Contre l’Indifference des Athées	Contre l’Indifférence des Athées
Que ceux qu combattent la Religion apprennent au moins quelle elle eſt avant que de la combattre.	Que ceux qu combattent la Religion apprennent au moins quelle elle est avant que de la combattre.
Mais puis qu’elle dit au contraire que les hommes ſont dans les tenebres, & dans l’éloignement de Dieu, qu’il ſ’eſt caché à leur connoiſſance, & que c’eſt meſme le nom qu’il ſe donne dans les Eſcritures, Deus abſconditus:	Mais puis qu’elle dit au contraire que les hommes sont dans les ténèbres, et dans l’éloignement de Dieu, qu’il s’est caché à leur connaissance, et que c’est même le nom qu’il se donne dans les Écritures, Deus absconditus:
& enfin ſi elle travaille également à établir ces deux choſes;	et enfin si elle travaille également à établir ces deux choses;
& qu’il les a couvertes neanmoins de telle ſorte qu’il ne ſera apperceu que de ceux qui le cherchent de tout leur cœur;	et qu’il les a couvertes néanmoins de telle sorte qu’il ne sera aperçu que de ceux qui le cherchent de tout leur cœur;
quel avantage peuvent-ils tirer, lors que dans la negligence où ils ſont profeſſion d’eſtre de chercher la verité, ils crient que rien ne la leur monſtre;	quel avantage peuvent-ils tirer, lors que dans la négligence où ils sont profession d’être de chercher la vérité, ils crient que rien ne la leur montre;
puiſque cette obſcurité où ils ſont, & qu’ils objectent à l’Egliſe ne fait qu’établir une des choſes qu’elle ſoûtient ſans toucher à l’autre, & confirme ſa doctrine bien loin de la ruiner?	puisque cette obscurité où ils sont, et qu’ils objectent à l’Église ne fait qu’établir une des choses qu’elle soutient sans toucher à l’autre, et confirme sa doctrine bien loin de la ruiner?
Il faudroit pour la combattre qu’ils criaſſent qu’ils ont fait tous leurs efforts pour chercher par tout, & meſme dans ce que l’Eglise propoſe pour s’en instruire, mais ſans aucune ſatisfaction.	Il faudrait pour la combattre qu’ils criassent qu’ils ont fait tous leurs efforts pour chercher par tout, et même dans ce que l’Église propose pour s’en instruire, mais sans aucune satisfaction.
S’ils parloient de la ſorte, ils combattroient à la verité une de ſes prétentions.	S’ils parlaient de la sorte, ils combattraient à la vérité une de ses prétentions.
Mais j’eſpere monſtrer icy qu’il n’y a point de perſonne raiſonnable qui puiſſe parler de la ſorte;	Mais j’espère montrer ici qu’il n’y a point de personne raisonnable qui puisse parler de la sorte;
On ſçait aſſez de quelle maniere agiſſent ceux qui ſont dans cet eſprit.	On sait assez de quelle manière agissent ceux qui sont dans cet esprit.
Ils croyent avoir fait de grands efforts pour s’inſtruire lors qu’ils ont employé quelques heures à la lecture de l’Eſcriture & qu’ils ont interrogé quelqu’Eccleſiaſtiqe ſur les veritez de la foy.	Ils croient avoir fait de grands efforts pour s’instruire lors qu’ils ont employé quelques heures à la lecture de l’ Écriture et qu’ils ont interrogé quelque Ecclésiastique sur les vérités de la foi.
Mais en verité je ne puis m’empeſcher de leur dire ce que j’ay dit ſouvent, que cette negligence n’eſt pas ſupportable.	Mais en vérité je ne puis m’empêcher de leur dire ce que j’ai dit souvent, que cette négligence n’est pas supportable.
Il ne s’agit pas icy de l’intereſt leger de quelque perſonne étrangere:	Il ne s’agit pas ici de l’intérêt léger de quelque personne étrangère:
Il s’agit de nous-meſme & de noſtre tout.	Il s’agit de nous-même et de notre tout.
L’immortalité de l’ame eſt une choſe qui nous importe ſi fort, & qui nous touche ſi profondément, qu’il faut avoir perdu tout ſentiment pour eſtre dans l’indifference de ſçavoir ce qui en eſt.	L’immortalité de l’âme est une chose qui nous importe si fort, et qui nous touche si profondément, qu’il faut avoir perdu tout sentiment pour être dans l’indifférence de savoir ce qui en est.
Toutes nos actions & toutes nos penſées doivent prendre des routes ſi differentes ſelon qu’il y aura des biens eternels à eſperer ou non, qu’il eſt impoſſible de faire une demarche avec ſens & jugement qu’en la reglant par la veuë de ce point qui doit eſtre noſtre dernier objet.	Toutes nos actions et toutes nos pensées doivent prendre des routes si différentes selon qu’il y aura des biens éternels à espérer ou non, qu’il est impossible de faire une démarche avec sens et jugement qu’en la réglant par la vue de ce point qui doit être notre dernier objet.
Ainſi noſtre premier intereſt & noſtre premier devoir eſt de nous éclaircir ſur ce ſujet d’où dépend toute noſtre conduite.	Ainsi notre premier intérêt et notre premier devoir est de nous éclaircir sur ce sujet d’où dépend toute notre conduite.
Je ne puis avoir que de la compaſſion pour ceux qui gémiſſent ſincerement dans ce doute, qui le regardent comme le dernier des malheurs, & qui n’épargnant rien pour en ſortir font de cette recherche leur principale & leur plus ſerieuſe occupation.	Je ne puis avoir que de la compassion pour ceux qui gémissent sincèrement dans ce doute, qui le regardent comme le dernier des malheurs, et qui n’épargnant rien pour en sortir font de cette recherche leur principale et leur plus sérieuse occupation.
Mais pour ceux qui paſſent leur vie ſans penſer à cette derniere fin de la vie, & qui par cette ſeule raiſon, qu’ils ne trouvent pas en eux-meſmes des lumieres qui les perſuadent, negligent d’en chercher ailleurs, & d’examiner à fond ſi cette opinion eſt de celle que le peuple reçoit par une ſimplicité credule, ou de celles qui quoy qu’obſcures d’elles-meſmes ont neanmoins un fondement tres ſolide, je les conſidere d’une maniere toute differente.	Mais pour ceux qui passent leur vie sans penser à cette dernière fin de la vie, et qui par cette seule raison, qu’ils ne trouvent pas en eux-mêmes des lumières qui les persuadent, négligent d’en chercher ailleurs, et d’examiner à fond si cette opinion est de celle que le peuple reçoit par une simplicité crédule, ou de celles qui quoi qu’obscures d’elles-mêmes ont néanmoins un fondement très solide, je les considère d’une manière toute différente.
elle m’étonne & m’épouvante;	elle m’étonne et m’épouvante;
c’eſt un monſtre pour moy.	c’est un monstre pour moi.
Je ne dis pas cecy par le zele pieux d’une devotion ſpirituelle.	Je ne dis pas ceci par le zèle pieux d’une dévotion spirituelle.
Je pretends au contraire que l’amour propre, que l’intereſt humain, que la plus ſimple lumiere de la raiſon nous doit donner ces ſentimens.	Je prétends au contraire que l’amour propre, que l’intérêt humain, que la plus simple lumière de la raison nous doit donner ces sentiments.
Il ne faut voir pour cela que ce que voyent les perſonnes les moins éclairées.	Il ne faut voir pour cela que ce que voient les personnes les moins éclairées.
Il ne faut pas avoir l’ame fort élevée pour comprendre qu’il n’y a point icy de ſatisfaction veritable & ſolide, que tous nos plaiſirs ne ſont que vanité, que nos maux ſont infinis, & qu’enfin la mort qui nous menace à chaque inſtant nous doit mettre dans peu d’années, & peut-eſtre en peu de jours dans un eſtat eternel de bonheur, ou de malheur, ou d’anneantiſſement.	Il ne faut pas avoir l’âme fort élevée pour comprendre qu’il n’y a point ici de satisfaction véritable et solide, que tous nos plaisirs ne sont que vanité, que nos maux sont infinis, et qu’enfin la mort qui nous menace à chaque instant nous doit mettre dans peu d’années, et peut-être en peu de jours dans un état éternel de bonheur, ou de malheur, ou d’anéantissement.
& le ciel n’eſtant pas certainement pour ceux qui doutent ſi leur ame eſt immortelle, ils n’ont à attendre que l’enfer ou le neant.	et le ciel n’étant pas certainement pour ceux qui doutent si leur âme est immortelle, ils n’ont à attendre que l’enfer ou le néant.
Il n’y a rien de plus réel que cela ny de plus terrible.	Il n’y a rien de plus réel que cela ni de plus terrible.
C’eſt envain qu’ils détournent leur penſée de cette eternité qui les attend, comme s’ils la pouvoient anneantir en n’y penſant point.	C’est en vain qu’ils détournent leur pensée de cette éternité qui les attend, comme s’ils la pouvaient anéantir en n’y pensant point.
Elle ſubſiſte malgré eux, elle s’avance, & la mort qui la doit ouvrir les mettra infailliblement dans peu de temps dans l’horrible neceſſité d’eſtre eternellement ou anneantis, ou malheureux.	Elle subsiste malgré eux, elle s’avance, et la mort qui la doit ouvrir les mettra infailliblement dans peu de temps dans l’horrible nécessité d’être éternellement ou anéantis, ou malheureux.
Voila un doute d’une terrible conſequence;	Voila un doute d’une terrible conséquence;
& c’eſt déja aſſurément un tres-grand mal que d’eſtre dans ce doute;	et c’est déjà assurément un très-grand mal que d’être dans ce doute;
mais c’eſt au moins un devoir indiſpenſable de chercher quand on y eſt.	mais c’est au moins un devoir indispensable de chercher quand on y est.
Ainſi celuy qui doute & qui ne cherche pas eſt tout enſemble & bien injuste, & bien malheureux.	Ainsi celui qui doute et qui ne cherche pas est tout ensemble et bien injuste, et bien malheureux.
Où peut-on prendre ces ſentimens?	Où peut-on prendre ces sentiments?
Quel ſujet de joye trouve-t’on à n’attendre plus que des miſeres ſans reſource?	Quel sujet de joie trouve-t-on à n’attendre plus que des misères sans ressource?
Quelle conſolation de n’attendre jamais de conſolateur?	Quelle consolation de n’attendre jamais de consolateur?
Ce repos dans cette ignorance eſt une choſe monſtrueuſe, & dont il faut faire ſentir l’extravagance & la ſtupidité à ceux qui y paſſent leur vie, en leur repreſentant ce qui ſe paſſe en eux-meſmes, pour les confondre par la veuë de leur folie.	Ce repos dans cette ignorance est une chose monstrueuse, et dont il faut faire sentir l’extravagance et la stupidité à ceux qui y passent leur vie, en leur représentant ce qui se passe en eux-mêmes, pour les confondre par la vue de leur folie.
Car voicy comment raiſonnent les hommes quand il choiſiſſent de vivre dans cette ignorance de ce qu’ils font, & ſans en rechercher d’éclairciſſement.	Car voici comment raisonnent les hommes quand il choisissent de vivre dans cette ignorance de ce qu’ils font, et sans en rechercher d’éclaircissement.
Je ne ſçay qui m’a mis au monde, ny ce que c’eſt que le monde, ny que moy-meſme.	Je ne sais qui m’a mis au monde, ni ce que c’est que le monde, ni que moi-même.
Je ſuis dans une ignorance terrible de toutes choſes.	Je suis dans une ignorance terrible de toutes choses.
Je ne ſçay ce que c’eſt que mon corps, que mes ſens, que mon ame;	Je ne sais ce que c’est que mon corps, que mes sens, que mon âme;
Je voy ces effroyables eſpaces de l’Univers qui m’enferment, & je me trouve attaché à un coin de cette vaſte eſtenduë, ſans ſçavoir pourquoy je ſuis plûtoſt placé en ce lieu qu’en un autre, ny pourquoy ce peu de temps qui m’eſt donné à vivre m’eſt aſſigné à ce point plûtoſt qu’à un autre de toute l’eternité qui m’a precedé, & de toute celle qui me ſuit.	Je vois ces effroyables espaces de l’Univers qui m’enferment, et je me trouve attaché à un coin de cette vaste étendue, sans savoir pourquoi je suis plutôt placé en ce lieu qu’en un autre, ni pourquoi ce peu de temps qui m’est donné à vivre m’est assigné à ce point plutôt qu’à un autre de toute l’éternité qui m’a précédé, et de toute celle qui me suit.
Je ne voy que des infinitez de toutes parts qui m’engloutiſſent comme un atome, & comme une ombre qui ne dure qu’un inſtant ſans retour.	Je ne vois que des infinités de toutes parts qui m’engloutissent comme un atome, et comme une ombre qui ne dure qu’un instant sans retour.
mais ce que j’ignore le plus c’eſt cette mort meſme que je ne ſçaurois éviter.	mais ce que j’ignore le plus c’est cette mort même que je ne saurais éviter.
Comme je ne ſçay d’où je viens, auſſi je ne ſçay où je vais;	Comme je ne sais d’où je viens, aussi je ne sais où je vais;
& je ſçay ſeulement qu’en ſortant de ce monde, je tombe pour jamais ou dans le neant, ou dans les mains d’un Dieu irrité, ſans ſçavoir à laquelle de ces deux conditions je dois eſtre eternellement en partage.	et je sais seulement qu’en sortant de ce monde, je tombe pour jamais ou dans le néant, ou dans les mains d’un Dieu irrité, sans savoir à laquelle de ces deux conditions je dois être éternellement en partage.
Voila mon eſtat plein de miſere, de foibleſſe, d’obſcurité.	Voila mon état plein de misère, de faiblesse, d’obscurité.
Et de tout cela je conclus que je dois donc paſſer tous les jours de ma vie ſans ſonger à ce qui me doit arriver, & que je n’ay qu’à ſuivre mes inclinations ſans reflexion & ſans inquietude, en faiſant tout ce qu’il faut pour tomber dans le malheur eternel au cas que ce qu’on en dit ſoit veritable.	Et de tout cela je conclus que je dois donc passer tous les jours de ma vie sans songer à ce qui me doit arriver, et que je n’ai qu’à suivre mes inclinations sans réflexion et sans inquiétude, en faisant tout ce qu’il faut pour tomber dans le malheur éternel au cas que ce qu’on en dit soit véritable.
Peut-eſtre que je pourrois trouver quelqu’éclairciſſement dans mes doutes;	Peut-être que je pourrais trouver quelqu’éclaircissement dans mes doutes;
& en traittant avec mépris ceux qui ſe travailleroient de ce ſoin, je veux aller ſans prévoyance & ſans crainte tenter un ſi grand evenement, & me laiſſer mollement conduire à la mort dans l’incertitude de l’eternité de ma condition future.	et en traitant avec mépris ceux qui se travailleraient de ce soin, je veux aller sans prévoyance et sans crainte tenter un si grand événement, et me laisser mollement conduire à la mort dans l’incertitude de l’éternité de ma condition future.
En verité il eſt glorieux à la Religion d’avoir pour ennemis des hommes ſi déraiſonnables;	En vérité il est glorieux à la Religion d’avoir pour ennemis des hommes si déraisonnables;
Car la foy Chreſtienne ne va principalement qu’à eſtablir ces deux choſes, la corruption de la nature, & la redemption de Jesus-Christ.	Car la foi Chrétienne ne va principalement qu’à établir ces deux choses, la corruption de la nature, et la rédemption de Jésus-Christ.
Or s’ils ne ſervent pas à monſtrer la verité de la redemption par la ſainteté de leurs mœurs, ils ſervent au moins admirablement à monſtrer la corruption de la nature par des ſentiments ſi dénaturez.	Or s’ils ne servent pas à montrer la vérité de la rédemption par la sainteté de leurs mœurs, ils servent au moins admirablement à montrer la corruption de la nature par des sentiments si dénaturez.
Rien n’eſt ſi important à l’homme que ſon eſtat;	Rien n’est si important à l’homme que son état;
rien ne luy eſt ſi redoutable que l’eternité.	rien ne lui est si redoutable que l’éternité.
Et ainſi qu’il ſe trouve des hommes indifferens à la perte de leur eſtre, & au peril d’une eternité de miſere, cela n’eſt point naturel.	Et ainsi qu’il se trouve des hommes indifférents à la perte de leur être, et au péril d’une éternité de misère, cela n’est point naturel.
Ils ſont tous autres à l’égard de toutes les autres choſes:	Ils sont tous autres à l’égard de toutes les autres choses:
& ce meſme homme qui paſſe les jours & les nuits dans la rage & dans le deſeſpoir pour la perte d’une charge, ou pour quelqu’offenſe imaginaire à ſon honneur, eſt celuy là-meſme qui ſçait qu’il va tout perdre par la mort, & qui demeure neanmoins ſans inquietude, ſans trouble, & ſans émotion.	et ce même homme qui passe les jours et les nuits dans la rage et dans le désespoir pour la perte d’une charge, ou pour quelqu’offense imaginaire à son honneur, est celui là-même qui sait qu’il va tout perdre par la mort, et qui demeure néanmoins sans inquiétude, sans trouble, et sans émotion.
Cette étrange inſenſibilité pour les choſes les plus terribles dans un cœur ſi ſenſibles au plus legeres, eſt une choſe monſtrueuſe;	Cette étrange insensibilité pour les choses les plus terribles dans un cœur si sensibles au plus légères, est une chose monstrueuse;
Un homme dans un cachot ne ſçachant ſi ſon arreſt eſt donné, n’ayant plus qu’une heure ſuffiſant, s’il ſçait qu’il eſt donné, pour le faire revoquer, il eſt contre la nature qu’il employe cette heure-là non à s’informer ſi cet arreſt eſt donné, mais à joüer, & à ſe divertir.	Un homme dans un cachot ne sachant si son arrêt est donné, n’ayant plus qu’une heure suffisant, s’il sait qu’il est donné, pour le faire révoquer, il est contre la nature qu’il emploie cette heure-là non à s’informer si cet arrêt est donné, mais à jouer, et à se divertir.
C’eſt l’eſtat où ſe trouuvent ces perſonnes, avec cette difference que les maux dont ils ſont menacez ſont bien autres que la ſimple perte de la vie & un ſupplice paſſager que ce priſonnier apprehenderoit.	C’est l’état où se trouvent ces personnes, avec cette différence que les maux dont ils sont menacés sont bien autres que la simple perte de la vie et un supplice passager que ce prisonnier appréhenderait.
Cependant ils courent ſans ſoucy dans le précipice aprés avoir mis quelque choſe devant leurs yeux pour s’empeſcher de le voir, & ils ſe moquent de ceux qui les en avertiſſent.	Cependant ils courent sans souci dans le précipice après avoir mis quelque chose devant leurs yeux pour s’empêcher de le voir, et ils se moquent de ceux qui les en avertissent.
Ainſi non ſeulement le zele de ceux qui cherchent Dieu prouve la veritable Religion, mais auſſi l’aveuglement de ceux qui ne le cherchent pas, & qui vivent dans cette horrible negligence.	Ainsi non seulement le zèle de ceux qui cherchent Dieu prouve la véritable Religion, mais aussi l’aveuglement de ceux qui ne le cherchent pas, et qui vivent dans cette horrible négligence.
Il faut qu’il y ait un étrange renverſement dans la nature de l’homme pour vivre dans cet eſtat, & encore plus pour en faire vanité.	Il faut qu’il y ait un étrange renversement dans la nature de l’homme pour vivre dans cet état, et encore plus pour en faire vanité.
Car quand ils auroient une certitude entiere qu’ils n’auroient rien à craindre aprés la mort que de tomber dans le neant, ne ſeroit-ce pas un ſujet de deſeſpoir plutoſt que de vanité?	Car quand ils auraient une certitude entière qu’ils n’auraient rien à craindre après la mort que de tomber dans le néant, ne serait-ce pas un sujet de désespoir plutôt que de vanité?
Et neanmoins il eſt certain que l’homme eſt ſi dénaturé qu’il y a dans ſon cœur une ſemence de joye en cela.	Et néanmoins il est certain que l’homme est si dénaturé qu’il y a dans son cœur une semence de joie en cela.
Ce repos brutal entre la crainte de l’enfer, & du neant ſemble ſi beau, que non ſeulement ceux qui ſont veritablement dans ce doute malheureux s’en glorifient;	Ce repos brutal entre la crainte de l’enfer, et du néant semble si beau, que non seulement ceux qui sont véritablement dans ce doute malheureux s’en glorifient;
Car l’experience nous fait voir que la plus part de ceux qui s’en meſlent ſont de ce dernier genre;	Car l’expérience nous fait voir que la plus part de ceux qui s’en mêlent sont de ce dernier genre;
que ce ſont des gens qui ſe contrefont, & qui ne ſont pas tels qu’ils veulent paroiſtre.	que ce sont des gens qui se contrefont, et qui ne sont pas tels qu’ils veulent paraître.
Ce ſont des perſonnes qui ont ouy dire que les belles manieres du monde conſiſtent à faire ainſi l’emporté.	Ce sont des personnes qui ont ouï dire que les belles manières du monde consistent à faire ainsi l’emporté.
C’eſt ce qu’ils appellent avoir ſecoüé le joug;	C’est ce qu’ils appellent avoir secoué le joug;
& la plus part ne le font que pour imiter les autres.	et la plus part ne le font que pour imiter les autres.
Mais s’ils ont encore tant ſoit peu de ſens commun, il n’eſt pas difficile de leur faire entendre combien ils s’abuſent en cherchant par là de l’eſtime.	Mais s’ils ont encore tant soit peu de sens commun, il n’est pas difficile de leur faire entendre combien ils s’abusent en cherchant par là de l’estime.
parce que les hommes n’aiment naturellement que ce qui leur peut eſtre utile.	parce que les hommes n’aiment naturellement que ce qui leur peut être utile.
Or quel avantage y a-t’il pour nous à ouïr dire à un homme qu’il a ſecoüé le joug, qu’il ne croit pas qu’il y ait un Dieu qui veille ſur ſes actions, qu’il ſe conſidere comme ſeul maiſtre de ſa conduite, qu’il ne penſe à en rendre compte qu’à ſoy meſme?	Or quel avantage y a-t-il pour nous à ouïr dire à un homme qu’il a secoué le joug, qu’il ne croit pas qu’il y ait un Dieu qui veille sur ses actions, qu’il se considère comme seul maître de sa conduite, qu’il ne pense à en rendre compte qu’à soi-même?
Penſe-t’il nous avoir bien rejouïs de nous dire qu’il doute ſi noſtre ame eſt autre choſe qu’un peu de vent & de fumée, & encore de nous le dire d’un ton de voix fier & content?	Pense-t-il nous avoir bien réjouis de nous dire qu’il doute si notre âme est autre chose qu’un peu de vent et de fumée, et encore de nous le dire d’un ton de voix fier et content?
Eſt-ce donc une choſe à dire gayement;	Est-ce donc une chose à dire gaiement;
& n’eſt-ce pas une choſe à dire au contraire triſtement, comme la choſe du monde la plus triſte?	et n’est-ce pas une chose à dire au contraire tristement, comme la chose du monde la plus triste?
S’ils y penſoient ſerieuſement ils verroient que cela eſt ſi mal pris, ſi contraire au bon ſens, ſi oppoſé à l’honneſteté, & ſi éloigné en toute maniere de ce bon air qu’ils cherchent, que rien n’eſt plus capable de leur attirer le meſpris & l’averſion des hommes, & de les faire paſſer pour des perſonnes ſans eſprit & ſans jugement.	S’ils y pensaient sérieusement ils verraient que cela est si mal pris, si contraire au bon sens, si opposé à l’honnêteté, et si éloigné en toute manière de ce bon air qu’ils cherchent, que rien n’est plus capable de leur attirer le mépris et l’aversion des hommes, et de les faire passer pour des personnes sans esprit et sans jugement.
Et en effet ſi on leur fait rendre compte de leurs ſentimens & des raiſons qu’ils ont de douter de la Religion, ils diront des choſes ſi foibles & ſi baſſes qu’ils perſuaderoient plutoſt du contraire.	Et en effet si on leur fait rendre compte de leurs sentiments et des raisons qu’ils ont de douter de la Religion, ils diront des choses si faibles et si basses qu’ils persuaderaient plutôt du contraire.
C’eſtoit ce que leur diſoit un jour fort à propos une perſonne:	C’était ce que leur disait un jour fort à propos une personne:
Et il avoit raiſon;	Et il avait raison;
car qui n’auroit horreur de ſe voir dans des ſentimens où l’on a pour compagnons des perſonnes ſi meſpriſables.	car qui n’aurait horreur de se voir dans des sentiments où l’on a pour compagnons des personnes si méprisables.
S’ils ſont faſchez dans le fond de leur cœur de n’avoir pas plus de lumiere, qu’ils ne le diſſimulent point.	S’ils sont fâchés dans le fond de leur cœur de n’avoir pas plus de lumière, qu’ils ne le dissimulent point.
Cette declaration ne ſera pas honteuſe.	Cette déclaration ne sera pas honteuse.
Il n’y a de honte qu’à n’en point avoir.	Il n’y a de honte qu’à n’en point avoir.
Rien ne deſcouvre davantage une eſtrange foibleſſe d’eſprit que de ne pas connoiſtre quel eſt le malheur d’un homme ſans Dieu.	Rien ne découvre davantage une étrange faiblesse d’esprit que de ne pas connaître quel est le malheur d’un homme sans Dieu.
Rien ne marque davantage une extrême baſſeſſe de cœur que de ne pas ſouhaitter la verité des promeſſes eternelles.	Rien ne marque davantage une extrême bassesse de cœur que de ne pas souhaiter la vérité des promesses éternelles.
Rien n’eſt plus laſche que de faire le brave contre Dieu.	Rien n’est plus lâche que de faire le brave contre Dieu.
qu’ils ſoient au moins honneſtes gens, s’ils ne peuvent encore eſtre Chreſtiens:	qu’ils soient au moins honnêtes gens, s’ils ne peuvent encore être Chrétiens:
& qu’ils reconnoiſſent enfin qu’il n’y a que de ſortes de perſonnes qu’on puiſſe appeller raiſonnables;	et qu’ils reconnaissent enfin qu’il n’y a que de sortes de personnes qu’on puisse appeler raisonnables;
ou ceux qui le cherchent de tout leur cœur, parce qu’ils ne le connoiſſent pas encore.	ou ceux qui le cherchent de tout leur cœur, parce qu’ils ne le connaissent pas encore.
C’eſt donc pour les perſonnes qui cherchent Dieux ſincerement, & qui reconnoiſſant leur miſere deſirent veritablement d’en ſortir, qu’il eſt juſte de travailler, afin de leur ayder à trouver la lumiere qu’ils n’ont pas.	C’est donc pour les personnes qui cherchent Dieux sincèrement, et qui reconnaissant leur misère désirent véritablement d’en sortir, qu’il est juste de travailler, afin de leur aider à trouver la lumière qu’ils n’ont pas.
Mais pour ceux qui vivent ſans le connoiſtre, & ſans le chercher, ils ſe jugent eux meſmes ſi peu dignes de leur ſoin, qu’ils ne ſont pas dignes du ſoin des autres:	Mais pour ceux qui vivent sans le connaître, et sans le chercher, ils se jugent eux mêmes si peu dignes de leur soin, qu’ils ne sont pas dignes du soin des autres:
& il faut avoir toute la charité de la Religion qu’ils meſpriſent pour ne les pas meſpriſer juſqu’à les abandonner dans leur folie.	et il faut avoir toute la charité de la Religion qu’ils méprisent pour ne les pas mépriser jusqu’à les abandonner dans leur folie.
Mais parce que cette Religion nous oblige de les regarder toûjours tant qu’ils feront en cette vie comme capables de la grace qui peut les éclairer, & de croire qu’ils peuvent eſtre dans peu de temps plus remplis de foy que nous de ſommes, & que nous pouvons au contraire tomber dans l’aveuglement où ils ſont;	Mais parce que cette Religion nous oblige de les regarder toujours tant qu’ils feront en cette vie comme capables de la grâce qui peut les éclairer, et de croire qu’ils peuvent être dans peu de temps plus remplis de foi que nous de sommes, et que nous pouvons au contraire tomber dans l’aveuglement où ils sont;
il faut faire pour eux ce que nous voudrions qu’on fiſt pour nous ſi nous eſtions en leur place, & les appeller à avoir pitié d’eux meſmes, & à faire au moins quelques pas pour tenter s’ils ne trouveront point de lumiere.	il faut faire pour eux ce que nous voudrions qu’on fît pour nous si nous étions en leur place, et les appeler à avoir pitié d’eux mêmes, et à faire au moins quelques pas pour tenter s’ils ne trouveront point de lumière.
Peut eſtre y rencontrerons ils quelque choſe, ou du moins ils n’y perdront pas beaucoup.	Peut-être y rencontreront-ils quelque chose, ou du moins ils n’y perdront pas beaucoup.
Mais pour ceux qui y apporteront une ſincerité parfaite & un parfait deſir de connoître la verité, j’eſpere qu’ils y auront ſatisfaction, & qu’ils ſeront convaincus des preuves d’une Religion ſi divine que l’on y a ramaſſées.	Mais pour ceux qui y apporteront une sincérité parfaite et un parfait désir de connaître la vérité, j’espère qu’ils y auront satisfaction, et qu’ils seront convaincus des preuves d’une Religion si divine que l’on y a ramassées.
Marques de la veritable Religion.	Marques de la véritable Religion.
La vraye Religion doit avoir pour marque d’obliger à aymer Dieu.	La vraie Religion doit avoir pour marque d’obliger à aimer Dieu.
Cela eſt bien juſte.	Cela est bien juste.
Et cependant aucune autre que la noſtre ne l’a ordonné.	Et cependant aucune autre que la nôtre ne l’a ordonné.
Elle doit encore avoir connu la concupiſcence de l’homme, & l’impuiſſance où il eſt par luy meſme d’acquerir la vertu.	Elle doit encore avoir connu la concupiscence de l’homme, et l’impuissance où il est par lui même d’acquérir la vertu.
Elle doit y avoir apporté les remedes dont la priere eſt le principal.	Elle doit y avoir apporté les remèdes dont la prière est le principal.
& nulle autre n’a jamais demandé à Dieu de l’aymer & de le ſuivre.	et nulle autre n’a jamais demandé à Dieu de l’aimer et de le suivre.
§ Il faut pour faire qu’une Religion ſoit vraye qu’elle ayt connu noſtre nature.	§ Il faut pour faire qu’une Religion soit vraie qu’elle ait connu notre nature.
Elle doit avoir connu la grandeur & la baſſeſſe de l’homme, & la raiſon de l’un & de l’autre.	Elle doit avoir connu la grandeur et la bassesse de l’homme, et la raison de l’un et de l’autre.
Quelle autre Religion que la Chreſtienne a connu toutes ces choſes?	Quelle autre Religion que la Chrétienne a connu toutes ces choses?
§ Les autres Religions, comme les Payennes, ſont plus populaires;	§ Les autres Religions, comme les Païennes, sont plus populaires;
car elles conſiſtent toutes en exterieur;	car elles consistent toutes en extérieur;
mais elles ne ſont pas pour les gens habiles.	mais elles ne sont pas pour les gens habiles.
Une Religion purement intellectuelle ſeroit plus proportionnée aux habiles;	Une Religion purement intellectuelle serait plus proportionnée aux habiles;
La ſeule Religion Chreſtienne eſt proportionnée à tous, eſtant meſlée d’exterieur & d’interieur.	La seule Religion Chrétienne est proportionnée à tous, étant mêlée d’extérieur et d’intérieur.
Elle éleve le peuple à l’interieur, & abaiſſe les ſuperbes à l’exterieur, & n’eſt pas parfaite ſans les deux.	Elle élève le peuple à l’intérieur, et abaisse les superbes à l’extérieur, et n’est pas parfaite sans les deux.
§ Nous ſommes haïſſables;	§ Nous sommes haïssables;
la raiſon nous en convainc.	la raison nous en convainc.
Or nulle autre Religion que la Chreſtienne ne propoſe de ſe haïr.	Or nulle autre Religion que la Chrétienne ne propose de se haïr.
Nulle autre Religion ne peut donc eſtre reçeüe de ceux qui ſçavent qu’ils ne ſont dignes que de haine.	Nulle autre Religion ne peut donc être reçue de ceux qui savent qu’ils ne sont dignes que de haine.
§ Nulle autre Religion que la Chreſtienne n’a connu que l’homme eſt la plus excellente creature, & en meſme temps la plus miſerable.	§ Nulle autre Religion que la Chrétienne n’a connu que l’homme est la plus excellente créature, et en même temps la plus misérable.
Les uns qui ont bien connu la realité de ſon excellence ont pris pour lâcheté & pour ingratitude les ſentimens bas que les hommes ont naturellement d’eux meſmes.	Les uns qui ont bien connu la réalité de son excellence ont pris pour lâcheté et pour ingratitude les sentiments bas que les hommes ont naturellement d’eux mêmes.
§ Nulle Religion que la noſtre n’a enſeigné que l’homme naiſt en peché.	§ Nulle Religion que la nôtre n’a enseigné que l’homme naît en péché.
Nulle ſecte de Philoſophes ne l’a dit.	Nulle secte de Philosophes ne l’a dit.
§ Dieu eſtant caché, toute Religion qui ne dit pas que Dieu eſt caché n’eſt pas veritable;	§ Dieu étant caché, toute Religion qui ne dit pas que Dieu est caché n’est pas véritable;
& toute Religion qui n’en rend pas la raiſon n’eſt pas inſtruiſante.	et toute Religion qui n’en rend pas la raison n’est pas instruisante.
La noſtre fait tout cela.	La nôtre fait tout cela.
§ Cette Religion qui conſiſte à croire que l’homme eſt tombé d’un eſtat de gloire & de communication avec Dieu en un eſtat de triſteſſe, de pénitence, & d’éloignement de Dieu, mais qu’enfin il ſeroit rétably par un Meſſie qui devoit venir, a toûjours eſté ſur la terre.	§ Cette Religion qui consiste à croire que l’homme est tombé d’un état de gloire et de communication avec Dieu en un état de tristesse, de pénitence, et d’éloignement de Dieu, mais qu’enfin il serait rétabli par un Messie qui devait venir, a toujours été sur la terre.
Toutes choſes ont paſſé, et celle là a ſubſiſté pour laquelle ſont toutes choſes.	Toutes choses ont passé, et celle-là a subsisté pour laquelle sont toutes choses.
Car Dieu voulant ſe former un peuple ſaint qu’il ſépareroit de toutes les autres nations, qu’il délivreroit de ſes ennemis, qu’il mettroit dans un lieu de repos, a promis de le faire, & de venir au monde pour cela;	Car Dieu voulant se former un peuple saint qu’il séparerait de toutes les autres nations, qu’il délivrerait de ses ennemis, qu’il mettrait dans un lieu de repos, a promis de le faire, et de venir au monde pour cela;
Et cependant pour affermir l’eſperance de ſes élûs dans tous les temps, il leur en a toujours fait voir des images & des figures, & il ne les a jamais laiſſez ſans des aſſurances de ſa puiſſance & de ſa volonté pour leur ſalut.	Et cependant pour affermir l’espérance de ses élus dans tous les temps, il leur en a toujours fait voir des images et des figures, et il ne les a jamais laissés sans des assurances de sa puissance et de sa volonté pour leur salut.
Car dans la creation de l’homme, Adam en eſtoit le témoin, & le dépoſitaire de la promeſſe du Sauveur qui devoit naiſtre de la femme.	Car dans la création de l’homme, Adam en était le témoin, et le dépositaire de la promesse du Sauveur qui devait naître de la femme.
Enſuite Dieu a envoyé Noé, qui a veu la malice des hommes au plus haut degré;	Ensuite Dieu a envoyé Noé, qui a vu la malice des hommes au plus haut degré;
& il l’a ſauvé en noyant toute la terre par un miracle qui marquoit aſſez, & le pouvoir qu’il avoit de ſauver le monde, & la volonté qu’il avoit de le faire, & de faire naiſtre de la femme celuy qu’il avoit promis.	et il l’a sauvé en noyant toute la terre par un miracle qui marquait assez, et le pouvoir qu’il avait de sauver le monde, et la volonté qu’il avait de le faire, et de faire naître de la femme celui qu’il avait promis.
Ce miracle ſuffiſoit pour affermir l’eſperance des hommes;	Ce miracle suffisait pour affermir l’espérance des hommes;
& la memoire en eſtant encore aſſez fraiche parmy eux, Dieu fit ſes promeſſes à Abraham qui eſtoit tout environné d’Idolâtres, & il luy fit connoiſtre le myſtere du Meſſie qu’il devoit envoyer.	et la mémoire en étant encore assez fraiche parmi eux, Dieu fit ses promesses à Abraham qui était tout environné d’Idolâtres, et il lui fit connaître le mystère du Messie qu’il devait envoyer.
Au temps d’Iſaac & de Jacob l’abomination eſtoit reſpanduë ſur toute la terre;	Au temps d’Isaac et de Jacob l’abomination était répandue sur toute la terre;
mais ces Saints vivoient en la foy;	mais ces Saints vivaient en la foi;
J’attens, ô mon Dieu, le Sauveur que vous avez promis, ſalutare tuum expectabo Domine.	J’attends, ô mon Dieu, le Sauveur que vous avez promis, salutare tuum expectabo Domine.
Les Egyptiens eſtoient infectez & d’idolatrie & de magie;	Les Egyptiens étaient infectés et d’idolâtrie et de magie;
Mais cependant Moyſe & d’autres voyoient celuy qu’ils ne voyoient pas, & l’adoroient en regardant les biens eternels qu’il leur preparoit.	Mais cependant Moïse et d’autres voyaient celui qu’ils ne voyaient pas, et l’adoraient en regardant les biens éternels qu’il leur préparait.
Les Grecs et les Latins enſuitte ont fait regner les fauſſes divinitez;	Les Grecs et les Latins ensuite ont fait régner les fausses divinités;
les Poëtes ont fait diverſes theologies;	les Poètes ont fait diverses théologies;
les Philoſophes ſe ſont ſeparez en mille ſectes differentes:	les Philosophes se sont séparés en mille sectes différentes:
& cependant il y avoit toûjours au cœur de la Judée des hommes choiſis qui prédiſoient la venuë de ce Meſſie qui n’eſtoit connu que d’eux.	et cependant il y avait toujours au cœur de la Judée des hommes choisis qui prédisaient la venue de ce Messie qui n’était connu que d’eux.
Il est venu enfin en la conſommation des temps:	Il est venu enfin en la consommation des temps:
cette Egliſe qui adore celuy qui a toûjours eſté adoré à ſubſiſté ſans interruption.	cette Eglise qui adore celui qui a toujours été adoré à subsisté sans interruption.
Et ce qui eſt admirable, incomparable, & tout à fait divin, c’eſt que cette Religion qui a toûjours duré a toûjours eſté combattüe.	Et ce qui est admirable, incomparable, et tout à fait divin, c’est que cette Religion qui a toujours duré a toujours été combattue.
& toutes les fois qu’elle a eſté en ce eſtat Dieu l’a relevée par des coups extraordinaires de ſa puiſſance.	et toutes les fois qu’elle a été en ce état Dieu l’a relevée par des coups extraordinaires de sa puissance.
C’eſt ce qui eſt eſtonnant, & qu’elle s’eſt maintenuë ſans flechir & plier ſous la volonté des tyrans.	C’est ce qui est étonnant, et qu’elle s’est maintenue sans fléchir et plier sous la volonté des tyrans.
§ Les Eſtats periroient ſi on ne faiſoit plier ſouvent les loix à la neceſſité.	§ Les États périraient si on ne faisait plier souvent les lois à la nécessité.
Mais jamais la Religion n’a ſouffert cela, & n’en a uſé.	Mais jamais la Religion n’a souffert cela, et n’en a usé.
Auſſi il faut ces accomodemens, ou des miracles.	Aussi il faut ces accommodements, ou des miracles.
Il n’eſt pas eſtrange qu’on ſe conſerve en pliant, & ce n’eſt pas proprement ſe maintenir;	Il n’est pas étrange qu’on se conserve en pliant, et ce n’est pas proprement se maintenir;
il n’y en a point qui ait duré quinze cens ans.	il n’y en a point qui ait duré quinze cens ans.
Mais que cette Religion ſe ſoit toûjours maintenüe, & inflexible;	Mais que cette Religion se soit toujours maintenue, et inflexible;
§ Ainſi le Meſſie a toûjours eſté crû.	§ Ainsi le Messie a toujours été crû.
La tradition d’Adam eſtoit encore nouvelles en Noé & en Moyſe.	La tradition d’Adam était encore nouvelles en Noé et en Moïse.
Les Prophetes l’ont predit depuis, en prédiſant toujours d’autres choſes dont les evenemens qui arrivoient de temps en temps à la veuë des hommes marquoient la verité de leur miſſion, & par conſequent celle de leurs promeſſes touchant le Meſſie.	Les Prophètes l’ont prédit depuis, en prédisant toujours d’autres choses dont les événements qui arrivaient de temps en temps à la vue des hommes marquaient la vérité de leur mission, et par conséquent celle de leurs promesses touchant le Messie.
Ils ont tous dit que la loy qu’ils avoient n’eſtoit qu’en attendant celle du Meſſie;	Ils ont tous dit que la loi qu’ils avoient n’était qu’en attendant celle du Messie;
que juſque là elle ſeroit perpétuelle, mais que l’autre dureroit éternellement;	que jusque là elle serait perpétuelle, mais que l’autre durerait éternellement;
qu’ainſi leur loy ou celle du Meſſie dont elle eſtoit la promeſſe ſeroient toujours ſur la terre.	qu’ainsi leur loi ou celle du Messie dont elle était la promesse seraient toujours sur la terre.
& Jesus-Christ eſt venu dans toutes les circonſtances prédites.	et Jésus-Christ est venu dans toutes les circonstances prédites.
Il a fait des miracles & les Apoſtres auſſi qui ont converti les Payens;	Il a fait des miracles et les Apôtres aussi qui ont converti les Païens;
§ La ſeule Religion contre la nature, contre le ſens commun, contre nos plaiſirs eſt la ſeule qui ait toûjours eſté.	§ La seule Religion contre la nature, contre le sens commun, contre nos plaisirs est la seule qui ait toujours été.
§ Toute la conduite des choſes doit avoir pour objet l’eſtabliſſement & la grandeur de la Religion:	§ Toute la conduite des choses doit avoir pour objet l’établissement et la grandeur de la Religion:
les hommes doivent avoir en eux-meſmes des ſentimens conformes à ce qu’elle nous enſeigne:	les hommes doivent avoir en eux-mêmes des sentiments conformes à ce qu’elle nous enseigne:
& enfin elle doit eſtre tellement l’objet & le centre où toutes choſes tendent, que qui en ſçaura les principes puiſſe rendre raiſon & de toute la nature de l’homme en particulier, & de toute la conduite du monde en general.	et enfin elle doit être tellement l’objet et le centre où toutes choses tendent, que qui en saura les principes puisse rendre raison et de toute la nature de l’homme en particulier, et de toute la conduite du monde en général.
Sur ce fondement les impies prennent lieu de blaſphemer la Religion Chreſtienne, parce qu’ils la connoiſſent mal.	Sur ce fondement les impies prennent lieu de blasphémer la Religion Chrétienne, parce qu’ils la connaissent mal.
Ils s’imaginent qu’elle conſiſte ſimplement en l’adoration d’un Dieu conſideré comme grand, puiſſant, & eternel;	Ils s’imaginent qu’elle consiste simplement en l’adoration d’un Dieu considéré comme grand, puissant, et éternel;
Et delà ils concluent que cette Religion n’eſt pas veritable;	Et delà ils concluent que cette Religion n’est pas véritable;
parce que ſi elle l’eſtoit il faudroit que Dieu ſe manifeſtaſt aux hommes par des preuves ſi ſenſibles qu’il fuſt impoſſible que perſonne le meſconnût.	parce que si elle l’était il faudrait que Dieu se manifestât aux hommes par des preuves si sensibles qu’il fût impossible que personne le méconnût.
Elle enſeigne donc aux hommes ces deux veritez, & qu’il y a un Dieu dont ils ſont capables, & qu’il y a une corruption dans la nature qui les en rend indignes.	Elle enseigne donc aux hommes ces deux vérités, et qu’il y a un Dieu dont ils sont capables, et qu’il y a une corruption dans la nature qui les en rend indignes.
Il importe également aux hommes de connoiſtre l’un & l’autre de ces points;	Il importe également aux hommes de connaître l’un et l’autre de ces points;
& il eſt également dangereux à l’homme de connoiſtre Dieu ſans connoiſtre ſa miſere, & de connoiſtre ſa miſere ſans connoiſtre le Redempteur qui l’en peut guerir.	et il est également dangereux à l’homme de connaître Dieu sans connaître sa misère, et de connaître sa misère sans connaître le Rédempteur qui l’en peut guérir.
Une ſeule de ces connoiſſances fait ou l’orgueil des Philoſophes qui ont connû Dieu & non leur miſere, ou le deſeſpoir des Athées qui connoiſſent leur miſere ſans Redempteur.	Une seule de ces connaissances fait ou l’orgueil des Philosophes qui ont connu Dieu et non leur misère, ou le désespoir des Athées qui connaissent leur misère sans Rédempteur.
Et ainſi comme il eſt également de la neceſſité de l’homme de connoiſtre ces deux points, il eſt auſſi également de la miſericorde de Dieu de nous les avoir fait connoiſtre.	Et ainsi comme il est également de la nécessité de l’homme de connaître ces deux points, il est aussi également de la miséricorde de Dieu de nous les avoir fait connaître.
La Religion Chreſtienne le fait;	La Religion Chrétienne le fait;
Qu’on examine l’ordre du monde ſur cela, & qu’on voye ſi toutes choses ne tendent pas à l’établiſſement des deux chefs de cette Religion.	Qu’on examine l’ordre du monde sur cela, et qu’on voie si toutes choses ne tendent pas à l’établissement des deux chefs de cette Religion.
§ Si l’on ne ſe connoiſt plein d’orgueil, d’ambition, de concupiſcence, de foibleſſe, de miſere, & d’injuſtice, on eſt bien aveugle.	§ Si l’on ne se connaît plein d’orgueil, d’ambition, de concupiscence, de faiblesse, de misère, et d’injustice, on est bien aveugle.
Que peut-on donc avoir que de l’eſtime pour une Religion qui connoiſt ſi bien les defauts de l’homme;	Que peut-on donc avoir que de l’estime pour une Religion qui connaît si bien les défauts de l’homme;
& que du deſir pour la verité d’une Religion qui y promet des remedes ſi ſouhaitables?	et que du désir pour la vérité d’une Religion qui y promet des remèdes si souhaitables?
Veritable Religion prouvée par les contrarietez qui ſont dans l’homme, & par le peché originel.	Véritable Religion prouvée par les contrariétés qui sont dans l’homme, et par le péché originel.
Les grandeurs & les miſeres de l’homme ſont tellement viſibles, qu’il faut neceſſairement que la veritable Religion nous enſeigne qu’il y a en luy quelque grand principe de grandeur, & en meſme temps quelque grand principe de miſere.	Les grandeurs et les misères de l’homme sont tellement visibles, qu’il faut nécessairement que la véritable Religion nous enseigne qu’il y a en lui quelque grand principe de grandeur, et en même temps quelque grand principe de misère.
Car il faut que la veritable Religion connoiſſe à fond noſtre nature, c’eſt-à-dire qu’elle connoiſſe tout ce qu’elle a de grand, & tout ce qu’elle a de miſerable, & la raiſon de l’un & de l’autre.	Car il faut que la véritable Religion connaisse à fond notre nature, c’est-à-dire qu’elle connaisse tout ce qu’elle a de grand, et tout ce qu’elle a de misérable, et la raison de l’un et de l’autre.
Il faut encore qu’elle nous rende raiſon des étonnantes contrarietez, qui s’y rencontrent.	Il faut encore qu’elle nous rende raison des étonnantes contrariétés, qui s’y rencontrent.
Mais comme nous nous trouvons dans l’impuiſſance d’adorer ce que nous ne connoiſſons pas, & d’aymer autre choſe que nous, il faut que la Religion qui inſtruit de ces devoirs nous inſtruiſe auſſi de cette impuiſſance, & qu’elle nous en apprenne les remedes.	Mais comme nous nous trouvons dans l’impuissance d’adorer ce que nous ne connaissons pas, et d’aimer autre chose que nous, il faut que la Religion qui instruit de ces devoirs nous instruise aussi de cette impuissance, et qu’elle nous en apprenne les remèdes.
Il faut pour rendre l’homme heureux qu’elle luy monſtre qu’il y a un Dieu, qu’on eſt obligé de l’aymer, que noſtre veritable felicité eſt d’eſtre à luy, & noſtre unique mal d’eſtre ſeparé de luy;	Il faut pour rendre l’homme heureux qu’elle lui montre qu’il y a un Dieu, qu’on est obligé de l’aimer, que notre véritable félicité est d’être à lui, et notre unique mal d’être séparé de lui;
Il faut qu’elle nous rende raiſon de l’oppoſition que nous avons à Dieu & à noſtre propre bien.	Il faut qu’elle nous rende raison de l’opposition que nous avons à Dieu et à notre propre bien.
Il faut qu’elle nous en enſeigne les remedes, & les moyens d’obtenir ces remedes.	Il faut qu’elle nous en enseigne les remèdes, et les moyens d’obtenir ces remèdes.
Qu’on examine ſur cela toutes les Religions du monde, & qu’on voye s’il y en a une autre que la Chreſtienne qui y ſatisfaſſe.	Qu’on examine sur cela toutes les Religions du monde, et qu’on voie s’il y en a une autre que la Chrétienne qui y satisfasse.
Sera-ce celle qu’enſeignoient les Philoſophes qui nous propoſent pour tout bien un bien qui eſt en nous?	Sera-ce celle qu’enseignaient les Philosophes qui nous proposent pour tout bien un bien qui est en nous?
Eſt-ce là le vray bien?	Est-ce là le vrai bien?
Ont-ils trouvé le remede à nos maux?	Ont-ils trouvé le remède à nos maux?
Et ceux qui nous ont egalé aux beſtes, & qui nous ont donné les plaiſirs de la terre pour tout bien ont-ils apporté le remede à nos concupiſcences?	Et ceux qui nous ont égalé aux bêtes, et qui nous ont donné les plaisirs de la terre pour tout bien ont-ils apporté le remède à nos concupiscences?
Levez vos yeux vers Dieu, diſent les uns;	Levez vos yeux vers Dieu, disent les uns;
Vous pouvez vous rendre ſemblable à luy;	Vous pouvez vous rendre semblable à lui;
la ſageſſe vous y égalera ſi vous voulez la ſuivre.	la sagesse vous y égalera si vous voulez la suivre.
Et les autres diſent:	Et les autres disent:
Baiſſez vos yeux vers la terre, chetif ver que vous eſtes, & regardez les beſtes dont vous eſtes le compagnon.	Baissez vos yeux vers la terre, chétif ver que vous êtes, et regardez les bêtes dont vous êtes le compagnon.
Que deviendra donc l’homme?	Que deviendra donc l’homme?
Sera-t-il égal à Dieu ou au beſtes?	Sera-t-il égal à Dieu ou au bêtes?
Que ſerons nous donc?	Que serons nous donc?
Quelle Religion nous enſeignera à guerir l’orgueüil, & la concupiſcence?	Quelle Religion nous enseignera à guérir l’orgueil, et la concupiscence?
Voyons ce que nous dit ſur tout cela la Sageſſe de Dieu qui nous parle dans la Religion Chreſtienne.	Voyons ce que nous dit sur tout cela la Sagesse de Dieu qui nous parle dans la Religion Chrétienne.
C’eſt en vain, ô homme, que vous cherchez dans vous meſme le remede à vos miſeres.	C’est en vain, ô homme, que vous cherchez dans vous même le remède à vos misères.
Toutes vos lumieres ne peuvent arriver qu’à connoître que ce n’eſt point en vous que vous trouverez ny la verité ny le bien.	Toutes vos lumières ne peuvent arriver qu’à connaître que ce n’est point en vous que vous trouverez ni la vérité ni le bien.
Les Philoſophes vous l’ont promis;	Les Philosophes vous l’ont promis;
ils n’ont pû le faire.	ils n’ont pu le faire.
Ils ne ſçavent ny quel eſt voſtre veritable bien, ny quel eſt voſtre veritable eſtat.	Ils ne savent ni quel est votre véritable bien, ni quel est votre véritable état.
Vos maladies principales ſont l’orgueüil qui vous ſouſtrait à Dieu, & la concupiſcence qui vous attache à la terre;	Vos maladies principales sont l’orgueil qui vous soustrait à Dieu, et la concupiscence qui vous attache à la terre;
& ils n’ont fait autre choſe qu’entretenir au moins une de ces maladies.	et ils n’ont fait autre chose qu’entretenir au moins une de ces maladies.
Ils vous ont fait penſer que vous luy eſtes ſemblable par voſtre nature.	Ils vous ont fait penser que vous lui êtes semblable par votre nature.
Et ceux qui ont vû la vanité de cette pretention vous ont jetté dans l’autre precipice en vous faiſant entendre que voſtre nature eſtoit pareille à celle des beſtes, & vous ont porté a chercher voſtre bien dans les concupiſcences qui ſont le partage des animaux.	Et ceux qui ont vu la vanité de cette prétention vous ont jeté dans l’autre précipice en vous faisant entendre que votre nature était pareille à celle des bêtes, et vous ont porté a chercher votre bien dans les concupiscences qui sont le partage des animaux.
Ce n’eſt pas là le moyen de vous inſtruire de vos injuſtices.	Ce n’est pas là le moyen de vous instruire de vos injustices.
N’attendez donc ny verité ny conſolation des hommes.	N’attendez donc ni vérité ni consolation des hommes.
Je ſuis celle qui vous ay formé, & qui puis ſeule vous apprendre qui vous eſtes.	Je suis celle qui vous ai formé, et qui puis seule vous apprendre qui vous êtes.
Mais vous n’eſtes plus maintenant en l’eſtat où je vous ay formé.	Mais vous n’êtes plus maintenant en l’état où je vous ai formé.
Je l’ay remply de lumiere & d’intelligence.	Je l’ai rempli de lumière et d’intelligence.
Je luy ai communiqué ma gloire & mes merveilles.	Je lui ai communiqué ma gloire et mes merveilles.
Il n’eſtoit pas dans les tenebres qui l’aveuglent, ny dans la mortalité, & dans les miſeres qui l’affligent.	Il n’était pas dans les ténèbres qui l’aveuglent, ni dans la mortalité, et dans les misères qui l’affligent.
Mais il n’a pû ſoutenir tant de gloire ſans tomber dans la preſomption.	Mais il n’a pu soutenir tant de gloire sans tomber dans la présomption.
Il a voulu ſe rendre centre de luy meſme, & independant de mon ſecours.	Il a voulu se rendre centre de lui même, et indépendant de mon secours.
Il s’eſt ſouſtrait à ma domination:	Il s’est soustrait à ma domination:
& s’égalant à moy par le deſir de trouver la felicité en luy meſme, je l’ay abandonné à luy;	et s’égalant à moi par le désir de trouver la félicité en lui même, je l’ai abandonné à lui;
& revoltant toutes les creatures qui luy eſtoient ſoumises je les luy ay rendu ennemies;	et révoltant toutes les créatures qui lui étaient soumises je les lui ai rendu ennemies;
Les ſens independans de la raiſon & souvent maiſtres de la raiſon l’ont emporté à la recherche des plaiſirs.	Les sens indépendants de la raison et souvent maîtres de la raison l’ont emporté à la recherche des plaisirs.
Toutes les creatures ou l’affligent ou le tentent, & dominent sur luy ou en le ſoumettant par leur force, ou en le charmant par leurs douceurs, ce qui eſt encore une domination plus terrible & plus imperieuſe.	Toutes les créatures ou l’affligent ou le tentent, et dominent sur lui ou en le soumettant par leur force, ou en le charmant par leurs douceurs, ce qui est encore une domination plus terrible et plus impérieuse.
Il leur reſte quelque inſtinct impuiſſant du bonheur de leur premiere nature;	Il leur reste quelque instinct impuissant du bonheur de leur première nature;
& ils ſont plongez dans les miſeres de leur aveuglement & de leur concupiſcence qui eſt devenüe leur ſeconde nature.	et ils sont plongés dans les misères de leur aveuglement et de leur concupiscence qui est devenue leur seconde nature.
§ De ces principes que je vous ouvre vous pouvez reconnoiſtre la cauſe de tant de contrarietez qui ont étonné tous les hommes, & qui les ont partagez.	§ De ces principes que je vous ouvre vous pouvez reconnaître la cause de tant de contrariétés qui ont étonné tous les hommes, et qui les ont partagez.
§ Obſervez maintenant tous les mouvemens de grandeur & de gloire que ce ſentiment de tant de miſeres ne peut étoufer, & voyez s’il ne faut pas que la cauſe en ſoit une autre nature.	§ Observez maintenant tous les mouvements de grandeur et de gloire que ce sentiment de tant de misères ne peut étouffer, et voyez s’il ne faut pas que la cause en soit une autre nature.
§ Connoiſſez donc, ſuperbe, quel paradoxe vous eſtes à vous meſme.	§ Connaissez donc, superbe, quel paradoxe vous êtes à vous même.
Humiliez vous, raiſon impuiſſante;	Humiliez-vous, raison impuissante;
apprenez que l’homme paſſe infiniment l’homme;	apprenez que l’homme passe infiniment l’homme;
& entendez de voſtre Maiſtre voſtre condition veritable que vous ignorez.	et entendez de votre Maître votre condition véritable que vous ignorez.
Et ſi l’homme n’avoit jamais eſté que corrompû il n’auroit aucune idée ny de la verité ny de la beatitude.	Et si l’homme n’avait jamais été que corrompu il n’aurait aucune idée ni de la vérité ni de la béatitude.
Mais malheureux que nous ſommes, & plus que s’il n’y avoit aucune grandeur dans noſtre condition, nous avons une idée du bonheur, & ne pouvons y arriver;	Mais malheureux que nous sommes, et plus que s’il n’y avait aucune grandeur dans notre condition, nous avons une idée du bonheur, et ne pouvons y arriver;
nous ſentons une image de la verité, & ne poſſedons que le menſonge;	nous sentons une image de la vérité, et ne possédons que le mensonge;
incapables d’ignorer abſolument, & de ſçavoir certainement;	incapables d’ignorer absolument, et de savoir certainement;
tant il eſt manifeſte que nous avons eſté dans un degré de perfection dont nous ſommes malheureuſement tombez.	tant il est manifeste que nous avons été dans un degré de perfection dont nous sommes malheureusement tombés.
§ Qu’eſt-ce donc que nous crie cette avidité & cette impuiſſance, ſinon qu’il y a eu autrefois en l’homme un veritable bonheur dont il ne luy reſte maintenant que la marque & la trace toute vuide, qu’il eſſaye inutilement de remplir de tout ce qui l’environne, en cherchant dans les choſes abſentes le ſecours qu’il n’obtient pas des preſentes, & que les unes & les autres ſont incapables de luy donner, parce que ce goufre infiny ne peut eſtre remply que par un objet infiny & immuable?	§ Qu’est-ce donc que nous crie cette avidité et cette impuissance, sinon qu’il y a eu autrefois en l’homme un véritable bonheur dont il ne lui reste maintenant que la marque et la trace toute vide, qu’il essaye inutilement de remplir de tout ce qui l’environne, en cherchant dans les choses absentes le secours qu’il n’obtient pas des présentes, et que les unes et les autres sont incapables de lui donner, parce que ce gouffre infini ne peut être rempli que par un objet infini et immuable?
Car il eſt ſans doute qu’il n’y a rien qui choque plus noſtre raiſon que de dire que le peché du premier homme ait rendu coupables ceux qui eſtant ſi éloignez de cette ſource ſemblent incapables d’y participer.	Car il est sans doute qu’il n’y a rien qui choque plus notre raison que de dire que le péché du premier homme ait rendu coupables ceux qui étant si éloignez de cette source semblent incapables d’y participer.
Cet écoulement ne nous paroiſt pas ſeulement impoſſible, il nous ſemble meſme tres injuſte.	Cet écoulement ne nous paraît pas seulement impossible, il nous semble même très injuste.
Certainement rien ne nous heurte plus rudement que cette doctrine.	Certainement rien ne nous heurte plus rudement que cette doctrine.
Et cependant ſans ce myſtere le plus incomprehenſible de tous, nous ſommes incomprehenſibles à nous meſmes.	Et cependant sans ce mystère le plus incompréhensible de tous, nous sommes incompréhensibles à nous mêmes.
Le nœud de noſtre condition prend ſes retours & ſes plis dans cet abyſme.	Le nœud de notre condition prend ses retours et ses plis dans cet abîme.
De ſorte que l’homme est plus inconcevable ſans ce myſtere, que ce myſtere n’eſt inconcevable à l’homme.	De sorte que l’homme est plus inconcevable sans ce mystère, que ce mystère n’est inconcevable à l’homme.
§ Le peché originel eſt une folie devant les hommes;	§ Le péché originel est une folie devant les hommes;
mais on le donne pour tel.	mais on le donne pour tel.
Mais cette folie eſt plus ſage que toute la ſageſſe des hommesI.	Mais cette folie est plus sage que toute la sagesse des hommesI.
Cor.	Cor.
15.	15.
, Quod ſtultum eſt Dei ſapientius eſt hominibus.	, Quod stultum est Dei sapientius est hominibus.
Car ſans cela que dira-t’on qu’eſt l’homme?	Car sans cela que dira-t-on qu’est l’homme?
Tout ſon eſtat dépend de ce point imperceptible.	Tout son état dépend de ce point imperceptible.
Et comment s’en fuſt il apperceu par ſa raiſon, puiſque c’eſt une choſe contre ſa raiſon;	Et comment s’en fût-il aperçu par sa raison, puisque c’est une chose contre sa raison;
& que ſa raiſon bien loin de l’inventer par ſes voyes, s’en éloigne quand on le luy preſente?	et que sa raison bien loin de l’inventer par ses voies, s’en éloigne quand on le lui présente?
§ Suivons nos mouvemens, obſervons nous nous meſmes, & voyons ſi nous n’y trouverons pas les caracteres vivans de ces deux natures.	§ Suivons nos mouvements, observons nous nous mêmes, et voyons si nous n’y trouverons pas les caractères vivants de ces deux natures.
§ Tant de contradictions ſe trouveroient elles dans un ſujet ſimple?	§ Tant de contradictions se trouveraient elles dans un sujet simple?
§ Ainſi toutes ces contraritez qui ſembloient devoir le plus éloigner les hommes de la connoiſſance d’une Religion, ſont ce qui les doit plutoſt conduire à la veritable.	§ Ainsi toutes ces contrariétés qui semblaient devoir le plus éloigner les hommes de la connaissance d’une Religion, sont ce qui les doit plutôt conduire à la véritable.
Pour moy j’avoüe qu’auſſitoſt que la Religion Chreſtienne découvre ce principe que la nature des hommes eſt corrompüe & deſchüe de Dieu, cela ouvre les yeux à voir par tout le caractere de cette verité.	Pour moi j’avoue qu’aussitôt que la Religion Chrétienne découvre ce principe que la nature des hommes est corrompue et déchue de Dieu, cela ouvre les yeux à voir par tout le caractère de cette vérité.
Car la nature eſt telle qu’elle marque par tout un Dieu perdu, & dans l’homme, & hors de l’homme.	Car la nature est telle qu’elle marque par tout un Dieu perdu, et dans l’homme, et hors de l’homme.
Sans ces divines connoiſſances qu’on pû faire les hommes, ſinon ou s’élever dans le ſentiment interieur qui leur reſte de leur grandeur paſſée, ou s’abbattre dans la veüe de leur foibleſſe preſente?	Sans ces divines connaissances qu’on pu faire les hommes, sinon ou s’élever dans le sentiment intérieur qui leur reste de leur grandeur passée, ou s’abattre dans la vue de leur faiblesse présente?
Car ne voyant pas la verité entiere ils n’ont pû arriver à une parfaitte vertu;	Car ne voyant pas la vérité entière ils n’ont pu arriver à une parfaite vertu;
les uns conſiderans la nature comme incorrompuë, les autres comme irreparable.	les uns considérant la nature comme incorrompue, les autres comme irréparable.
puiſqu’ils ne pouvoient ſinon ou s’y abandonner par laſcheté, ou en ſortir par l’orgueüil.	puisqu’ils ne pouvaient sinon ou s’y abandonner par lâcheté, ou en sortir par l’orgueil.
Car s’ils connoiſſoient l’excellence de l’homme, ils en ignoroient la corruption;	Car s’ils connaissaient l’excellence de l’homme, ils en ignoraient la corruption;
Et s’ils reconnoiſſoient l’infirmité de la nature, ils en ignoroient la dignité;	Et s’ils reconnaissaient l’infirmité de la nature, ils en ignoraient la dignité;
de ſorte qu’ils pouvoient bien éviter la vanité, mais c’eſtoit en ſe précipitant dans le deſeſpoir.	de sorte qu’ils pouvaient bien éviter la vanité, mais c’était en se précipitant dans le désespoir.
De là viennent les diverſes ſectes des Stoïciens & des Epicuriens, des r Dogmatistes et des Academiciens, &c.	De là viennent les diverses sectes des Stoïciens et des Epicuriens, des Dogmatistes et des Académiciens, etc.
La ſeule Religion Chreſtienne a pû guerir ces deux vices;	La seule Religion Chrétienne a pu guérir ces deux vices;
non pas en chaſſant l’un part l’autre par la ſageſſe de la terre;	non pas en chassant l’un part l’autre par la sagesse de la terre;
mais en chaſſant l’un & l’autre par la ſimplicité de l’Evangile.	mais en chassant l’un et l’autre par la simplicité de l’Evangile.
& elle crie aux plus impies qu’ils ſont capables de la grace de leur Redempteur.	et elle crie aux plus impies qu’ils sont capables de la grâce de leur Rédempteur.
Ainſi donnant à trembler à ceux qu’elle juſtifie, & conſolant ceux qu’elle condamne, elle tempere avec tant de juſteſſe la crainte avec l’eſperance par cette double capacité qui eſt commune à tous & de la grace & du peché, qu’elle abbaiſſe infiniment plus que la ſeule raiſon ne peut faire, mais ſans deſeſperer;	Ainsi donnant à trembler à ceux qu’elle justifie, et consolant ceux qu’elle condamne, elle tempère avec tant de justesse la crainte avec l’espérance par cette double capacité qui est commune à tous et de la grâce et du péché, qu’elle abaisse infiniment plus que la seule raison ne peut faire, mais sans désespérer;
faiſant bien voir par là qu’eſtant ſeule exempte d’errer & de vice, ils n’appartient qu’à elle & d’inſtruire & de corriger les hommes.	faisant bien voir par là qu’étant seule exempte d’errer et de vice, ils n’appartient qu’à elle et d’instruire et de corriger les hommes.
§ Le Chriſtianiſme eſt étrange.	§ Le Christianisme est étrange.
Il ordonne à l’homme de reconnoiſtre qu’il eſt vil & meſme abominable, & luy ordonne en meſme temps de vouloir eſtre ſemblable à Dieu.	Il ordonne à l’homme de reconnaître qu’il est vil et même abominable, et lui ordonne en même temps de vouloir être semblable à Dieu.
Sans un tel contrepoids cette élevation le rendroit horriblement vain, ou cet abbaiſſement le rendroit horriblement abjet.	Sans un tel contrepoids cette élévation le rendrait horriblement vain, ou cet abaissement le rendrait horriblement abject.
§ La miſere porte au deſeſpoir la grandeur inſpire la preſomption.	§ La misère porte au désespoir la grandeur inspire la présomption.
§ L’Incarnation monſtre à l’homme la grandeur de ſa miſere par la grandeur du remede qu’il a fallu.	§ L’Incarnation montre à l’homme la grandeur de sa misère par la grandeur du remède qu’il a fallu.
§ Il n’y a point de doctrine plus propre à l’homme que celle-là, qui l’inſtruit de ſa double capacité de recevoir & de perdre la grace, à cauſe du double peril où il eſt toûjours expoſé de deſeſpoir ou d’orgueüil.	§ Il n’y a point de doctrine plus propre à l’homme que celle-là, qui l’instruit de sa double capacité de recevoir et de perdre la grâce, à cause du double péril où il est toujours exposé de désespoir ou d’orgueil.
§ Les Philoſophes ne preſcrivent point des ſentimens proportionnez aux deux eſtats.	§ Les Philosophes ne prescrivent point des sentiments proportionnés aux deux états.
Ils inſpiroient des mouvemens de baſſeſſe pure, & c’eſt auſſi peu l’eſtat de l’homme.	Ils inspiraient des mouvements de bassesse pure, et c’est aussi peu l’état de l’homme.
Il faut des mouvemens de baſſeſſe, non d’une baſſeſſe de nature, mais de penitence;	Il faut des mouvements de bassesse, non d’une bassesse de nature, mais de pénitence;
non pour y demeurer, mais pour aller à la grandeur.	non pour y demeurer, mais pour aller à la grandeur.
Il faut des mouvemens de grandeur, mais d’une grandeur qui vienne de la grace & non du merite, & aprés avoir paſſé par la baſſeſſe.	Il faut des mouvements de grandeur, mais d’une grandeur qui vienne de la grâce et non du mérite, et après avoir passé par la bassesse.
§ Nul n’eſt heureux comme un vray Chreſtien, ny raiſonnable, ny vertueux, ny aimable.	§ Nul n’est heureux comme un vrai Chrétien, ni raisonnable, ni vertueux, ni aimable.
Avec combien peu d’orgueüil un Chreſtien ſe croit-il uny à Dieu?	Avec combien peu d’orgueil un Chrétien se croit-il uni à Dieu?
§ Qui peut donc refuſer à ces celeſtes lumieres de les croire, & de les adorer?	§ Qui peut donc refuser à ces célestes lumières de les croire, et de les adorer?
Car n’eſt-t’il pas plus clair que le jour que nous ſentons en nous meſmes des caracteres ineffaçables d’excellence?	Car n’est-t-il pas plus clair que le jour que nous sentons en nous mêmes des caractères ineffaçables d’excellence?
Que nous crie donc ce cahos & cette confuſion monſtrueuſe, ſinon la verité de ces deux eſtats, avec une voix ſi puiſſante, qu’il eſt impoſſible d’y reſiſter?	Que nous crie donc ce chaos et cette confusion monstrueuse, sinon la vérité de ces deux états, avec une voix si puissante, qu’il est impossible d’y résister?
