SEigneur, en attendant que Scipion vous voye,	SEigneur, en attendant que Scipion vous voit,
Je me tiens honoré de l’ordre qu'il m’envoye,	Je me tiens honoré de l’ordre qu’il m’envoie,
Nous ſçaurons d’Annibal les ſecrets ſentimens,	Nous saurons d’Hannibal les secrets sentiments,
C'eſt vous qui dans ce Camp annoncez ſa venuë.	C’est vous qui dans ce Camp annoncez sa venue.
Je viens la demander, c’eſt ſon intention	Je viens la demander, c’est son intention
Que de voir aujourd'hui le fameux Scipion;	Que de voir aujourd’hui le fameux Scipion;
Aux plaines de Zama nous ſommes l'un & l’autre,	Aux plaines de Zama nous sommes l’un et l’autre,
Nôtre Armée eſt campée aſſez prés de la vôtre;	Notre Armée est campée assez près de la vôtre;
Mais Annibal prétend avec luy conferer,	Mais Hannibal prétend avec lui conférer,
Et je viens en ce Camp pour en déliberer,	Et je viens en ce Camp pour en délibérer,
Sans doute qu'on ne peut refuſer de l'entendre;	Sans doute qu’on ne peut refuser de l’entendre;
Nous verrons aujourd'hui ces deux grands Citoyens,	Nous verrons aujourd’hui ces deux grands Citoyens,
Donner ce peu de tréve à cette longue guerre,	Donner ce peu de trêve à cette longue guerre,
Pour décider entre-eux du deſtin de la terre,	Pour décider entre eux du destin de la terre,
Et de leur conference on attend deſormais	Et de leur conférence on attend désormais
Le jour de la bataille, ou celuy de la paix.	Le jour de la bataille, ou celui de la paix.
Je ne m'explique point des deſſeins de mon Maître,	Je ne m’explique point des desseins de mon Maître,
Il paroîtra luy-même, & les fera connoître,	Il paraîtra lui-même, et les fera connaître,
Seigneur, de Scipion ont remply les projets?	Seigneur, de Scipion ont rempli les projets?
La vicoire en tous lieux à ſon bras enchaînée	La victoire en tous lieux à son bras enchaînée
Jeune encor, on a vû ſes grandes actions	Jeune encore, on a vu ses grandes actions
Suivre, & même paſſer celles des Scipions,	Suivre, et même passer celles des Scipions,
Et digne rejeton de cette illuſtre race,	Et digne rejeton de cette illustre race,
A vingt ans on l'a vû commander en leur place;	À vingt ans on l’a vu commander en leur place;
Il nous chaſſa d’Eſpagne aprés quatre combats,	Il nous chassa d’Espagne après quatre combats,
Où Rome triompha par l’effort de ſon bras,	Où Rome triompha par l’effort de son bras,
Il arrache Annibal du ſein de l'Italie.	Il arrache Hannibal du sein de l’Italie.
Et contraint ce Heros de voler en ces lieux,	Et contraint ce Héros de voler en ces lieux,
S’il acheve, Seigneur, cette heureuſe campagne,	S’il achève, Seigneur, cette heureuse campagne,
Dans l'Affrique il fera ce qu'il fit en Eſpagne:	Dans l’Afrique il fera ce qu’il fit en Espagne:
Un des plus puiſſans Rois qui fut dans l’Univers,	Un des plus puissants Rois qui fût dans l’Univers,
L’infidelle Syphax a pery dans ſes fers,	L’infidèle Syphax a péri dans ses fers,
Aſdrubal & Xantus ont perdu trois batailles,	Asdrubal et Xantus ont perdu trois batailles,
Cartage va nous voir au pied de ſes murailles,	Carthage va nous voir au pied de ses murailles,
D’appeller Annibal pour luy ſervir d’appuy,	D’appeler Hannibal pour lui servir d’appui,
Scipion la menace, & l’on voit ce grand homme	Scipion la menace, et l’on voit ce grand homme
Il vient de ſes ſuccés interrompre le cours,	Il vient de ses succès interrompre le cours,
Et promet à l’Affrique un fidele ſecours.	Et promet à l’Afrique un fidèle secours.
Son nom ſeul raffermit nos Provinces craintives;	Son nom seul raffermit nos Provinces craintives;
Mais puis-je m’informer des illuſtres captives	Mais puis-je m’informer des illustres captives
Que Zama pris d’aſſaut vit tomber dans vos fers;	Que Zama pris d’assaut vit tomber dans vos fers;
La Niéce d’Annibal les a-t-elle ſouffers?	La Nièce d’Hannibal les a-t-elle soufferts?
S'eſt-elle accoûtumée à porter une chaîne?	S’est-elle accoutumée à porter une chaîne?
Que leur chaîne, Seigneur, eſt facile à porter?	Que leur chaîne, Seigneur, est facile à porter?
Au Camp de Scipion elles ſont ſouveraines,	Au Camp de Scipion elles sont souveraines,
Il les traite bien moins en eſclaves qu’en Reines,	Il les traite bien moins en esclaves qu’en Reines,
Il n’a plus de fierté ſi-tôt qu’il eſt vainqueur,	Il n’a plus de fierté sitôt qu’il est vainqueur,
Sa bonté, ſa clemence égalent ſa valeur;	Sa bonté, sa clémence égalent sa valeur;
Oüy, ſon bras aux vaincus ne fut jamais funeſte,	Oui, son bras aux vaincus ne fut jamais funeste,
La victoire ne ſert qu'à le rendre modeſte,	La victoire ne sert qu’à le rendre modeste,
Il n’eſt jamais ſuperbe en la proſperité.	Il n’est jamais superbe en la prospérité.
La Niéce d’Annibal, l’adorable Iſperie,	La Nièce d’Hannibal, l’adorable Ispérie,
Qu'il en fut ébloüy: mais enfin ſa beauté	Qu’il en fut ébloui: mais enfin sa beauté
Porte un charme ſecret dont on eſt enchanté.	Porte un charme secret dont on est enchanté.
Au Prince Lucejus elle ſe vit promiſe,	Au Prince Lucejus elle se vit promise,
Il devoit l’épouſer quand Zama fut ſurpriſe;	Il devait l’épouser quand Zama fut surprise;
Ce jour infortuné ſi funeſte pour eux	Ce jour infortuné si funeste pour eux
Sépara ces Amans ſur le point d’eſtre heureux:	Sépara ces Amants sur le point d’être heureux:
Et ſouvent ſes beaux yeux pour luy verſent des larmes:	Et souvent ses beaux yeux pour lui versent des larmes:
Mais, Seigneur, Erixene en ce lieu doit venir,	Mais, Seigneur, Erixène en ce lieu doit venir,
Je vois qu’elle s’avance, & vous laiſſe avecque elle.	Je vois qu’elle s’avance, et vous laisse avec elle.
ON nous vient d’annoncer une grande nouvelle,	ON nous vient d’annoncer une grande nouvelle,
Annibal en Affrique eſt enfin de retour.	Hannibal en Afrique est enfin de retour.
Vous le verrez, Madame, avant la fin du jour.	Vous le verrez, Madame, avant la fin du jour.
Je ſçay que dans l'état où l’Affrique eſt reduite,	Je sais que dans l’état où l’Afrique est réduite,
Elle n’eſpere plus qu’en ſa ſeule conduite;	Elle n’espère plus qu’en sa seule conduite;
Je prévois, Aurilcar, qu’ils tendent a la paix.	Je prévois, Aurilcar, qu’ils tendent à la paix.
Vous avez penetré ce que veut ſa prudence,	Vous avez pénétré ce que veut sa prudence,
Mais, Madame, que dit, & que fait Scipion?	Mais, Madame, que dit, et que fait Scipion?
Son jeune cœur n'a-t-il que de l'ambition?	Son jeune cœur n’a-t-il que de l’ambition?
Les charmes d'Erixene, ou les yeux d’Iſperie	Les charmes d’Erixène, ou les yeux d’Ispérie
N'ont-ils pû rendre encor ſa grande ame attendrie?	N’ont-ils pu rendre encor sa grande âme attendrie?
Pardonnez...	Pardonnez…
Apprenez un ſecret important,	Apprenez un secret important,
Depuis peu dans ſon Camp ſa flâme eſt allumée.	Depuis peu dans son Camp sa flamme est allumée,
Bien que ſa paſſion dans ſon cœur renfermée	Bien que sa passion dans son cœur renfermée
Qu’il faſſe des efforts en vain pour l’arracher,	Qu’il fasse des efforts en vain pour l’arracher,
J’ay connu cependant, même par ſa contrainte,	J’ai connu cependant, même par sa contrainte,
Que d’un feu violent ſon ame étoit atteinte.	Que d’un feu violent son âme était atteinte.
Il faut d'un tel ſecret qu'Annibal ſoit inſtruit,	Il faut d’un tel secret qu’Hannibal soit instruit,
Sa prudence pouroit en tirer quelque fruit;	Sa prudence pourrait en tirer quelque fruit;
Car ſi de Scipion on fléchit le courage,	Car si de Scipion on fléchit le courage,
Hé quoy? ſi de l’amour il reſſentoit les coups?	Hé quoi? si de l’amour il ressentait les coups?
Et s’il étoit charmé d’Iſperie, ou de vous,	Et s’il était charmé d’Ispérie, ou de vous,
A connoître les cœurs je ne ſuis pas habile;	À connaître les cœurs je ne suis pas habile;
Mais j’ay crû dêmeſler dans ſon trouble ſecret,	Mais j’ai crû démêler dans son trouble secret,
Qu'il aime une des deux, & qu'il l’aime à regret;	Qu’il aime une des deux, et qu’il l’aime à regret;
Plus j'obſerve pour nous ſes yeux & ſa conduite,	Plus j’observe pour nous ses yeux et sa conduite,
Plus je vois qu’il nous cherche alors qu’il nous évite;	Plus je vois qu’il nous cherche alors qu’il nous évite;
Quand il nous voit enſemble il demeure interdit,	Quand il nous voit ensemble il demeure interdit,
Et quand il s'aperçoit du trouble de ſon ame,	Et quand il s’aperçoit du trouble de son âme,
Il ſemble s’indigner de ſa naiſſante flâme,	Il semble s’indigner de sa naissante flamme,
Et que tout ſon courage a peine à ſurmonter.	Et que tout son courage a peine à surmonter.
Voila le plan d’un cœur difficile à connoître;	Voila le plan d’un cœur difficile à connaître;
Mais pour aprofondir qui peut en eſtre maître,	Mais pour approfondir qui peut en être maître,
Je ſçay trop qu’Iſperie a des charmes puiſſans,	Je sais trop qu’Ispérie a des charmes puissants,
Que ſa beauté d’abord peut enchanter les ſens,	Que sa beauté d’abord peut enchanter les sens,
Mais à ſon cher Amant elle eſt trop attachée,	Mais à son cher Amant elle est trop attachée,
Scipion le connoît.	Scipion le connaît.
Madame, & plût aux Dieux!	Madame, et plût aux Dieux!
Je ne m'en flatte point, mais ſans eſtre trop vaine,	Je ne m’en flatte point, mais sans être trop vaine,
Scipion ſans rougir pouroit porter ma chaîne,	Scipion sans rougir pourrait porter ma chaîne,
Que dis-je? ce Heros, le plus grand des mortels,	Que dis-je? ce Héros, le plus grand des mortels,
A qui Rome déja conſacre des Autels,	À qui Rome déjà consacre des Autels,
D'un cœur tel que le mien peut devenir le maître,	D’un cœur tel que le mien peut devenir le maître,
Et s'il n’eſt mon Amant il eſt digne de l'eſtre.	Et s’il n’est mon Amant il est digne de l’être.
Un foible, dont mon cœur me faiſoit un ſecret;	Un faible, dont mon cœur me faisait un secret;
Mais quoy? Si l’on faiſoit la paix avec Cartage,	Mais quoi? Si l’on faisait la paix avec Carthage,
Et du moins je voudrois pour flater ma fierté,	Et du moins je voudrais pour flatter ma fierté,
Que l'heureuſe Erixene eût part à ce traité.	Que l’heureuse Erixène eût part à ce traité.
Adieu, Scipion vient, & vous allez l’entendre.	Adieu, Scipion vient, et vous allez l’entendre.
ESt-il donc vray, Seigneur, ce qu’on vient de m'apprendre,	Est-il donc vrai, Seigneur, ce qu’on vient de m’apprendre,
Que le grand Annibal cherche à m’entretenir?	Que le grand Hannibal cherche à m’entretenir?
Seigneur, ſur ce ſujet je viens vous prévenir,	Seigneur, sur ce sujet je viens vous prévenir,
Annibal, par ma bouche aujourd'hui vous en prie;	Hannibal, par ma bouche aujourd’hui vous en prie;
Une telle entreveuë utile à ſon païs,	Une telle entrevue utile à son pays,
Pouroit en ce grand jour décidant de la guerre,	Pourrait en ce grand jour décidant de la guerre,
Donner un plein repos au reſte de la terre.	Donner un plein repos au reste de la terre.
Annibal me ſurprend par ce nouveau deſſein,	Hannibal me surprend par ce nouveau dessein,
Je ne le croyois voir que le fer à la main,	Je ne le croyais voir que le fer à la main,
Et ſeur de ſa valeur & de ſa renommée,	Et sûr de sa valeur et de sa renommée,
Je l'attendois toujours en tête d’une Armée.	Je l’attendais toujours en tête d’une Armée.
Avant que de tenter le deſtin des combats,	Avant que de tenter le destin des combats,
Il a cru pour le bien de chaque Republique,	Il a cru pour le bien de chaque République,
Examiner à fonds les divers intereſts	Examiner à fond les divers intérêts
Qui troublent nos Etats par des reſſors ſecrets,	Qui troublent nos États par des ressorts secrets,
Et les ayant tous mis dans la juſte balance,	Et les ayant tous mis dans la juste balance,
En peſer à loiſir les raiſons, l'importance,	En peser à loisir les raisons, l’importance,
Pour garder à chacun & ſa gloire & ſon rang;	Pour garder à chacun et sa gloire et son rang;
Souvent une entreveuë épargne bien du ſang,	Souvent une entrevue épargne bien du sang,
Hé bien? pour luy marquera quel point je l’honore	Hé bien? pour lui marquer à quel point je l’honore
J’accepte l’entreveuë, & veux bien differer	J’accepte l’entrevue, et veux bien différer
Pour lever tout ombrage & toute défiance,	Pour lever tout ombrage et toute défiance,
Qu’il choiſiſſe un lieu propre à cette conference,	Qu’il choisisse un lieu propre à cette conférence,
Je m’y rendray, Seigneur, au jour qu’il nommera,	Je m’y rendrai, Seigneur, au jour qu’il nommera,
Et ne ſeray ſuivy qu’autant qu’il le ſera.	Et ne serai suivi qu’autant qu’il le sera.
Il prétend dans ce Camp venir bien-tôt luy-même.	Il prétend dans ce Camp venir bientôt lui-même.
Quoy! luy-même en mon Camp, ma ſurpriſe eſt extrême?	Quoi! lui-même en mon Camp, ma surprise est extrême?
Que demande-t-il qui puiſſe...	Que demande-t-il qui puisse…
Vôtre foy.	Votre foi.
Il veut de Scipion la parole pour gage,	Il veut de Scipion la parole pour gage,
Hé quel ôtage peut remplacer Annibal?	Hé quel otage peut remplacer Hannibal?
Je ſçay qu’il n’en eſt point pour un tel General.	Je sais qu’il n’en est point pour un tel Général.
Et puiſqu'il ſe confie en ma ſeule parole,	Et puisqu’il se confie en ma seule parole,
Je jure par les Dieux appuis du Capitole,	Je jure par les Dieux appuis du Capitole,
Qu’il peut en ſeureté ſe fier à ma foy,	Qu’il peut en sûreté se fier à ma foi,
Seigneur, c’en eſt aſſez.	Seigneur, c’en est assez.
Allez, je vais l’attendre,	Allez, je vais l’attendre,
Mais preſſez l'entreveuë où j’ay dû conſentir,	Mais pressez l’entrevue où j’ai dû consentir,
Et voyez Iſperie avant que de partir.	Et voyez Ispérie avant que de partir.
LEpide, que crois-tu de cette conference	LÉpide, que crois-tu de cette conférence
Qu’Annibal me demande avecque tant d'inſtance;	Qu’Hannibal me demande avec tant d’instance;
Son invincible bras, la terreur des Romains,	Son invincible bras, la terreur des Romains,
Son grand coeur, ſa conduite, & ſes vaſtes deſſeins	Son grand cœur, sa conduite, et ses vastes desseins
Long-temps de la fortune il fixa le caprice;	Longtemps de la fortune il fixa le caprice;
De Trebie, & ſur tout de Cannes le malheur,	De Trébie, et sur tout de Cannes le malheur,
Sur les deux Scipions ſa derniere victoire,	Sur les deux Scipions sa dernière victoire,
Tout enfin a ſervy de trophée à ſa gloire:	Tout enfin a servi de trophée à sa gloire:
Cependant ce vainqueur aprés tant de combats	Cependant ce vainqueur après tant de combats
Envoye à Scipion, & fait les premiers pas,	Envoie à Scipion, et fait les premiers pas,
Il dément la fierté de ſon a me hautaine.	Il dément la fierté de son âme hautaine.
Que me vient propoſer ce fameux Capitaine?	Que me vient proposer ce fameux Capitaine?
Fremit en ce moment du ſeul mot de traité.	Frémit en ce moment du seul mot de traité.
S’il demande la paix, n’eſtes-vous pas le maître	S’il demande la paix, n’êtes-vous pas le maître
Apprens à me connoître.	Apprends à me connaître.
Si dans cette entreveuë il propoſe la paix,	Si dans cette entrevue il propose la paix,
Ma gloire me défend d’y conſentir jamais.	Ma gloire me défend d’y consentir jamais.
Quelques conditions que j'impoſe à Cartage,	Quelques conditions que j’impose à Carthage,
Quand Rome la verroit reduite à l'eſclavage,	Quand Rome la verrait réduite à l’esclavage,
Je ne fais rien pour moy, ſi dans un jour fatal	Je ne fais rien pour moi, si dans un jour fatal
Voila donc l'intereſt le premier de ma gloire;	Voila donc l’intérêt le premier de ma gloire;
J'en ay d’autres ſecrets que tu ne pouras croire,	J’en ai d’autres secrets que tu ne pourras croire,
Je ſens ce que jamais je n’avois reſſenty.	Je sens ce que jamais je n’avais ressenti.
Vous, Seigneur?	Vous, Seigneur?
Je te veux ouvrir toute mon ame,	Je te veux ouvrir toute mon âme,
Je ne ſçay ſi je dois donner le nom de flâme	Je ne sais si je dois donner le nom de flamme
A ce trouble mortel dont je ſuis agité;	À ce trouble mortel dont je suis agité;
Qu’on l’ignore à jamais dans la poſterité?	Qu’on l’ignore à jamais dans la postérité?
Lepide, quelquefois j’ay pitié de moy-même,	Lépide, quelquefois j’ai pitié de moi-même,
Je combats, mais en vain un rapide penchant,	Je combats, mais en vain un rapide penchant,
Je rougis d’en ſentir les mortelles atteintes,	Je rougis d’en sentir les mortelles atteintes,
J’ay voulu te cacher mon deſordre, mes craintes;	J’ai voulu te cacher mon désordre, mes craintes;
Mais il faut t’avoüer mon foible avec douleur.	Mais il faut t’avouer mon faible avec douleur.
La priſe de Zama coûte cher à mon cœur.	La prise de Zama coûte cher à mon cœur.
Je vous entends, Seigneur, des atteintes ſi vives	Je vous entends, Seigneur, des atteintes si vives
Sont de l’amour...	Sont de l’amour…
je tremble ſeulement d’en prononcer le nom,	Je tremble seulement d’en prononcer le nom,
A ſoûmis, a vaincu le cœur de Scipion;	A soumis, a vaincu le cœur de Scipion;
Un charme ébloüiſſant brille ſur ſon viſage,	Un charme éblouissant brille sur son visage,
Un air plein de grandeur, une noble fierté,	Un air plein de grandeur, une noble fierté,
L’éclat & la douceur jointe à la majeſté,	L’éclat et la douceur jointe à la majesté,
Mille & mille vertus, une grace infinie...	Mille et mille vertus, une grâce infinie…
Enfin ne dois-tu pas reconnoître Iſperie.	Enfin ne dois-tu pas reconnaître Ispérie.
Hé? qui pouroit la voir ſans en eſtre ſurpris,	Hé? qui pourrait la voir sans en être surpris,
Ses yeux...	Ses yeux…
Ne flates point mon panchant, ma foibleſſe,	Ne flatte point mon penchant, ma faiblesse,
Contre un feu ſi fatal prête-moy du ſecours,	Contre un feu si fatal prête-moi du secours,
Sauve moy, s’il ſe peut, de l’abîme où je cours:	Sauve-moi, s’il se peut, de l’abîme où je cours:
D’Iſperie, il eſt vray, je redoutois la veuë,	D’Ispérie, il est vrai, je redoutais la vue,
Je ſentois à ſes yeux mon ame trop émeuë,	Je sentais à ses yeux mon âme trop émue,
J'ay voulu l’éviter, vaine précaution!	J’ai voulu l’éviter, vaine précaution!
Par l’abſence j’ay cru vaincre ma paſſion,	Par l’absence j’ai cru vaincre ma passion,
Mais enfin je la vis, elle verſoit des larmes,	Mais enfin je la vis, elle versait des larmes,
C’eſtoit pour ſon Amant, & j'en fus offenſé,	C’était pour son Amant, et j’en fus offensé,
Et ſes pleurs, ſes ſoûpirs, ſa langueur, ſa triſteſſe,	Et ses pleurs, ses soupirs, sa langueur, sa tristesse,
Me firent vivement reſſentir ma foibleſſe,	Me firent vivement ressentir ma faiblesse,
Je n'en ſuis plus le maître, & malgré mes efforts	Je n’en suis plus le maître, et malgré mes efforts
Je ſuccombe, Lepide, à de ſi doux transports.	Je succombe, Lépide, à de si doux transports.
Il eſt vray qu’elle eſt belle, & digne d'eſtre aimée.	Il est vrai qu’elle est belle, et digne d’être aimée.
Plus je reſiſte, & plus j’en ay l’ame charmée,	Plus je résiste, et plus j’en ai l’âme charmée,
Prés d’elle je contrains, j’étouffe mes ſoûpirs:	Prés d’elle je contrains, j’étouffe mes soupirs:
Mais dieux! elle eſt ſans ceſſe en de triſtes allarmes,	Mais dieux! elle est sans cesse en de tristes alarmes,
Ma fatale victoire a trahy ſes deſſeins,	Ma fatale victoire a trahi ses desseins,
Elle doit me haïr, Lepide, & je le crains.	Elle doit me haïr, Lépide, et je le crains.
Vous pouriez voir, Seigneur, vôtre flâme trompée,	Vous pourriez voir, Seigneur, votre flamme trompée,
Du Prince Lucejus elle eſt préocupée,	Du Prince Lucejus elle est préoccupée,
Vous l’avez enlevée aux bras de cet époux.	Vous l’avez enlevée aux bras de cet époux.
Il l'épouſoit? ah Ciel! que ſon ſort étoit doux?	Il l’épousait? ah Ciel! que son sort était doux?
Eſt-il dans l’univers rien qui ſoit digne d’elle?	Est-il dans l’univers rien qui soit digne d’elle?
Mais que veut Annibal? quel accord, quel traité?	Mais que veut Hannibal? quel accord, quel traité?
Eſt-ce pour Lucejus, pour elle, ou pour Cartage	Est-ce pour Lucejus, pour elle, ou pour Carthage
Qu'il vient... dure à jamais plûtôt ſon eſclavage!	Qu’il vient… dure à jamais plutôt son esclavage!
Apprens que Scipion ne la rendra jamais,	Apprends que Scipion ne la rendra jamais,
Elle eſt ſeule un obſtacle invincible à la paix;	Elle est seule un obstacle invincible à la paix;
Ainſi donc plus d’accord, ny même d’entreveuë.	Ainsi donc plus d’accord, ni même d’entrevue.
Mais vous l'avez promiſe, & dans peu la venuë	Mais vous l’avez promise, et dans peu la venue
Il eſt vray, j'ay promis	Il est vrai, j’ai promis
D'entendre le plus fier de tous nos ennemis;	D’entendre le plus fier de tous nos ennemis;
Je dois la regarder en mortelle ennemie,	Je dois la regarder en mortelle ennemie,
La Niéce d'Annibal tenteroit ma vertu?	La Nièce d’Hannibal tenterait ma vertu?
Le plus grand ennemy que jamais Rome ait eu?	Le plus grand ennemi que jamais Rome ait eu?
Non, Lepide, aujourd’huy je dois briſer ma chaîne.	Non, Lépide, aujourd’hui je dois briser ma chaîne.
Seigneur portez vos vœux du côté d’Erixene.	Seigneur, portez vos vœux du côté d’Erixène.
Elle eſt fille d’Hannon ennemy d’Annibal,	Elle est fille d’Hannon ennemi d’Hannibal,
Toujours dans le Senat à ce Heros contraire,	Toujours dans le Sénat à ce Héros contraire,
Dans Rome il n’eut jamais de plus grand adverſaire,	Dans Rome il n’eut jamais de plus grand adversaire,
Il paroiſſoit plûtôt l’allié des Romains;	Il paraissait plutôt l’allié des Romains;
Aux charmes d'Iſperie oppoſez Erixene,	Aux charmes d’Ispérie opposez Erixène,
Et prenez un amour conforme à vôtre haine,	Et prenez un amour conforme à votre haine,
Elle peut balancer vos deſirs à ſon tour,	Elle peut balancer vos désirs à son tour,
Et même elle pouroit répondre à vôtre amour.	Et même elle pourrait répondre à votre amour.
Erixene	Erixène!
Toute ſa fierté tombe en nous voyant paroître:	Toute sa fierté tombe en vous voyant paraître:
Quand on parle de vous, il le faut avoüer,	Quand on parle de vous, il le faut avouer,
Et lorſque vos regards tournent vers Iſperie,	Et lorsque vos regards tournent vers Ispérie,
Dans ſon dépit ſecret on lit ſa jalouſie;	Dans son dépit secret on lit sa jalousie;
Elle voudroit bien voir ſes charmes effacez,	Elle voudrait bien voir ses charmes effacés,
Elle la hait enfin, en eſt-ce pas aſſez?	Elle la hait enfin, en est-ce pas assez?
Elle hait Iſperie, ah Ciel! quelle injuſtice?	Elle hait Ispérie, ah Ciel! quelle injustice?
Par qu’elle jalouſie, ou plûtôt quel caprice,	Par quelle jalousie, ou plutôt quel caprice,
Ce que la main des Dieux forma de plus parfait.	Ce que la main des Dieux forma de plus parfait.
Je m’égare, Lepide, & tu vois ma foibleſſe,	Je m’égare, Lépide, et tu vois ma faiblesse,
Apprenons cependant ce qu’Aurilcar a fait,	Apprenons cependant ce qu’Aurilcar a fait,
Peut-eſtre qu’Iſperie aura ſçû quel projet	Peut-être qu’Ispérie aura su quel projet
Annibal peut former, & qu’elle eſt ſa conduite,	Hannibal peut former, et quelle est sa conduite,
De ſes deſſeins ſans doute elle doit eſtre inſtruite;	De ses desseins sans doute elle doit être instruite;
Je veux ſonder ſon coeur, je veux eſtre éclaircy	Je veux sonder son cœur, je veux être éclairci
Des ſecretes raiſons qui l'amenent icy.	Des secrètes raisons qui l’amènent ici.
Du Prince Lucejus on n'a point de nouvelles,	Du Prince Lucejus on n’a point de nouvelles,
Aurilcar m'a parlé ſans m'avoir rien appris	Aurilcar m’a parlé sans m’avoir rien appris
Il m’apprend qu’Annibal, ce Heros que j'honore,	Il m’apprend qu’Hannibal, ce Héros que j’honore,
Viendra; mais Lucejus ne paroit point encore;	Viendra; mais Lucejus ne paraît point encore;
Devoit-il pas aller au devant de ſes pas?	Devait-il pas aller au devant de ses pas?
Le joindre dans ſon Camp, y mener ſes ſoldats?	Le joindre dans son Camp, y mener ses soldats?
Que fait-il? en quels lieux avec indifference,	Que fait-il? en quels lieux avec indifférence,
Depuis deux mois entiers ſouffre-t-il mon abſence?	Depuis deux mois entiers souffre-t-il mon absence?
Sans doute que mon cœur eſt d’un trop foible prix;	Sans doute que mon cœur est d’un trop faible prix;
Et ne devoit-il pas au peril de ſa teſte,	Et ne devait-il pas au péril de sa tête,
Il n’a rien fait encor pour me prouver ſa foy,	Il n’a rien fait encor pour me prouver sa foi,
Je ne merite pas qu’il s'expoſe pour moy.	Je ne mérite pas qu’il s’expose pour moi.
Eh? pouvez-vous douter que ce Prince vous aime,	Eh? pouvez-vous douter que ce Prince vous aime,
Madame, rapellez ſon deſeſpoir extrême,	Madame, rappelez son désespoir extrême,
Quand Zama pris d'aſſaut le ſépara de vous:	Quand Zama pris d’assaut le sépara de vous:
Ce malheureux Amant dans ſon juſte couroux,	Ce malheureux Amant dans son juste courroux,
Je deſarmay ſon bras au ſeul nom d’Iſperie,	Je désarmai son bras au seul nom d’Ispérie,
Et peut-eſtre...	Et peut-être…
Pourquoy me rapeller ce triſte ſouvenir?	Pourquoi me rappeler ce triste souvenir?
O nuit! qui preceda la fatale journée	O nuit! qui précéda la fatale journée
Qui devoir éclairer un heureux hymenée!	Qui devait éclairer un heureux hyménée!
Au lieu de me livrer au malheur qui me ſuit,	Au lieu de me livrer au malheur qui me suit,
Que n’es-tu devenuë une éternelle nuit?	Que n’es-tu devenue une éternelle nuit?
Lors qu’on vint nous donner de ſi vives allarmes,	Lors qu’on vint nous donner de si vives alarmes,
Que le fer à la main je vis tant de ſoldats	Que le fer à la main je vis tant de soldats
En foule en mon Palais précipiter leurs pas;	En foule en mon Palais précipiter leurs pas;
Je demeuray long-temps immobile & ſans vie,	Je demeurai longtemps immobile et sans vie,
Scipion m’aperçût, ſon zele officieux	Scipion m’aperçût, son zèle officieux
Me prêta du ſecours, me fit ouvrir les yeux,	Me prêta du secours, me fit ouvrir les yeux,
A ſon air, à ſon port je connus ce grand homme,	À son air, à son port je connus ce grand homme,
La terreur de Cartage & la gloire de Rome,	La terreur de Carthage et la gloire de Rome,
Et ſans qu’il eût beſoin qu’on prononçât ſon nom,	Et sans qu’il eût besoin qu’on prononçât son nom,
Depuis de mille ſoins je luy ſuis redevable;	Depuis de mille soins je lui suis redevable;
Cependant aujourd'huy c’eſt luy ſeul qui m’accable,	Cependant aujourd’hui c’est lui seul qui m’accable,
Et ſans luy je ſerois unie à Lucejus.	Et sans lui je serais unie à Lucejus.
Madame pouvez-vous murmurer de ſa chaîne?	Madame pouvez-vous murmurer de sa chaîne?
Ce Heros vous regarde & traite en ſouveraine,	Ce Héros vous regarde et traite en souveraine,
Vôtre nom dans Zama ſeroit moins reſpecté,	Votre nom dans Zama serait moins respecté,
Vous eſtes dans ton Camp en pleine liberté,	Vous estes dans son Camp en pleine liberté,
Sans gardes, ſans témoins, il met toute ſa gloire	Sans gardes, sans témoins, il met toute sa gloire
Et ſi je m'en raporte à des regards plus doux,	Et si je m’en rapporte à des regards plus doux,
Le ſeul reſpect n’eſt pas tout ce qu'il ſent pour vous.	Le seul respect n’est pas tout ce qu’il sent pour vous.
Je ſonge à mon Amant & néglige le reſte,	Je songe à mon Amant et néglige le reste,
Tous les autres objets me touchent foiblement,	Tous les autres objets me touchent faiblement,
Qu'un cœur eſt malheureux d'aimer ſi tendrement?	Qu’un cœur est malheureux d’aimer si tendrement?
Mais ce Prince m'oublie & j’en ſuis outragée,	Mais ce Prince m’oublie et j’en suis outragée,
Il n'y faut plus penſer pour en eſtre vangée,	Il n’y faut plus penser pour en être vengée,
Dans un lâche repos s’il eſt enſevely,	Dans un lâche repos s’il est enseveli,
Me laiſſer à long-temps languir dans l'eſclavage?	Me laisser si longtemps languir dans l’esclavage?
Eſt-ce faute d’amour, ou faute de courage?	Est-ce faute d’amour, ou faute de courage?
S’il manque de courage eſt-il digne de moy?	S’il manque de courage est-il digne de moi?
Ce penſer contre luy me revolte, m'indigne,	Ce penser contre lui me révolte, m’indigne,
Et s’il manque d'amour en ſera-il plus digne?	Et s’il manque d’amour en sera-t-il plus digne?
Mais que vois-je? eſt-ce luy? grands Dieux!...	Mais que vois-je? est-ce lui? grands Dieux!…
N'En doutez plus,	N’en doutez plus,
Madame, & connoiſſez aujourd’huy Lucejus:	Madame, et connaissez aujourd’hui Lucejus:
Il le renvoya libre, & j’en ay le ſalaire,	Il le renvoya libre, et j’en ai le salaire,
C’eſt luy qui m’a conduit prés de vous en ces lieux,	C’est lui qui m’a conduit prés de vous en ces lieux,
Ciel! qu’entens-je?	Ciel! qu’entends-je?
Voila le ſujet qui m’ameine,	Voilà le sujet qui m’amène,
Mes ſoldats ſont cachez dans la foreſt prochaine,	Mes soldats sont cachés dans la forêt prochaine,
Juſqu’au prés de ce Camp nous ſommes parvenus	Jusqu’au prés de ce Camp nous sommes parvenus
Par des lieux écartez, des chemins inconnus,	Par des lieux écartés, des chemins inconnus,
Je n’ay pris avec moy que des troupes d’élite,	Je n’ai pris avec moi que des troupes d’élite,
Avecque un Camp volant Mandonius le ſuit,	Avec un Camp volant Mandonius le suit,
Nous devons attaquer ce quartier cette nuit;	Nous devons attaquer ce quartier cette nuit;
En quel endroit du Camp vos tentes pouvoient être,	En quel endroit du Camp vos tentes pouvaient être,
je le ſçais à preſent, & j'en rends grâce aux Dieux,	Je le sais à présent, et j’en rends grâce aux Dieux,
Il faudra profiter & du temps & des lieux,	Il faudra profiter et du temps et des lieux,
Et ſi le Ciel répond à ce que je projete,	Et si le Ciel répond à ce que je projette,
Tout le Camp d'Annibal nous offre une retraite,	Tout le Camp d’Hannibal nous offre une retraite,
Il n'eſt pas loin d’icy; mais fay voulu ſans luy	Il n’est pas loin d’ici; mais j’ai voulu sans lui
Je craignois qu’Annibal par ſa lente prudence	Je craignais qu’Hannibal par sa lente prudence
Ne ſervit mal ma flâme & mon impatience:	Ne servît mal ma flamme et mon impatience:
Vos ſens ſont interdits, vos eſprits ſont troublez,	Vos sens sont interdits, vos esprits sont troublés,
Vous ne répondez rien, & vous verſez des larmes.	Vous ne répondez rien, et vous versez des larmes.
Que je reſſens pour vous de mortelles allarmes?	Que je ressens pour vous de mortelles alarmes?
Qu'allez-vous entreprendre? & qui peut m'aſſurer	Qu’allez-vous entreprendre? Et qui peut m’assurer
Du ſuccés....	Du succès…
Ouy, Madame, il faut tout eſperer,	Oui, Madame, il faut tout espérer,
L'ardeur de vous ſervir doit me rendre invincible,	L’ardeur de vous servir doit me rendre invincible,
Si le ſort me trahit, ou ſi je meurs au moins,	Si le sort me trahit, ou si je meurs au moins,
J'auray fait mon devoir s’il m’en coûte la vie,	J’aurai fait mon devoir s’il m’en coûte la vie,
Du moins je la perdray pour ſauver Iſperie.	Du moins je la perdrai pour sauver Ispérie.
Et c'eſt ce que je crains, que pourez-vous, ah Dieux?	Et c’est ce que je crains, que pourrez-vous, ah Dieux?
Vous allez attaquer un Camp victorieux,	Vous allez attaquer un Camp victorieux,
Vous perirez, Seigneur, & tout me le fait croire,	Vous périrez, Seigneur, et tout me le fait croire,
Vous allez contre vous irriter la victoire,	Vous allez contre vous irriter la victoire,
Tomber peut-être...	Tomber peut-être…
Helas! que mon ſort ſera doux	Hélas! que mon sort sera doux
Non, Seigneur, gardez-vous d’entreprendre,	Non, Seigneur, gardez-vous d’entreprendre,
Si je l'ay ſouhaité, je dois vous le défendre;	Si je l’ai souhaité, je dois vous le défendre;
L’oin de vous j’accuſois vôtre trop de lenteur,	Loin de vous j’accusais votre trop de lenteur,
J’allois juſqu’à douter même de vôtre coeur:	J’allais jusqu’à douter même de votre cœur:
Pardonnez-moy, j’étois injuſte, criminelle,	Pardonnez-moi, j’étais injuste, criminelle,
De ſoupçonner ce cœur genereux & fidelle:	De soupçonner ce cœur généreux et fidèle:
Et je retrouve en vous un Heros plein d’amour,	Et je retrouve en vous un Héros plein d’amour,
C'eſt aſſez.	C’est assez.
Ou choiſir de me voir dans peu ceſſer de vivre,	Ou choisir de me voir dans peu cesser de vivre,
Diſſipez vos chagrins, & n’ayez point d’effroy,	Dissipez vos chagrins, et n’ayez point d’effroi,
Cette entrepriſe eſt digne & de vous & de moy.	Cette entreprise est digne et de vous et de moi.
Hé quoy donc Scipion vous peut voir à toute heure,	Hé quoi donc Scipion vous peut voir à toute heure,
Vous le ſouffrez helas! quand il faut que je meure,	Vous le souffrez hélas! quand il faut que je meure,
Il joüit des momens qui m’eſtoient deſtinez,	Il jouit des moments qui m’étaient destinés,
Vous le voyez ſouvent, pardonnez-moy, Madame,	Vous le voyez souvent, pardonnez-moi, Madame,
L’éclat de ſa grandeur pouroit toucher une ame,	L’éclat de sa grandeur pourrait toucher une âme,
Il a tout le reſpect que j’attendrois de vous,	Il a tout le respect que j’attendrais de vous,
Sa bonté, ſa clemence, enlevent mon eſtime,	Sa bonté, sa clémence, enlèvent mon estime,
Je ne m’en défens point puiſqu'elle eſt legitime?	Je ne m’en défends point puisqu’elle est légitime?
Mais enfin Scipion n'eſt point vôtre rival,	Mais enfin Scipion n’est point votre rival,
Il n’aime que la gloire, & ne hait qu'Annibal.	Il n’aime que la gloire, et ne hait qu’Hannibal.
Moy, je hay ce Romain dont vous portez la chaîne,	Moi, je hais ce Romain dont vous portez la chaîne,
Mais, Madame, ſongez qu’il fait tous nos malheurs,	Mais, Madame, songez qu’il fait tous nos malheurs,
Vous devez le haïr, il vous coûte des pleurs,	Vous devez le haïr, il vous coûte des pleurs,
De vous voir dans ſon Camp encor porter ſa chaîne.	De vous voir dans son Camp encor porter sa chaîne.
Non, non, & cette nuit il en faudra ſortir,	Non, non, et cette nuit il en faudra sortir,
Ou j'iray...	Ou j’irai…
Non, Seigneur, je n'y puis conſentir,	Non, Seigneur, je n’y puis consentir,
Annibal vient bien-tôt, attendons ſa venüe,	Hannibal vient bientôt, attendons sa venue,
Aprenons le ſuccés d'une telle entrevüe,	Apprenons le succès d’une telle entrevue,
Et novs ſerons tous deux compris dans le traité;	Et nous serons tous deux compris dans le traité;
Peut-eſtre ſans riſquer une ſi chere vie	Peut-être sans risquer une si chère vie
Ne précipitez rien, Seigneur, retirez-vous,	Ne précipitez rien, Seigneur, retirez-vous,
Je tremble qu’en ces lieux quelqu’un ne vienne à nous;	Je tremble qu’en ces lieux quelqu’un ne vienne à nous;
Si vous tardez long-temps on peut vous y ſurprendre;	Si vous tardez longtemps on peut vous y surprendre;
Surtout, au nom des Dieux, avant que d’entreprendre,	Surtout, au nom des Dieux, avant que d’entreprendre,
Si j’ay ſur vôtre cœur de veritables droits,	Si j’ai sur votre cœur de véritables droits,
Je prétends vous parler une ſeconde fois;	Je prétends vous parler une seconde fois;
Il poura dans ſa tente aſſurer vôtre vie,	Il pourra dans sa tente assurer votre vie,
Attendez quelque temps.	Attendez quelque temps.
Mais enfin, ſi vos vœux & les miens ſont trahis	Mais enfin, si vos vœux et les miens sont trahis,
Vous partirez.	Vous partirez.
Seigneur, je promets de vous ſuivre,	Seigneur, je promets de vous ſuivre,
Et même de mourir ſi vous ceſſez de vivre.	Et même de mourir si vous cessez de vivre.
A Preſent je reſpire! il a rempli mes voeux,	À présent je respire! il a rempli mes vœux,
Cet Amant que je vois fidelle & genereux,	Cet Amant que je vois fidèle et généreux,
Il ne me reſte plus que l’amour & la crainte;	Il ne me reste plus que l’amour et la crainte;
Mais helas! quelle eſt vive & ſenſible à mon cœur?	Mais hélas! qu’elle est vive et sensible à mon cœur?
Il eſt digne de moy, je dois trop le connoître;	Il est digne de moi, je dois trop le connaître;
Mais il va s'expoſer, & perira peut-eſtre;	Mais il va s’exposer, et périra peut-être;
Que dis-je, ſon amour va tenter un effort	Que dis-je, son amour va tenter un effort
Qui luy fera trouver Scipion & la mort;	Qui lui fera trouver Scipion et la mort;
Juſtes Dieux! détournez ce funeſte présage!	Justes Dieux! détournez ce funeste présage!
Inſpirez Annibal pour la paix de Cartage!	Inspirez Hannibal pour la paix de Carthage!
Et ſur tout portez-y le cœur de Scipion:	Et surtout portez-y le cœur de Scipion:
Il vient, que me veut-il?	Il vient, que me veut-il?
Mais quel trouble nouveau frape & ſaiſit vôtre ame!	Mais quel trouble nouveau frappe et saisit votre âme!
Etonnée, interdite, à mon premier abord,	Étonnée, interdite, à mon premier abord,
Je vois combien pour moy vous vous faites d’effort.	Je vois combien pour moi vous vous faites d’effort.
Seigneur, ne croyez pas...	Seigneur, ne croyez pas…
Ma preſence vous gêne,	Ma présence vous gêne
Et je ſeray toujours l'objet de vôtre haine,	Et je serai toujours l’objet de votre haine,
Moy, Seigneur?	Moi, Seigneur?
Vous haïr? mon reſpect vous répond de mon coeur,	Vous haïr? mon respect vous répond de mon cœur,
Madame, vous croyez la haine legitime,	Madame, vous croyez la haine légitime,
La priſe de Zama vous a coûté des pleurs,	La prise de Zama vous a coûté des pleurs,
Du Prince vôtre Amant j’ay cauſé les malheurs,	Du Prince votre Amant j’ai causé les malheurs,
Et vous vous en plaignez du moins ſans vous contraindre,	Et vous vous en plaignez du moins sans vous contraindre,
Il eſt d’autres malheurs dont on n’oſe ſe plaindre.	Il est d’autres malheurs dont on n’ose se plaindre.
Seroit-il des malheurs comparables aux ſiens?	Serait-il des malheurs comparables aux siens?
Ce jeune Prince helas! attendoit la journée	Ce jeune Prince hélas! attendait la journée
Qui devoit couronner un pompeux hymenée,	Qui devait couronner un pompeux hyménée,
De ma memoire encor je ne puis le bannir,	De ma mémoire encor je ne puis le bannir,
C’eſt vous qui luy cauſez les malheurs de ſa vie,	C’est vous qui lui causez les malheurs de sa vie,
Errant, infortune, ſeparé d'Iſperie,	Errant, infortuné, séparé d’Ispérie,
Il nourit loin de moy d’inutiles regrets,	Il nourrit loin de moi d’inutiles regrets,
Peut-eſtre ſes tourmens ne finiront jamais;	Peut-être ses tourments ne finiront jamais;
Si vous aimiez, Seigneur, vous ſçauriez par vous-même	Si vous aimiez, Seigneur, vous sauriez par vous-même
Et qu’il eſt ſeparé de l’objet de ſes vœux?	Et qu’il est séparé de l’objet de ses vœux?
Helas! qu’il eſt à plaindre? & qu’il eſt malheureux?	Hélas! qu’il est à plaindre? Et qu’il est malheureux?
Qu'il eſt digne d’envie!	Qu’il est digne d’envie!
Peut-on rien ajouter au bonheur de ſa vie?	Peut-on rien ajouter au bonheur de sa vie?
Lucejus eſt choiſi pour eſtre vôtre epoux,	Lucejus est choisi pour être votre époux,
Il vous aime, & de plus il eſt aimé de vous.	Il vous aime, et de plus il est aimé de vous.
Mais ç’en eſt trop, il faut combattre dans vôtre ame,	Mais ç’en est trop, il faut combattre dans votre âme,
Et bannir pour jamais cette inutile flâme.	Et bannir pour jamais cette inutile flamme.
Ouy, pour vous Rome a d’autres deſſeins,	Oui, pour vous Rome a d’autres desseins,
Et puiſqu'il eſt enfin ennemy des Romains	Et puisqu’il est enfin ennemi des Romains
Tout s'opoſe à ſes vœux, raiſon, & politique,	Tout s’oppose à ses vœux, raison, et politique,
Pouroit-elle ſouffrir qu’il devint vôtre époux?	Pourrait-elle souffrir qu’il devînt votre époux?
Et d’ailleurs cet hymen eſt indigne de vous.	Et d’ailleurs cet hymen est indigne de vous.
Lucejus eſt né Prince.	Lucejus est né Prince.
Et fuſt-il Roy, Madame,	Et fût-il Roi, Madame,
Il ne merite point une ſi belle flâme?	Il ne mérite point une si belle flamme?
Vous ignorez encor juſqu’à quel point d’hõneur...	Vous ignorez encor jusqu’à quel point d’honneur…
Non, à vôtre merite il n'eſt rien qui réponde,	Non, à votre mérite il n’est rien qui réponde,
Et pour mieux ſoûtenir l’honneur de vôtre choix,	Et pour mieux soutenir l’honneur de votre choix,
Il faut un des vainqueurs, un des maiſtres des Rois,	Il faut un des vainqueurs, un des maîtres des Rois,
En un mot, un Romain.	En un mot, un Romain.
La grandeur, la fortune	La grandeur, la fortune
Peut faire impreſſion ſur une ame commune;	Peut faire impression sur une âme commune;
Mais quoy! tout ſon éclat mis dans ſon plus beau jour	Mais quoi! tout son éclat mis dans son plus beau jour
Quoy? vous pouriez, Madame?...	Quoi? Vous pourriez, Madame?…
Eh! Seigneur, que m’importe	Eh! Seigneur, que m’importe
Je dois les reſpecter, & je ſuis dans leurs fers;	Je dois les respecter, et je suis dans leurs fers;
Qu'à leur gré les Romains gouvernent l’Univers,	Qu’à leur gré les Romains gouvernent l’Univers,
Tout doit fléchir ſous eux? Mais encor à quels titres	Tout doit fléchir sous eux? Mais encor à quels titres
Veulent-ils de nos cœurs devenir les arbitres?	Veulent-ils de nos cœurs devenir les arbitres?
Il faut juſtifier, Madame, leurs desseins,	Il faut justifier, Madame, leurs desseins,
Et vous aprendre icy l’intereſt des Romains;	Et vous apprendre ici l’intérêt des Romains;
Rome ne peut ſouffrir d’alliance ennemie,	Rome ne peut souffrir d’alliance ennemie,
Syphax, ce Roy ſuperbe a payé cherement	Syphax, ce Roi superbe a payé chèrement
Il eſtoit nôtre amy; mais de dangereux charmes	Il était notre ami; mais de dangereux charmes
Luy firent contre nous ſoudain prendre les armes,	Lui firent contre nous soudain prendre les armes,
Sophoniſbe luy plût, il devint ſon epoux,	Sophonisbe lui plut, il devint son époux,
(Madame, elle eſtoit belle, & moins belle que vous)	(Madame, elle était belle, et moins belle que vous)
La fille d’Aſdrubal a donc ſçû le détruire,	La fille d’Asdrubal a donc su le détruire,
Et vient de luy coûter la vie avec l’Empire;	Et vient de lui coûter la vie avec l’Empire;
Iſperie eſt la fille, & niéce d’Annibal,	Ispérie est la fille, et nièce d’Hannibal,
Plus charmante cent fois, plus redoutable encore,	Plus charmante cent fois, plus redoutable encore,
Qu’il unit à Cartage avec de tels liens	Qu’il unît à Carthage avec de tels liens
Tout le peuple nombreux des Celtiberiens;	Tout le peuple nombreux des Celtibériens;
Si Sophoniſbe ſeule a coûté trois batailles,	Si Sophonisbe seule a coûté trois batailles,
Combien coûteriez-vous de ſang, de funerailles?	Combien coûteriez-vous de sang, de funérailles?
Vous pouriez ſoûlever vingt Rois nos ennemis,	Vous pourriez soulever vingt Rois nos ennemis,
Unir Mandonius avecque Indibilis,	Unir Mandonius avec Indibilis,
Vos yeux pouroient contr’elle armer toute la terre.	Vos yeux pourraient contre elle armer toute la terre.
Mais ſi la paix, Seigneur, par de plus doux projets	Mais si la paix, Seigneur, par de plus doux projets
Madame, point de paix,	Madame, point de paix,
Point d'accord, c'eſt en vain en former l’eſperance,	Point d’accord, c’est en vain en former l’espérance,
Il faut de Rome, il faut pourſuivre la vangeance,	Il faut de Rome, il faut poursuivre la vengeance,
On me l’a confiée, & j’en dois prendre ſoin,	On me l’a confiée, et j’en dois prendre soin,
Et ſi j’en crois mon cœur je la porteray loin,	Et si j’en crois mon cœur je la porterai loin,
Madame, vous pleurez.	Madame, vous pleurez.
Puiſque par cet Arreſt vous voulez que je meure?	Puisque par cet Arrêt vous voulez que je meure?
Vous ſerez ſatisfait, cet ordre rigoureux	Vous serez satisfait, cet ordre rigoureux
Nous avions dans la paix encor quelque eſperance,	Nous avions dans la paix encor quelque espérance,
Mais vous voulez de Rome achever la vangeance.	Mais vous voulez de Rome achever la vengeance.
Achevez-là, Seigneur, mais du moins le trépas,	Achevez-la, Seigneur, mais du moins le trépas,
Au defaut de la paix ne nous manquera pas.	Au défaut de la paix ne nous manquera pas.
ELle fort, juſte Ciel! & ſes yeux pleins de larmes	Elle sort, juste Ciel! et ses yeux pleins de larmes
Attendriſſent mon cœur, & m’arrachent les armes,	Attendrissent mon cœur, et m’arrachent les armes,
Et preſqu’en ce moment je conſens à la paix;	Et presqu’en ce moment je consens à la paix;
Ouy, puiſqu'elle le veut, il faut finir la guerre,	Oui, puisqu’elle le veut, il faut finir la guerre,
Mais quel triſte penſer me frape en ce moment?	Mais quel triste penser me frappe en ce moment?
Elle ne veut la paix que pour voir ſon Amant,	Elle ne veut la paix que pour voir son Amant,
Que pour combler ſes vœux d’un heureux hymenée,	Que pour combler ses vœux d’un heureux hyménée,
Et j'en avancerois la fatale journée?	Et j’en avancerais la fatale journée?
C’eſt donc pour Lucejus qu'elle aſpire à la paix:	C’est donc pour Lucejus qu’elle aspire à la paix:
Qu’elle l’aime grands Dieux! grands Dieux que je le hais?	Qu’elle l’aime grand Dieux! grands Dieux que je le hais?
D'où vient que Lucejus eſt l’objet de ma haine?	D’où vient que Lucejus est l’objet de ma haine?
D’où vient que contre luy je me trouve animé?	D’où vient que contre lui je me trouve animé?
Les voila ces raiſons? & mon ame ſaiſie...	Les voilà ces raisons? et mon âme saisie…
Ah! je te reconnois affreuſe jalouſie,	Ah! Je te reconnais affreuse jalousie,
Tu viens porter la haine & le trouble en mon cœur,	Tu viens porter la haine et le trouble en mon cœur,
Et tu me fais ſentir que l’amour eſt vainqueur,	Et tu me fais sentir que l’amour est vainqueur,
Dans quel temps? dans le temps qu’Annibal va paroître,	Dans quel temps? dans le temps qu’Hannibal va paraître,
Et que de mes tranſports je dois eſtre le maître,	Et que de mes transports je dois être le maître,
De mes égaremens je n’ay point de témoins;	De mes égarements je n’ai point de témoins,
Mais dois-je ſuccomber au panchant qui m’entraîne,	Mais dois-je succomber au penchant qui m’entraîne?
Mépriſons ſes attraits, & peut-être en ce jour	Méprisons ses attraits, et peut-être en ce jour
Qu'Erixene ſçaura détruire cet amour:	Qu’Erixène saura détruire cet amour:
je veux rendre un hommage éclatant à ſes charmes,	Je veux rendre un hommage éclatant à ses charmes,
Abandonnons des yeux toujours noyez de larmes,	Abandonnons des yeux toujours noyés de larmes,
Tout le veut, la raiſon, la gloire, l’équité,	Tout le veut, la raison, la gloire, l’équité,
Il faut par d'autre fers me mettre eu liberté.	Il faut par d’autres fers me mettre en liberté.
Que pour en ſoûtenir l'éclat, la renommée	Que pour en soutenir l’éclat, la renommée,
lien veut étaler la pompe à ſon rival,	Il en veut étaler la pompe à son rival,
En attendant qu’icy nous le voyons paroître,	En attendant qu’ici nous le voyons paraître,
De grace, aprenez-moy ſi ce ſuperbe maître,	De grâce, apprenez-moi si ce superbe maître,
Ce fameux Scipion qui marchoit ſur vos pas	Ce fameux Scipion qui marchait sur vos pas
A rendu les reſpects qu’il doit à vos apas;	A rendu les respects qu’il doit à vos appâts;
Ouy, ſon front deſarmé de la fierté Romaine	Oui, son front désarmé de la fierté Romaine
Sembloit le préparer à porter votre chaîne;	Semblait le préparer à porter votre chaîne;
Aſſez diſtinctement cet homage rendu:	Assez distinctement cet hommage rendu:
Mais helas! je vous vois les yeux pleins de triſteſſe,	Mais hélas! je vous vois les yeux pleins de tristesse,
Vous ne répondez rien, vous devorez vos pleurs,	Vous ne répondez rien, vous dévorez vos pleurs,
Madame, & ce ſilence...	Madame, et ce silence…
Aprens tous mes malheur,	Apprends tous mes malheurs,
Barcé, puiſque tu veux que je t’en rende conte,	Barcé, puisque tu veux que je t’en rende compte,
Aprens ma paſſion, ma douleur, & ma honte;	Apprends ma passion, ma douleur, et ma honte;
Que les yeux d’une Amante helas! ſont clairvoyans?	Que les yeux d’une Amante hélas! sont clairvoyants?
Il m’eſt venu trouver pour m’en faire un homage,	Il m’est venu trouver pour m’en faire un hommage,
Mais que ſon cœur ah Dieux! démentoit ſon langage?	Mais que son cœur ah Dieux! démentait son langage?
J'ay vû qu’il me rendoit un homage forcé;	J’ai vu qu’il me rendait un hommage forcé;
Au nom de Lucejus toute ſa jalouſie	Au nom de Lucejus toute sa jalousie
Me l'a fait voir remply des charmes d’Iſperie,	Me l’a fait voir rempli des charmes d’Ispérie,
Il la cherchoit encore en voulant me parler,	Il la cherchait encore en voulant me parler,
Il découvroit un feu qu’il tâchoit de celer,	Il découvrait un feu qu’il tâchait de celer,
Et ſon aveu pour moy d’une flâme fatale	Et son aveu pour moi d’une flamme fatale
Que dites-vous? ah Ciel!	Que dites-vous? ah Ciel!
Tout ce que j'ay trop vû,	Tout ce que j’ai trop vu,
Ouy, j'ay de mes malheurs l'affreuſe certitude,	Oui, j’ai de mes malheurs l’affreuse certitude,
Et n’ay plus la douceur de mon inquietude;	Et n’ai plus la douceur de mon inquiétude;
Ce n'eſt pas qu’il n’ait fait d’inutiles effors	Ce n’est pas qu’il n’ait fait d’inutiles efforts
Pour s'arracher luy-même à ſes premiers tranſports:	Pour s’arracher lui-même à ses premiers transports:
Je voyois qu’il tâchoit de me rendre les armes,	Je voyais qu’il tâchait de me rendre les armes,
Qu’il vouloit tout entier ſe livrer à mes charmes,	Qu’il voulait tout entier se livrer à mes charmes,
Qui ſuivoit malgré luy ſon panchant obſtiné:	Qui suivait malgré lui son penchant obstiné:
En parlant d’Iſperie un dédain legitime	En parlant d’Ispérie un dédain légitime
Il vouloit à mes yeux rabaiſſer ſes attraits,	Il voulait à mes yeux rabaisser ses attraits,
Mais les ſiens me ſembloient égarez & diſtraits:	Mais les siens me semblaient égarés et distraits:
Il nommoit Iſperie, il nommoit Erixene,	Il nommait Ispérie, il nommait Erixène,
Il montroit de l’amour, il marquoit de la haine,	Il montrait de l’amour, il marquait de la haine,
Il s’efforçoit Barcé d’aimer & de haïr,	Il s’efforçait Barcé d’aimer et de haïr,
Et ſon cœur en ſuſpens refuſoit d’obéïr.	Et son cœur en suspens refusait d’obéir.
Son ame d’un tel feu doit eſtre aſſez punie,	Son âme d’un tel feu doit être assez punie,
Elle aime Lucejus, & leurs cœurs embraſez	Elle aime Lucejus, et leurs cœurs embrasés
Sa tendreſſe...	Sa tendresse…
Et pourquoy ſans deſſein de luy plaire	Et pourquoi sans dessein de lui plaire
Me ravit-elle un cœur à ſes vœux ſi contraire?	Me ravit-elle un cœur à ses vœux si contraire?
Ou pourquoy ce Heros s’eſt-il laiſſé charmer	Ou pourquoi ce Héros s’est-il laissé charmer
D'un objet qui ne peut & ne doit pas l’aimer?	D’un objet qui ne peut et ne doit pas l’aimer?
Quand il voit aujourd’huy la ſuperbe Erixene	Quand il voit aujourd’hui la superbe Erixène
Iſperie eſt aimée? ah jalouſe fureur!	Ispérie est aimée? ah jalouse fureur!
De mon cruel deſtin vois-tu toute l’horreur?	De mon cruel destin vois-tu toute l’horreur?
Qu’il en coûte des pleurs, du ſang à ma rivale,	Qu’il en coûte des pleurs, du sang à ma rivale,
Et mon cœur irrite ſera plus ſatisfait	Et mon cœur irrité sera plus satisfait
Si je puis la punir du vol qu’elle m'a fait:	Si je puis la punir du vol qu’elle m’a fait:
Mais pourquoy la punir d’un crime involontaire?	Mais pourquoi la punir d’un crime involontaire?
C’eſt ſans doute à regret qu'elle a trop ſçû luy plaire,	C’est sans doute à regret qu’elle a trop su lui plaire,
Pourois-je l'accabler de mon inimitié	Pourrais-je l’accabler de mon inimitié
On l'adore, & ſa flâme eſt ailleurs allumée,	On l’adore, et sa flamme est ailleurs allumée,
Et moy, j’aime un ingrat ſans eſpoir d’eſtre aimée.	Et moi, j’aime un ingrat sans espoir d’être aimée.
Madame, ſoûtenez l’éclat de vôtre nom.	Madame, soutenez l’éclat de votre nom.
Annibal dans ces lieux à l’inſtant va ſe rendre,	Hannibal dans ces lieux à l’instant va se rendre,
Scipion ſuit mes pas, Madame, & vient l’attendre,	Scipion suit mes pas, Madame, et vient l’attendre,
J'ay dû vous avertir...	J’ai dû vous avertir…
Lepide, c’eſt aſſez.	Lépide, c’est assez.
Barcé, retirons-nous.	Barcé, retirons-nous.
Seront bien-tôt remplis, & ſuivant mon attente	Seront bientôt remplis, et suivant mon attente
Je vais voir Annibal, Lepide, en cette tente:	Je vais voir Hannibal, Lépide, en cette tente:
Sextus va par mon ordre au devant de ſes pas,	Sextus va par mon ordre au devant de ses pas,
Je rends tous les honneurs qu’on doit à ce grand homme,	Je rends tous les honneurs qu’on doit à ce grand homme,
Et je vais ſoûtenir les interêts de Rome:	Et je vais soutenir les intérêts de Rome:
Il faut reprendre icy toute ma fermeté,	Il faut reprendre ici toute ma fermeté,
Oublier les tranſports de mon cœur agité,	Oublier les transports de mon cœur agité,
J'en ay rougy cent fois, & j’y fus trop ſenſible,	J’en ai rougi cent fois, et j’y fus trop sensible,
Et je veux aujourd’huy plein d’une noble ardeur	Et je veux aujourd’hui plein d’une noble ardeur,
Malgré ma paſſion luy découvrir le cœur	Malgré ma passion lui découvrir le cœur
Ne ſonge qu’à ſa gloire & qu’à la Republique.	Ne songe qu’à sa gloire et qu’à la République.
Sur vous de l’Univers vous attachez les yeux,	Sur vous de l’Univers vous attachez les yeux,
Seigneur, & vos ſuccés vous font des envieux,	Seigneur, et vos succès vous font des envieux,
Qui ne peuvent ſouffrir ſans quelque jalouſie	Qui ne peuvent souffrir sans quelque jalousie
Le cours trop éclatant de vôtre illuſtre vie:	Le cours trop éclatant de votre illustre vie:
Je n’oſe qu’à regret en prononcer le nom,	Je n’ose qu’à regret en prononcer le nom,
Qui ſouvent contre vous animez d’un faux zele	Qui souvent contre vous animez d’un faux zèle
Fatiguent le Senat d’une plainte éternelle.	Fatiguent le Sénat d’une plainte éternelle.
A tenté contre moy des efforts ſuperflus,	A tenté contre moi des efforts superflus,
Il vouloit empêcher mon voyage en Affrique,	Il voulait empêcher mon voyage en Afrique,
Mais c’eſt l’eſprit jaloux de chaque Republique,	Mais c’est l’esprit jaloux de chaque République,
Qui craint ſes citoyens dés qu’ils font trop fameux,	Qui craint ses citoyens dés qu’ils sont trop fameux,
La vertu des Heros eſt un crime chez eux,	La vertu des Héros est un crime chez eux,
Et lorſqu’on s’agrandit avec trop de courage	Et lorsqu’on s’agrandit avec trop de courage
Caton & Fabius en ont conçû pour moy,	Caton et Fabius en ont conçu pour moi,
Et peut-eſtre en ſecret jaloux de mon employ,	Et peut-être en secret jaloux de mon emploi,
Mais il faut terminer cette guerre d'Affrique,	Mais il faut terminer cette guerre d’Afrique,
C’eſt à moy de remplir la gloire de mon ſort,	C’est à moi de remplir la gloire de mon sort,
Je n’écoûteray rien ſi l’on parle d’accord,	Je n’écouterai rien si l’on parle d’accord,
Il faut que par mon bras Cartage ſoit punie,	Il faut que par mon bras Carthage soit punie,
Il faut vaincre Annibal & la guerre eſt finie,	Il faut vaincre Hannibal et la guerre est finie,
Il vient, que ſon abord inſpire de reſpect,	Il vient, que son abord inspire de respect,
Si j’ay paru ſurpris à vôtre aſpect,	Si j’ai paru surpris à votre aspect,
Et ſi quelques momens j'ay gardé le ſilence,	Et si quelques moments j’ai gardé le silence,
On ne peut regarder ſans admiration	On ne peut regarder sans admiration
L’éclat, la majeſté du fameux Scipion,	L’éclat, la majesté du fameux Scipion,
Et mon étonnement eſt qu’en un ſi jeune âge,	Et mon étonnement est qu’en un si jeune âge,
Vous ayez fait trembler Annibal pour Cartage:	Vous ayez fait trembler Hannibal pour Carthage:
Ouy, Seigneur, je l’avouë, aprenant vos exploits	Oui, Seigneur, je l’avoue, apprenant vos exploits
Pour elle j'ay pâly pour la premiere fois;	Pour elle j’ai pâli pour la première fois;
Et dont pendant ſeize ans mon nom fit l'épouvante;	Et dont pendant seize ans mon nom fut l’épouvante;
J’avois compté pour peu tant de fiers Generaux	J’avais compté pour peu tant de fiers Généraux
Et les jours de Trebie, & ceux de Thraſymene,	Et les jours de Trébie, et ceux de Thrasymène,
Qui me firent raiſon de la fierté Romaine	Qui me firent raison de la fierté Romaine
M’avoient accoûtumé d’en être le vainqueur,	M’avaient accoutumé d’en être le vainqueur,
Tant de proſperitez devoient m'enfler le cœur;	Tant de prospérités devaient m’enfler le cœur;
Mais, Seigneur, vous venez d’un courage heroïque	Mais, Seigneur, vous venez d’un courage héroïque
Délivrer l’Italie en attaquant l'Affrique,	Délivrer l’Italie en attaquant l’Afrique,
Que vôtre bras détruit ce que le mien a fait:	Que votre bras détruit ce que le mien a fait:
Mon retour en ces lieux eſt vôtre grand ouvrage,	Mon retour en ces lieux est votre grand ouvrage,
Et pour elle aujourd'huy par de juſtes projets	Et pour elle aujourd’hui par de justes projets
Vous voyez Annibal vous demander la paix.	Vous voyez Hannibal vous demander la paix.
Je ne m’attendois pas qu’un ſi grand Capitaine	Je ne m’attendais pas qu’un si grand Capitaine
Vint icy deſarmé de colere & de haine,	Vînt ici désarmé de colère et de haine,
Qu’Annibal ſi long-temps couronné de lauriers,	Qu’Hannibal si longtemps couronné de lauriers,
Le modelle & l’effroy des plus fameux Guerriers,	Le modèle et l’effroi des plus fameux Guerriers,
Put rallentir en luy le deſir de la gloire,	Pût ralentir en lui le désir de la gloire,
Et qu’un Heros illuſtre aprés tant de haut faits	Et qu’un Héros illustre après tant de hauts faits
Je le veux, je le dois: la fortune éclatante	Je le veux, je le dois: la fortune éclatante
Qui fut aſſez long-temps pour moy ferme & conſtante,	Qui fut assez longtemps pour moi ferme et constante,
Ne m'a point ébloüy; ſes inégalitez	Ne m’a point ébloui; ses inégalités
M’ont fait voir quelquefois ſes infidelitez,	M’ont fait voir quelquefois ses infidélités,
Et bien qu’elle ait paru s’attacher à mes traces,	Et bien qu’elle ait paru s’attacher à mes traces,
Ses faveurs m’ont inſtruit bien moins que les diſgraces.	Ses faveurs m’ont instruit bien moins que ses disgrâces.
Du deſſein de la paix n’éloigne vôtre cœur,	Du dessein de la paix n’éloigne votre cœur,
Juſqu’icy la fortune à vos vœux fût fidelle,	Jusqu’ici la fortune à vos vœux fut fidèle,
Commandant dans un âge où l’on doit obéïr	Commandant dans un âge où l’on doit obéir,
Mille & mille ſuccés ont dû vous ébloüïr;	Mille et mille succès ont dû vous éblouir;
La vertu, la valeur vous fût hereditaire,	La vertu, la valeur vous fut héréditaire,
Vous vangeâtes d’abord vôtre oncle & vôtre pere,	Vous vengeâtes d’abord votre oncle et votre père,
(Illuſtres monumens de vôtre pieté)	(Illustres monuments de votre piété)
Cette même valeur avec rapidité	Cette même valeur avec rapidité
L'Affrique à vôtre bras a coûté deux campagnes,	L’Afrique à votre bras a coûté deux campagnes,
Je viens d’y voir perir deux freres genereux,	Je viens d’y voir périr deux frères généreux,
Vous avez de Syphax conquis le vaſte Empire,	Vous avez de Syphax conquis le vaste Empire,
L’Univers étonné vous craint & vous admire,	L’Univers étonné vous craint et vous admire,
Mais dans ce haut degré de gloire & de ſplendeur	Mais dans ce haut degré de gloire et de splendeur
Scipion, redoutez vôtre propre grandeur,	Scipion, redoutez votre propre grandeur,
La fortune eſt volage, il ne faut qu’un caprice,	La fortune est volage, il ne faut qu’un caprice,
Un ſeul jour, un inſtant nous meine au précipice,	Un seul jour, un instant nous mène au précipice,
Du plus haut point de gloire il tomba dans nos fers,	Du plus haut point de gloire il tomba dans nos fers,
Et n’eût pas éprouvé tant d’affreuſes miſeres	Et n’eût pas éprouvé tant d’affreuses misères
Le ſort d’une bataille eſt toujours incertain,	Le sort d’une bataille est toujours incertain,
Mais celuy de la paix eſt tout en vôtre main,	Mais celui de la paix est tout en votre main,
Pour Scipion, pour Rome étant pleine de gloire,	Pour Scipion, pour Rome étant pleine de gloire,
Elle aura plus d’éclat pour vous qu’une victoire:	Elle aura plus d’éclat pour vous qu’une victoire:
Pour Cartage, j’avouë avec ſincerité	Pour Carthage, j’avoue avec sincérité
Qu'elle aura moins d’honneur & plus d’utilité:	Qu’elle aura moins d’honneur et plus d’utilité:
Suivre icy la raiſon que l’aveugle fortune;	Suivre ici la raison que l’aveugle fortune;
Souffrez donc que j’en vienne aux termes d’un accord,	Souffrez donc que j’en vienne aux termes d’un accord,
Et ſi nous vous cedons tous nos droits ſur l’Eſpagne,	Et si nous vous cédons tous nos droits sur l’Espagne,
Vous quittant la Sicile ainſi que la Sardaigne,	Vous quittant la Sicile ainsi que la Sardaigne,
Si nous abandonnons tant de païs conquis,	Si nous abandonnons tant de pays conquis,
Qui furent de la guerre & la cauſe, & le prix,	Qui furent de la guerre et la cause, et le prix,
Si nous nous reſſerrons en détroites limites,	Si nous nous resserrons en d’étroites limites,
Qui par l’ordre des Dieux nous võt être preſcrites,	Qui par l’ordre des Dieux nous vont être prescrites,
Qui va preſque nous mettre au rang de vos ſujets?	Qui va presque nous mettre au rang de vos sujets?
Mais je lis dans vos yeux qu’aprés tant de batailles	Mais je lis dans vos yeux qu’après tant de batailles
C’eſt là vôtre deſſein, je le vois, & je viens	C’est là votre dessein, je le vois, et je viens
Ménager un accord pour mes concitoyens;	Ménager un accord pour mes concitoyens;
Juſqu’à vous en prier je fléchis mon courage,	Jusqu’à vous en prier je fléchis mon courage,
Mais j’immole ma gloire au ſalut de Cartage,	Mais j’immole ma gloire au salut de Carthage,
Et je croy faire plus pour l’éclat de mon nom	Et je crois faire plus pour l’éclat de mon nom
Que ſi j'avois ſoûmis & Rome, & Scipion.	Que si j’avais soumis et Rome, et Scipion.
De preſſants interêts qu’on ne doit pas confondre,	De pressants intérêts qu’on ne doit pas confondre,
Et je dois balancer avecque un ſoin égal	Et je dois balancer avec un soin égal
Pour le vôtre, Seigneur, je ſouffrirois ſans peine	Pour le vôtre, Seigneur, je souffrirais sans peine
Que Rome par la paix pût éteindre ſa haine;	Que Rome par la paix pût éteindre sa haine;
Je connois vos vertus, j’admire vos exploits,	Je connais vos vertus, j’admire vos exploits,
Mais pour ma gloire il faut vous cõbattre une fois:	Mais pour ma gloire il faut vous combattre une fois:
Si Fabius acquit une immortelle gloire	Si Fabius acquit une immortelle gloire
D’éviter Annibal, & de fuïr la victoire,	D’éviter Hannibal, et de fuir la victoire,
En triomphant de vous quelle gloire eut-il eu?	En triomphant de vous quelle gloire eut-il eu?
Je n’oſe m’en flater, je ſerois temeraire,	Je n’ose m’en flatter, je serais téméraire,
D'eſſayer de vous mettre au nombre des vaincus,	D’essayer de vous mettre au nombre des vaincus,
Et d’aller aujourd’huy plus loin que Fabius.	Et d’aller aujourd’hui plus loin que Fabius.
Peut-être ferez-vous un effort inutile?	Peut-être ferez-vous un effort inutile?
Scipion, le chemin en ſera difficile,	Scipion, le chemin en sera difficile,
Je le rendray penible, & ſans doute fatal	Je le rendrai pénible, et sans doute fatal
A quiconque voudra triompher d’Annibal.	À quiconque voudra triompher d’Hannibal.
J’ay bien prévû, Seigneur, qu’ardant à la victoire	J’ai bien prévu, Seigneur, qu’ardent à la victoire
Vous pouriez dédaigner celle de Fabius,	Vous pourriez dédaigner celle de Fabius,
Ce Chef impetueux par un eſprit contraire,	Ce Chef impétueux par un esprit contraire,
Emporté d’une ardeur boüillante & temeraire	Emporté d’une ardeur bouillante et téméraire
Accuſoit Fabius de crainte & de lenteur,	Accusait Fabius de crainte et de lenteur,
J’eus bien-tôt rallenty ſon inutile ardeur,	J’eus bientôt ralenti son inutile ardeur,
Quand le prudent Conſul m’évitant par ſageſſe,	Quand le prudent Consul m’évitant par sagesse,
Avec cette lenteur fatigua mon adreſſe,	Avec cette lenteur fatigua mon adresse,
Rétablit ſa patrie & ſçut vaincre en fuyant.	Rétablit sa patrie et sut vaincre en fuyant.
Je m’accommode peu de pareille victoire,	Je m’accommode peu de pareille victoire,
Rome qui veut de moy de plus puiſſants efforts,	Rome qui veut de moi de plus puissants efforts,
Eſt dans un autre état qu'elle n’étoit alors;	Est dans un autre état qu’elle n’était alors;
Mais Cartage, Seigneur, & perfide, & cruelle	Mais Carthage, Seigneur, et perfide, et cruelle
Eſt indigne aprés tout que vous parliez pour elle;	Est indigne après tout que vous parliez pour elle;
Nos Alliez pour elle indignement traitez	Nos alliés par elle indignement traités
Croyant eſtre à l'abry ſur la foy des traitez,	Croyant être à l’abri sur la foi des traités,
Vos combats trop heureux l’ont depuis enhardie,	Vos combats trop heureux l’ont depuis enhardie,
Les Mammertins vaincus, les Sagontins défaits,	Les Mammertins vaincus, les Sagontins défaits,
Nos Conſuls terraſſez, Rome preſque aſſiegée,	Nos Consuls terrassés, Rome presque assiégée,
Tout cela veut que Rome à la fin ſoit vangée.	Tout cela veut que Rome à la fin soit vengée.
Vous ferez plus pour elle en accordant la paix,	Vous ferez plus pour elle en accordant la paix,
La victoire toujours ne ſuit pas nos ſouhaits;	La victoire toujours ne suit pas nos souhaits;
De plus, conſiderez qu’en l’état où nous ſommes	De plus, considérez qu’en l’état où nous sommes
Je me vois à la tête encor de cent mille hommes,	Je me vois à la tête encor de cent mille hommes,
Nous combatrons, le reſte eſt en la main des Dieux:	Nous combattrons, le reste est en la main des Dieux:
Elle ſçaura regler vôtre ſort & le nôtre,	Elle saura régler votre sort et le nôtre,
J’ay négligé, Seigneur, de vous parler d’abord	J’ai négligé, Seigneur, de vous parler d’abord
D’un lien qui pouroit cimenter un accord;	D’un lien qui pourrait cimenter un accord;
Juſqu’icy vous n’avez aucun nœud qui vous lie:	Jusqu’ici vous n’avez aucun nœud qui vous lie:
Si ma Niéce, Seigneur, ſi l’heureuſe Iſperie	Si ma Nièce, Seigneur, si l’heureuse Ispérie
A ce ſuprême honneur meritoit d’aſpirer...	À ce suprême honneur méritait d’aspirer…
Mais le cœur d’un Romain ne ſçait pas ſoûpirer,	Mais le cœur d’un Romain ne sait pas soupirer,
Je reſpecte Iſperie, elle eſt toute adorable,	Je respecte Ispérie, elle est toute adorable,
Elle pouroit fléchir le plus ſuperbe cœur,	Elle pourrait fléchir le plus superbe cœur,
Et ce ſeroit pour moy le comble de la gloire,	Et ce serait pour moi le comble de la gloire,
Que l’hymen d’Iſperie aprés une victoire,	Que l’hymen d’Ispérie après une victoire,
e ne m’en défens point j’adore ſes vertus,	Je ne m’en défens point, j’adore ses vertus,
Cependant vous l’avez promiſe à Lucejus,	Cependant vous l’avez promise à Lucejus,
Et vôtre foy Seigneur...	Et votre foi Seigneur…
Cette promeſſe eſt vaine,	Cette promesse est vaine,
Elle eſt vôtre captive, & ne peut être à luy,	Elle est votre captive, et ne peut être à lui,
Et pouroit être à vous, Seigneur, dés aujourd’huy.	Et pourrait être à vous, Seigneur, dès aujourd’hui.
Heureux! ſi mon ſang avoit cet avantage	Heureux! si mon sang avait cet avantage
De cimenter la paix que demande Cartage,	De cimenter la paix que demande Carthage,
Je réponds d’Iſperie, elle y doit conſentir,	Je réponds d’Ispérie, elle y doit consentir,
J’attens vôtre réponſe avant que de partir,	J’attends votre réponse avant que de partir,
En l’attendant ſouffrez que je parle à ma Niéce.	En l’attendant souffrez que je parle à ma Nièce.
Seigneur, vous le pouvez.	Seigneur, vous le pouvez.
Ah Ciel! que m’a-t-il dit! il prévient mon ardeur,	Ah Ciel! que m’a-t-il dit! il prévient mon ardeur,
A-t-il lû dans mes yeux le ſecret de mon cœur?	A-t-il lu dans mes yeux le secret de mon cœur?
Il vient a rallumer dans le fonds de mon ame?	Il vient la rallumer dans le fond de mon âme?
Il me donne Iſperie? ah! quel ſaiſiſſement	Il me donne Ispérie? ah! quel saisissement
Vient de fraper mon cœur dans ce fatal moment?	Vient de frapper mon cœur dans ce fatal moment?
Ayant mal dans mon Camp déguiſé ma tendreſſe,	Ayant mal dans mon Camp déguisé ma tendresse,
Il eſt par Aurilcar inſtruit de ma foibleſſe,	Il est par Aurilcar instruit de ma faiblesse,
Et ce grand politique autant que grand guerrier	Et ce grand politique autant que grand guerrier
Mais pourquoy refuſer l’accord qu’il me demande?	Mais pourquoi refuser l’accord qu’il me demande?
Qu'y s'opoſe à mes vœux? qu’eſt-ce que j’aprehende?	Qui s’oppose à mes vœux? qu’est-ce que j’appréhende?
Que de pleurs? que de ſang nous pouvons épargner?	Que de pleurs? que de sang nous pouvons épargner?
Le Senat m’a remis une pleine puiſſance	Le Sénat m’a remis une pleine puissance
De faire les Traitez de paix & d’alliance,	De faire les Traités de paix et d’alliance,
Et ménageant ſa gloire avec ſes interêts;	Et ménageant sa gloire avec ses intérêts;
Rome ſçaura ſouſcrire à tout ce que je fais?	Rome saura souscrire à tout ce que je fais?
A Cartage d’ailleurs cette paix eſt honteuſe,	À Carthage d’ailleurs cette paix est honteuse,
Annibal a fléchy, ſon orgueil a plié,	Hannibal a fléchi, son orgueil a plié,
Et par là n’eſt-il pas aſſez humilié?	Et par là n’est-il pas assez humilié?
Dois-je accorder la paix & m’oublier moy-même?	Dois-je accorder la paix et m’oublier moi-même?
Dieux! ſoûtenez ma gloire, & verſez dans mon ſein	Dieux! soutenez ma gloire, et versez dans mon sein
Un conſeil ſalutaire à l’Empire Romain.	Un conseil salutaire à l’Empire Romain.
OUY, Madame, Annibal par l'éclat de vos charmes	Oui, Madame, Hannibal par l’éclat de vos charmes
Du fameux Scipion a ſuſpendu les armes;	Du fameux Scipion a suspendu les armes;
On dit qu’il a d’abord rejetté fieremẽt	On dit qu’il a d’abord rejeté fièrement
Mais qu’à la fin quittant ſon ſuperbe langage,	Mais qu’à la fin quittant son superbe langage,
De Rome il a connu la gloire, l'avantage;	De Rome il a connu la gloire, l’avantage;
Etoit avantageuſe à l’Empire Romain,	Était avantageuse à l’Empire Romain,
Qu'il pouvoit accorder l’amour, la politique,	Qu’il pouvait accorder l’amour, la politique,
Et ſuivant ſon panchant ſervir ſa Republique;	Et suivant son penchant servir sa République;
Vos yeux ont captivé cet illuſtre Vainqueur.	Vos yeux ont captivé cet illustre Vainqueur.
Annibal veut qu’il ſoit le maître de mon cœur	Hannibal veut qu’il soit le maître de mon cœur.
Juſte Dieux! de la paix je ſeray la victime,	Justes Dieux! de la paix je serai la victime,
Il va parler en maître, Aurilcar à voulu	Il va parler en maître, Aurilcar a voulu
Déja me preparer à cet ordre abſolu;	Déjà me préparer à cet ordre absolu;
Veut me ſacrifier au repos de l'Affrique;	Veut me sacrifier au repos de l’Afrique;
Que fera Lucejus helas! contre Annibal,	Que fera Lucejus hélas! contre Hannibal,
Lorſque dans Scipion il rencontre un rival,	Lorsque dans Scipion il rencontre un rival,
Ce Prince infortuné, dont j'expoſe la vie,	Ce Prince infortuné, dont j’expose la vie,
Il va venir, ah Dieux, que luy dire Ermilie?	Il va venir, ah Dieux, que lui dire Ermilie?
Mais toy-même, va, cours au devant de ſes pas,	Mais toi-même, va, cours au devant de ses pas,
Qu'il parte de ce Camp, qu’il m’évite, qu’il fuye	Qu’il parte de ce Camp, qu’il m’évite, qu’il fuie
Les regards d’Annibal & les yeux d’Iſperie,	Les regards d’Hannibal et les yeux d’Ispérie,
Qu'il m’obéïſſe... Ah Ciel! il vient, il n’eſt plus temps.	Qu’il m’obéisse… Ah Ciel! il vient, il n’est plus temps.
HE' bien, aprenez-moy quelle eſt ma deſtinée?	Hé bien, apprenez-moi quelle est ma destinée?
AMadame, eſt-elle heureuſe? eſt-elle infortunée?	Madame, est-elle heureuse? est-elle infortunée?
Que j'ay ſouffert, grands Dieux! attendant ce moment?	Que j’ai souffert, grands Dieux! attendant ce moment?
Mais qu’a-t-on reſolu? quel accommodement?	Mais qu’a-t-on résolu? quel accommodement?
Quel accord Annibal a-t-il fait?...	Quel accord Hannibal a-t-il fait?…
Partez, Seigneur, je crains qu’il ne nous voye enſemble,	Partez, Seigneur, je crains qu’il ne nous voit ensemble,
Sçavez-ous quels perils vous courez en ces lieux,	Savez-vous quels périls vous courez en ces lieux,
Je ne partiray point, & de grace, Madame	Je ne partirai point, et de grâce, Madame
Parlez, expliquez-moy le trouble de vôtre ame.	Parlez, expliquez-moi le trouble de votre âme.
On veut que de la paix je ſois le nœud fatal,	On veut que de la paix je sois le nœud fatal,
C’eſt vous en dire aſſez.	C’est vous en dire assez.
Hé quoy donc Annibal...	Hé quoi donc Hannibal…
Me donne à Scipion.	Me donne à Scipion.
Malgré tant de ſermens voila la foy punique!	Malgré tant de serments voilà la foi punique!
Je m’en étois douté; quoy? malgré vôtre foy,	Je m’en étais douté; quoi? Malgré votre foi,
Le crüel vous engage en une autre alliance,	Le cruel vous engage en une autre alliance,
Je veux le voir, je veux courir à la vangeance,	Je veux le voir, je veux courir à la vengeance,
Laiſſez-moy luy parler & j’y vais...	Laissez-moi lui parler et j’y vais…
Arreſtez,	Arrêtez,
Aprenez les malheurs que vous vous apreſtez;	Apprenez les malheurs que vous vous apprêtez;
Fuyez, Seigneur, fuyez de ce Camp redoutable,	Fuyez, Seigneur, fuyez de ce Camp redoutable,
Vous n’y pouvez trouver que la mort ou les fers.	Vous n’y pouvez trouver que la mort ou les fers.
Et qu’ais-je à ménager encor ſi je vous perds,	Et qu’ai-je à ménager encor si je vous perds?
Je veux percer un cœur qui m'arrache le vôtre;	Je veux percer un cœur qui m’arrache le vôtre;
Encor pour Scipion, s’il vous aime aujourd’huy,	Encor pour Scipion, s’il vous aime aujourd’hui,
Madame, en vous voyant qui ſeroit moins que luy,	Madame, en vous voyant qui ferait moins que lui,
Je dois luy pardonner une tendreſſe extrême,	Je dois lui pardonner une tendresse extrême,
Il n'a pû l’éviter, j’en juge par moy-même,	Il n’a pu l’éviter, j’en juge par moi-même,
Vos yeux me répondoient qu’il ſeroit mon rival,	Vos yeux me répondaient qu’il serait mon rival,
C’eſt ſur luy...	C’est sur lui…
Moderez cette vaine colere,	Modérez cette vaine colère,
Je ne rompray jamais le ſerment ſolemnel	Je ne romprai jamais le serment solennel
Que m’impoſe un lien qui doit être éternel,	Que m’impose un lien qui doit être éternel,
Ny Scipion, ny Rome, & toute ſa puiſſance	Ni Scipion, ni Rome, et toute sa puissance
N’obtiendront point de moy de lâche obeïſſance,	N’obtiendront point de moi de lâche obéissance,
Je réponds de mon cœur, répondez-moy de vous,	Je réponds de mon cœur, répondez-moi de vous,
Mais de grâce évitez Annibal en couroux,	Mais de grâce évitez Hannibal en courroux,
Dans un ſi grand peril de vous voir tant d’audace;	Dans un si grand péril de vous voir tant d’audace;
Si vous m’aimez, Seigneur, partez au nom des Dieux,	Si vous m’aimez, Seigneur, partez au nom des Dieux,
Mais n’entreprenez rien pour la triſte Iſperie,	Mais n’entreprenez rien pour la triste Ispérie,
Pour le prix de ſa foy conſervez vôtre vie,	Pour le prix de sa foi conservez votre vie,
Peut-être Scipion quoyque vôtre rival,	Peut-être Scipion quoique votre rival,
Sera bien moins pour vous à craindre qu’Annibal,	Sera bien moins pour vous à craindre qu’Hannibal,
Il va venir, Seigneur, évitez ſa colere.	Il va venir, Seigneur, évitez sa colère.
Et je demeurerois tranquille pour vous plaire?	Et je demeurerais tranquille pour vous plaire?
Quand une mort certaine en deviendroit le fruit;	Quand une mort certaine en deviendrait le fruit;
Permettez ſeulement ſi les Dieux me ſecondent,	Permettez seulement si les Dieux me secondent,
Si je puis penetrer juſqu’à vous dans ces lieux,	Si je puis pénétrer jusqu’à vous dans ces lieux,
Que mon bras vous arrache à ce Camp odieux,	Que mon bras vous arrache à ce Camp odieux,
Madame, ou ſi le ſort trahit mon entrepriſe,	Madame, ou si le sort trahit mon entreprise,
Conſervez-moy la foy que vous m’avez promiſe,	Conservez-moi la foi que vous m’avez promise,
Honorez de vos pleurs un Amant, un époux,	Honorez de vos pleurs un Amant, un époux,
Et ſi je meurs, du moins, ſongez que c’eſt pour vous;	Et si je meurs, du moins, songez que c’est pour vous;
HElas! que va-t-il entreprendre?	Hélas! que va-t-il entreprendre?
Il va perir, c’eſt tout ce que j’en dois attendre?	Il va périr, c’est tout ce que j’en dois attendre?
Donnez à cet Amant un deſtin plus heureux,	Donnez à cet Amant un destin plus heureux,
Qu’il regagne ſon Camp, & qu’enfin il revienne	Qu’il regagne son Camp, et qu’enfin il revienne
Soûtenir dignement & ſa gloire & la mienne?	Soutenir dignement et sa gloire et la mienne?
Dieux! Annibal paroît...	Dieux! Hannibal paraît…
J'Embraſſe vos genoux,	J’embrasse vos genoux,
Seigneur, que vos bontez...	Seigneur, que vos bontés…
Seigneur, ſi vous uſez par un ordre ſevere	Seigneur, si vous usez par un ordre sévère
Du pouvoir que ſur moy vous a donné mon pere,	Du pouvoir que sur moi vous a donné mon père,
Si vous n’avez pitié du trouble où je me voy,	Si vous n’avez pitié du trouble où je me vois,
Et ſi vous violez une ſainte promeſſe,	Et si vous violez une sainte promesse,
Sur qui mon cœur ſoûmis a reglé ſa tendreſſe...	Sur qui mon cœur soumis a réglé sa tendresse…
Non, ne m’opoſez point de frivolles ardeurs,	Non, ne m’opposez point de frivoles ardeurs,
L’amour ne regle pas le deſtin des grands cours,	L’amour ne règle pas le destin des grands cœurs,
Il le faut immoler au bien de la patrie,	Il le faut immoler au bien de la patrie,
Et pourquoy cette paix, Seigneur, n’avez-vous pas	Et pourquoi cette paix, Seigneur, n’avez-vous pas
Cent mille hõmes encor dont les cœurs & les bras...	Cent mille hommes encor dont les cœurs et les bras…
Mais Dieux! elle n’eſt plus à vaincre acoûtumée,	Mais Dieux! elle n’est plus à vaincre accoutumée,
Madame, je n’ay plus d’intrepides ſoldats,	Madame, je n’ai plus d’intrépides soldats,
Leurs cœurs ſont affoiblis auſſi bien que leurs bras,	Leurs cœurs sont affaiblis aussi bien que leurs bras,
Fatalles voluptez, délices de Capoüe!	Fatales voluptés, délices de Capoue!
Vous nous coutâtes cher, il eſt vray, je l'avoüe,	Vous nous coûtâtes cher, il est vrai, je l’avoue,
Nous avions triomphé dans les adverſitez,	Nous avions triomphé dans les adversités,
Et ce repos des miens moliſſant le courage,	Et ce repos des miens mollissant le courage,
Capoüe à ſauvé Rome & menace Cartage.	Capoue a sauvé Rome et menace Carthage.
Ils retrouvent en vous le même General;	Ils retrouvent en vous le même Général;
Seigneur, vôtre valeur & vôtre renommée...	Seigneur, votre valeur et votre renommée…
Qu’on me faſſe trouver auſſi la même Armée?	Qu’on me fasse trouver aussi la même Armée?
Annibal répondant de ſemblables ſuccés	Hannibal répondant de semblables succès
Ne ſeroit pas reduit à demander la paix;	Ne serait pas réduit à demander la paix;
Mais il me reſte peu de troupes aguerries,	Mais il me reste peu de troupes aguerries,
J’ay Scipion en tête avec trop de vertus,	J’ai Scipion en tête avec trop de vertus,
Et je n’ay plus à faire à des Flaminius.	Et je n’ai plus à faire à des Flaminius.
Pour marquer l’intereſt que vous y devez prendre;	Pour marquer l’intérêt que vous y devez prendre;
Il faut donc en ce jour épouſer ce Heros,	Il faut donc en ce jour épouser ce Héros,
Pour rendre aux Africains la gloire & le repos,	Pour rendre aux Africains la gloire et le repos,
Il faut que de la paix vous ſoyez un ſeur gage,	Il faut que de la paix vous soyez un sûr gage,
Vôtre hymen va ſauver & l'Afrique & Cartage,	Votre hymen va sauver et l’Afrique et Carthage,
Quel triomphe pour vous en vous laiſſant fléchir?	Quel triomphe pour vous en vous laissant fléchir?
Moy, Seigneur?	Moy, Seigneur?
N’ais-je pas ſacrifié ma gloire?	N’ai-je pas sacrifié ma gloire?
Madame, & cet effort à cent fois plus coûté	Madame, et cet effort a cent fois plus coûté
A L’orgueil d’Annibal, à toute ſa fierté,	À l’orgueil d’Hannibal, à toute sa fierté,
Qu’il n’en poura jamais coûter à vôtre flâme,	Qu’il n’en pourra jamais coûter à votre flamme,
J’en ay donné l’exemple, imitez-moy, Madame,	J’en ai donné l’exemple, imitez-moi, Madame,
Il faut ſacrifier vos feux à vôtre tour.	Il faut sacrifier vos feux à votre tour.
J’immoleray ma vie & non pas mon amour,	J’immolerai ma vie et non pas mon amour,
Ordonnez de mon ſort, diſpoſez de ma tête,	Ordonnez de mon sort, disposez de ma tête,
Je l’immole à Cartage, & ne puis rien de plus;	Je l’immole à Carthage, et ne puis rien de plus;
A Lucejus? ah Ciel! quand Scipion vous aime,	À Lucejus? ah Ciel! quand Scipion vous aime,
Ce Heros revêtu d’une gloire ſuprême,	Ce Héros revêtu d’une gloire suprême,
Se peut-il que le Chef des Celtiberiens	Se peut-il que le Chef des Celtibériens
Oſe luy diſputer l’honneur de vos liens?	Ose lui disputer l’honneur de vos liens?
Et lorſque vous voyez dans vos fers ce grand hõme	Et lorsque vous voyez dans vos fers ce grand homme
Qui va mettre à vos pieds la puiſſance de Rome,	Qui va mettre à vos pieds la puissance de Rome,
Songez-vous que l’honneur en rejallit ſur nous:	Songez-vous que l’honneur en rejaillit sur nous:
Ah ma Niéce! pour vous croyez-en ma tendreſſe,	Ah ma Nièce! pour vous croyez-en ma tendresse,
Secondez aujourd’huy de ſi juſtes deſſeins,	Secondez aujourd’hui de si justes desseins,
Et prenez pour époux le plus grand des Romains.	Et prenez pour époux le plus grand des Romains.
Me faiſant ſouvenir que je ſuis vôtre Niéce.	Me faisant souvenir que je suis votre Nièce.
A ſoûtenir ce nom ma gloire s’intereſſe,	À soutenir ce nom ma gloire s’intéresse,
Je ſuis Cartaginoiſe, & fille d’Hyerbal,	Je suis Carthaginoise, et fille d’Hyerbal,
Et pour dire encor plus la Niéce d’Annibal;	Et pour dire encor plus la Nièce d’Hannibal;
Et que mon cœur dédaigne enfin d’eſtre Romaine.	Et que mon cœur dédaigne enfin d’être Romaine.
Je voy que c’eſt en vain employer la douceur	Je vois que c’est en vain employer la douceur
Mais il faut étouffer cette vaine tendreſſe,	Mais il faut étouffer cette vaine tendresse,
Je ne dis plus qu’un mot, Madame, & je vous laiſſe.	Je ne dis plus qu’un mot, Madame, et je vous laisse.
Tournez vers Scipion vôtre cœur & vos vœux,	Tournez vers Scipion votre cœur et vos vœux,
Vous l’allez voir; ſur tout ſongez que je le veux.	Vous l’allez voir; surtout songez que je le veux.
Cruel? à Lucejus mon cœur ſera fidelle,	Cruel? à Lucejus mon cœur sera fidèle,
Et je ſeray toujours à cet ordre rebelle,	Et je serai toujours à cet ordre rebelle,
Montrer que nôtre cœur ne dépend que de nous,	Montrer que notre cœur ne dépend que de nous,
J'aperçois Scipion, armons-nous de courage,	J’aperçois Scipion, armons-nous de courage,
ON veut que vous ſoyez le gage d’une paix,	On veut que vous soyez le gage d’une paix,
Qui ſans doute n'eſt pas conforme à vos ſouhaits;	Qui sans doute n’est pas conforme à vos souhaits;
Mais, Madame, aujourd'huy je croirois faire un crime.	Mais, Madame, aujourd’hui je croirais faire un crime.
De ſouffrir qu’Annibal vous en fiſt la victime;	De souffrir qu’Hannibal vous en fît la victime;
J’honore vos vertus, j’adore vos apas,	J’honore vos vertus, j’adore vos appâts,
Mais ſans contraindre un cœur s’il ne ſe donne pas,	Mais sans contraindre un cœur s’il ne se donne pas,
De vôtre ſort, du mien, je vous laiſſe l’arbitre,	De votre sort, du mien, je vous laisse l’arbitre,
Vous avez ou la paix, ou la guerre en vos mains,	Vous avez ou la paix, ou la guerre en vos mains,
Que dites-vous, Seigneur? ah Ciel! pourois-je croire	Que dites-vous, Seigneur? ah Ciel! pourrais-je croire
Qu’un cœur tel que le mien meritât tant de gloire,	Qu’un cœur tel que le mien méritât tant de gloire,
Que le ſort de l'Afrique & celuy des Romains	Que le sort de l’Afrique et celui des Romains
Fuſt par vous aujourd'huy remis entre mes mains?	Fût par vous aujourd’hui remis entre mes mains?
Lorſque du mien, Seigneur, je ne ſuis plus maitreſſe,	Lorsque du mien, Seigneur, je ne suis plus maîtresse,
Qu’engagée à tenir une ſainte promeſſe...	Qu’engagée à tenir une sainte promesse…
PArdonnez ſi je vous interromps,	PArdonnez si je vous interromps,
Seigneur de Lucejus on voit les eſcadrons,	Seigneur, de Lucejus on voit les escadrons,
Et que vers nôtre Camp à marcher il s'aprête,	Et que vers notre Camp à marcher il s’apprête,
Qu'avec ſes étendarts on voit ceux des deux Rois.	Qu’avec ses étendards on voit ceux des deux Rois.
Ah! je reſpire enfin pour la premiere fois.	Ah! je respire enfin pour la première fois.
C’en eſt aſſez, Sextus, allez les reconnoître,	C’en est assez, Sextus, allez les reconnaître,
J’attens vôtre retour. Lucejus va paroître,	J’attends votre retour. Lucejus va paraître,
Madame, & je vois bien que pour vos interêts	Madame, et je vois bien que pour vos intérêts
Sans doute que ce Prince avance & vient lui-même	Sans doute que ce Prince avance et vient lui-même
Pour rejoindre Annibal... Dieux! quel deſordre extrême?	Pour rejoindre Hannibal… Dieux! quel désordre extrême?
Mais je vais le combattre & veux vous conquerir,	Mais je vais le combattre et veux vous conquérir,
Je vois par la frayeur dont vôtre ame eſt atteinte...	Je vois par la frayeur dont votre âme est atteinte…
Non, Seigneur, je commence à diſſiper ma crainte,	Non, Seigneur, je commence à dissiper ma crainte,
Malgré tous mes malheurs je reprends quelque eſpoir,	Malgré tous mes malheurs je reprends quelque espoir,
S’il vient me ſecourir il remplit ſon devoir.	S’il vient me secourir il remplit son devoir.
IL remplit ſon devoir. Ah! quelle confiance?	Il remplit son devoir. Ah! quelle confiance?
Elle s’en promet tout. Vos vœux trop empreſſez	Elle s’en promet tout. Vos vœux trop empressés
N’en ſont pas, Iſperie, encore où vous penſez?	N’en sont pas, Ispérie, encore où vous pensez?
Ah! je ſens redoubler & ma haine, & ma rage,	Ah! je sens redoubler et ma haine, et ma rage,
Il faut combattre, il faut rompre ce nœud fatal;	Il faut combattre, il faut rompre ce nœud fatal;
Ce Prince étoit ſans doute attendu d’Annibal,	Ce Prince était sans doute attendu d’Hannibal,
Sous pretexte de paix, ce Chef adroit peut-être	Sous prétexte de paix, ce Chef adroit peut-être
N’eſt venu dãs mon camp que pour le reconnoître,	N’est venu dans mon camp que pour le reconnaître,
Que pour gagner du temps ſur l'eſpoir d’un traité?	Que pour gagner du temps sur l’espoir d’un traité?
Par ces projets pompeux de paix & d’alliance,	Par ces projets pompeux de paix et d’alliance,
Il tâchoit d’endormir mes ſoins, ma vigilance,	Il tâchait d’endormir mes soins, ma vigilance,
A bien d’autres qu’à nous il a manqué de foy,	À bien d’autres qu’à nous il a manqué de foi,
Il vient, je ne dois plus le tenir en balance.	Il vient, je ne dois plus le tenir en balance.
NE me ſoupçonnez pas d’aucune intelligence,	Ne me soupçonnez pas d’aucune intelligence,
Seigneur, quand Lucejus vient pour ſes interêts,	Seigneur, quand Lucejus vient pour ses intérêts,
Les armes à la main s'opoſer à la paix,	Les armes à la main s’opposer à la paix,
On a vû ſes drapeaux, & ma juſte colere...	On a vu ses drapeaux, et ma juste colère…
Qu'il eſt heureux? il ſert ſa gloire & ſon amour,	Qu’il est heureux! il sert sa gloire et son amour,
Seigneur, il vient groſſir vôtre armée en ce jour,	Seigneur, il vient grossir votre armée en ce jour,
Seigneur, qu’oſez-vous dire? un tel ſoupçon m’outrage.	Seigneur, qu’osez-vous dire? Un tel soupçon m’outrage.
J'oſe diſe, Seigneur, ce que j’ay dû penſer.	J’ose dire, Seigneur, ce que j’ai dû penser.
Vous en dites aſſez enfin pour m’offenſer.	Vous en dites assez enfin pour m’offenser.
Vous êtes dans mon Camp, Seigneur, je vous reſpecte,	Vous êtes dans mon Camp, Seigneur, je vous respecte,
Mais la foy de Cartage aux Romains eſt ſuſpecte.	Mais la foi de Carthage aux Romains est suspecte.
Ah! c’en eſt trop, il faut...	Ah! c’en est trop, il faut…
Et quittons des ſoupçons incertains & confus;	Et quittons des soupçons incertains et confus;
Il faut que vôtre ardeur à la mienne réponde,	Il faut que votre ardeur à la mienne réponde,
Annibal, ſi les Dieux ont mis entre nos mains	Hannibal, si les Dieux ont mis entre nos mains
Le deſtin de l'Afrique, & celuy des Romains,	Le destin de l’Afrique, et celui des Romains,
Il faut dans ce grand jour ſans tarder davantage,	Il faut dans ce grand jour sans tarder davantage,
Faire triompher Rome, ou délivrer Cartage,	Faire triompher Rome, ou délivrer Carthage,
Il faut voir l’une ou l'autre, ou libre, ou dãs les fers,	Il faut voir l’une ou l’autre, ou libre, ou dans les fers,
Et donner un ſeul maître enfin à l’Univers.	Et donner un seul maître enfin à l’Univers.
Et déja vous croyez courir à la victoire,	Et déjà vous croyez courir à la victoire,
Scipion, mais je veux ſeconder vos ſouhaits;	Scipion, mais je veux seconder vos souhaits;
Ouy, j’accepte aujourd'huy la bataille, & j'eſpere	Oui, j’accepte aujourd’hui la bataille, et j’espère
Vous mettre au même état où j’ay mis vôtre pere;	Vous mettre au même état où j’ai mis votre père;
Je me rends à ma haine, il faut remplir mon ſort,	Je me rends à ma haine, il faut remplir mon sort,
J’ay promis de haïr Rome juſqu’à la mort,	J’ai promis de haïr Rome jusqu’à la mort,
En naiſſant j’ay juré la guerre au Capitole,	En naissant j’ai juré la guerre au Capitole,
Juſqu’au dernier ſoûpir je luy tiendray parole.	Jusqu’au dernier soupir je lui tiendrai parole.
J’ay rompu grace au Ciel cet indigne traité:	J’ai rompu grâce au Ciel cet indigne traité:
Et vous Dieux! protecteurs du ſacré Capitole,	Et vous, Dieux! protecteurs du sacré Capitole,
Rome, vous attendez cette grande action,	Rome, vous attendez cette grande action,
Qu'Annibal ſuive un jour le char de Scipion.	Qu’Hannibal suive un jour le char de Scipion.
NE m’abandonne point, viens, ma chere Ermilie,	NE m’abandonne point, viens, ma chère Ermilie,
Partager les frayeurs dont mon ame eſt ſaiſie,	Partager les frayeurs dont mon âme est saisie,
Quel combat? quelle horreur? quelle confuſion?	Quel combat? quelle horreur? quelle confusion?
Lucejus eſt aux mains avecque Scipion,	Lucejus est aux mains avec Scipion,
Qui va de mon Amant faire la deſtinée?	Qui va de mon Amant faire la destinée?
Je ne dis point la mienne, ah Dieux! vous ſçavez bien	Je ne dis point la mienne, ah Dieux! Vous savez bien
As-tu vû comme moi ce Heros intrepide,	As-tu vu comme moi ce Héros intrépide,
Animé par l’amour qui luy ſervoit de guide,	Animé par l’amour qui lui servait de guide,
Pouſſer de Lelius les eſcadrons épars,	Pousser de Lélius les escadrons épars,
Et déja prés de nous planter ſes étendars,	Et déjà près de nous planter ses étendards,
Quand le fier Scipion eſt venu plein de rage	Quand le fier Scipion est venu plein de rage
De ſon Camp ébranlé ranimer le courage.	De son Camp ébranlé ranimer le courage.
J'en ay pâly grands Dieux! & n’ay rien vû de plus;	J’en ai pâli grands Dieux! et n’ai rien vu de plus;
Tout s’eſt mêlé pour lors, le tumulte des armes,	Tout s’est mêlé pour lors, le tumulte des armes,
Que je tremble pour luy malgré ſes grands efforts?	Que je tremble pour lui malgré ses grands efforts?
Helas! il eſt tombé peut-être entre les morts.	Hélas! il est tombé peut-être entre les morts.
Raſſurez-vous, Madame, ayez quelque eſperance,	Rassurez-vous, Madame, ayez quelque espérance,
La valeur d’Annibal met le ſort en balance,	La valeur d’Hannibal met le sort en balance,
Ce Heros qui combat fera voir ſon grand cœur	Ce Héros qui combat fera voir son grand cœur
Sans doute, & Scipion n'eſt pas encor vainqueur,	Sans doute, et Scipion n’est pas encor vainqueur,
MAdame c’en eſt fait, nôtre eſperãce eſt vaine,	MAdame c’en est fait, notre espérance est vaine,
Annibal eſt vaincu, Scipion eſt vainqueur,	Hannibal est vaincu, Scipion est vainqueur,
Bien qu’Annibal ait fait un effort incroyable	Bien qu’Hannibal ait fait un effort incroyable
Pour rallier les ſiens d’un ſoin infatigable,	Pour rallier les siens d’un soin infatigable,
Tout ſon Camp par avance étoit ſaiſi d’effroy,	Tout son Camp par avance était saisi d’effroi,
Tout fuit, & j'en pâlis & pour vous & pour moy;	Tout fuit, et j’en pâlis et pour vous et pour moi;
Scipion triomphant va nous parler en maître,	Scipion triomphant va nous parler en maître,
Nos fers ſont redoublez, & ſon amour peut-être...	Nos fers sont redoublés, et son amour peut-être…
Hé que fait Lucejus?	Hé que fait Lucejus?
Aprenez-moy ſon ſort; peut-être il ne vit plus.	Apprenez-moi son sort; peut-être il ne vit plus.
Mais avecque Annibal les deux Rois ſont en fuite,	Mais avec Hannibal les deux Rois sont en fuite,
Peut-être qu’avecque eux cherchãt un pareil ſort...	Peut-être qu’avec eux cherchant un pareil sort…
Il ne fuit point, Madame, & ſans doute il eſtmort;	Il ne fuit point, Madame, et sans doute il est mort;
Quoy? Lucejus fuiroit en perdant ce qu’il aime,	Quoi? Lucejus fuirait en perdant ce qu’il aime,
Je connois ſa valeur & ſon amour extréme,	Je connais sa valeur et son amour extrême,
Il aura combatu juſqu’au dernier ſoûpir,	Il aura combattu jusqu’au dernier soupir,
Dieux que je ſuis en proye à mon inquietude?	Dieux, que je suis en proie à mon inquiétude?
Je ne puis demeurer dans cette incerritude,	Je ne puis demeurer dans cette incertitude,
S’il eſt parmy les morts expirer avec luy.	S’il est parmi les morts expirer avec lui.
O Fortune! ô journée à toutes deux fatale!	Ô Fortune! ô journée à toutes deux fatale!
Mais je dois envier le ſort de ma rivale;	Mais je dois envier le sort de ma rivale;
Je ne ſçaurois la plaindre, & malgré ſes douleurs	Je ne saurais la plaindre, et malgré ses douleurs
Pour un Amant fidelle elle verſe des pleurs;	Pour un Amant fidèle elle verse des pleurs;
Du moins, ou s'il eſt mort elle n’a qu’à le ſuivre;	Du moins, ou s’il est mort elle n’a qu’à le suivre;
Que vais-je devenir? quel doit être mon ſort?	Que vais-je devenir? quel doit être mon sort?
Pour moy? de tous côtez je ne voy que la mort;	Pour moi? de tous côtés je ne vois que la mort;
Retournons dans Cartage enſevelir ma honte,	Retournons dans Carthage ensevelir ma honte,
On la doit aſſieger, j’y finiray mes jours,	On la doit assiéger, j’y finirai mes jours,
J'attends de Scipion ce funeſte ſecours;	J’attends de Scipion ce funeste secours;
Je l'aperçois, parlons.	Je l’aperçois, parlons.
QU'on obſerve Iſperie?	Qu’on observe Ispérie?
Qu'on la ſuive? & ſur tout ayez ſoin de ſa vie.	Qu’on la suive? et surtout ayez soin de sa vie.
Seigneur, & vôtre nom encor plus éclatant	Seigneur, et votre nom encor plus éclatant
Par cette memorable & derniere victoire	Par cette mémorable et dernière victoire
Vous êtes genereux, daignez briſer mes fers,	Vous êtes généreux, daignez briser mes fers,
Je les ay ſans regret à ma honte ſouffers;	Je les ai sans regret à ma honte soufferts;
Nous vous allons bien-tôt voir aſſieger Cartage,	Nous vous allons bientôt voir assiéger Carthage,
Souffrez que ma preſence anime ſon courage,	Souffrez que ma présence anime son courage,
L’amour de ma patrie allumant mon ardeur,	L’amour de ma patrie allumant mon ardeur,
Je veux y terminer ma vie & mon malheur.	Je veux y terminer ma vie et mon malheur.
Ouy, de vôtre deſtin je vous rends la maîtreſſe,	Oui, de votre destin je vous rends la maîtresse,
Soyez libre, Madame, & d’un cœur affermy	Soyez libre, Madame, et d’un cœur affermi
Ma victoire n’a fait qu'enfler ſa renommée,	Ma victoire n’a fait qu’enfler sa renommée,
Luy ſeul a combatu dans toute ſon Armée,	Lui seul a combattu dans toute son Armée,
J’ay malgré ſa défaite admiré ſa valeur,	J’ai malgré sa défaite admiré sa valeur,
Il n'a jamais été plus grand qu’en ce malheur:	Il n’a jamais été plus grand qu’en ce malheur:
Vous pourez aujourd'huy le revoir dans Cartage,	Vous pourrez aujourd’hui le revoir dans Carthage,
Contre moy je luy donne un puiſſant avantage:	Contre moi je lui donne un puissant avantage:
Et rendez les honneurs qu’on doit à ſes vertus.	Et rendez les honneurs qu’on doit à ses vertus.
Je n’attendois pas moins d’un heros magnanime,	Je n’attendais pas moins d’un héros magnanime,
Que mon cœur penetré d’un ſi noble deſſein,	Que mon cœur pénétré d’un si noble dessein,
Me fera reverer toujours le nom Romain.	Me fera révérer toujours le nom Romain.
AInſi vous l’envoyez ſecourir ſa patrie:	AInsi vous l’envoyez secourir sa patrie:
Mais, Seigneur, qu’allez-vous ordonner d’Iſperie?	Mais, Seigneur, qu’allez-vous ordonner d’Ispérie?
Maître de ſon deſtin dans ce fatal moment,	Maître de son destin dans ce fatal moment,
Vous avez dans vos mains la Maîtreſſe & l’Amant,	Vous avez dans vos mains la maîtresse et l’Amant,
Ah! Lepide,	Ah! Lépide,
Je tremble que l’amour ne me ſerve de guide,	Je tremble que l’amour ne me serve de guide,
Que contre ma vertu ſe revoltent mes ſens;	Que contre ma vertu se révoltent mes sens;
La gloire, la pitié, l’amour, tout me déchire,	La gloire, la pitié, l’amour, tout me déchire,
Que je ſouffre grands Dieux! j'en rougis, j'en ſoûpire,	Que je souffre grands Dieux! j’en rougis, j’en soupire,
Qu'il me faut rendre encor de terribles combats?	Qu’il me faut rendre encor de terribles combats?
Annibal eſt vaincu, mais l’amour ne l'eſt pas.	Hannibal est vaincu, mais l’amour ne l’est pas.
Hé? Seigneur, profitez des droits de la victoire?	Hé! Seigneur, profitez des droits de la victoire?
Cartage va tomber, & le ſoldat Romain	Carthage va tomber, et le soldat Romain
Vous honore déja du titre d'Africain,	Vous honore déjà du titre d’Africain,
En flatant mon amour que me fais-tu connoître?	En flattant mon amour que me fais-tu connaître?
Ouy, ſi j’en conſultois les tranſports de mon cœur,	Oui, si j’en consultais les transports de mon cœur,
Peut-être deviendrois-je un ſuperbe vainqueur:	Peut-être deviendrais-je un superbe vainqueur:
Elle viendra bien-tôt cette tendre Iſperie,	Elle viendra bientôt cette tendre Ispérie,
De ſon heureux Amant me demander la vie;	De son heureux Amant me demander la vie;
Elle ignore ſon ſort que je luy fais cacher,	Elle ignore son sort que je lui fais cacher,
Mais helas! ce qui rend ſa gloire plus parfaite,	Mais hélas! ce qui rend sa gloire plus parfaite,
Il contraint ſon vainqueur d’envier ſa defaite,	Il contraint son vainqueur d’envier sa défaite,
J’ay ſenti redoubler mon amour, ma fureur;	J’ai senti redoubler mon amour, ma fureur;
Il tâchoit de ſauver une Amante fidelle,	Il tâchait de sauver une Amante fidèle,
Je voyois à regret qu’il étoit digne d’elle:	Je voyais à regret qu’il était digne d’elle:
Il étoit des momens où malgré mon couroux	Il était des moments où malgré mon courroux
Je trouvois Annibal moins digne de mes coups:	Je trouvais Hannibal moins digne de mes coups:
Mais que fait cet Amant? a-t-il la même audace?	Mais que fait cet Amant? a-t-il la même audace?
Indigné d’avoir fait un inutile effort,	Indigné d’avoir fait un inutile effort,
Il nous a conjurez de luy donner la mort:	Il nous a conjurés de lui donner la mort:
Scipion eſt vainqueur, & je perds Iſperie;	Scipion est vainqueur, et je perds Ispérie;
Lelius le conſole, & d’un ſoin genereux...	Lélius le console, et d’un soin généreux…
Non, c’en eſt fait, il faut qu’il étouſſe ſes feux,	Non, c’en est fait, il faut qu’il étouffe ses feux,
Je veux que Lucejus abandonne Iſperie,	Je veux que Lucejus abandonne Ispérie,
A ce prix je metray ſa liberté, ſa vie	À ce prix je mettrai sa liberté, sa vie
Ceſt à luy d’obéïr... Mais quel eſt mon deſſein?	C’est à lui d’obéir… Mais quel est mon dessein?
Juſtes Dieux? eſt-ce ainſi que je ſuis les exemples	Justes Dieux? est-ce ainsi que je suis les exemples
Des Heros à qui Rome a conſacré des Temples?	Des Héros à qui Rome a consacré des Temples?
Qui les rendra fameux à la poſterité?	Qui les rendra fameux à la postérité?
Etouffons un amour... Ah Dieux! que vais-je faire?	Étouffons un amour… Ah Dieux! que vais-je faire?
De ma victoire un autre aura-t-il le ſalaire?	De ma victoire un autre aura-t-il le salaire?
Mais je vois Iſperie, ah! j’ay mal combatu,	Mais je vois Ispérie, ah! J’ai mal combattu,
A ſes yeux j’ay beſoin de toute ma vertu.	À ses yeux j’ai besoin de toute ma vertu.
AH! Seigneur, tirez-moy du plus cruel martyre	AH! Seigneur, tirez-moi du plus cruel martyre
On me refuſe helas! de m'aprendre ſon ſort,	On me refuse hélas! de m’apprendre son sort,
Ce Prince malheureux a-t-il trouvé la mort?	Ce Prince malheureux a-t-il trouvé la mort?
D’un champ couvert de morts & rẽply de carnage?	D’un champ couvert de morts et rempli de carnage?
Ces cadavres ſanglants tous pâles, tous glacez,	Ces cadavres sanglants tous pâles, tous glacés,
Qui n’offroient à mes yeux que des traits effacez,	Qui n’offraient à mes yeux que des traits effacés,
Ah! Seigneur, concevez mon deſeſpoir extrême,	Ah! Seigneur, concevez mon désespoir extrême,
Dãs toutes ſes horreurs je cherchois ce que j’aime.	Dans toutes ses horreurs je cherchais ce que j’aime.
Ne craignez plus pour luy, diſſipez vôtre effroy,	Ne craignez plus pour lui, dissipez votre effroi,
Il eſt vivant, mais quoy vous en êtes le maître?	Il est vivant, mais quoi vous en êtes le maître?
Vous pouvez diſpoſer de ſon ſort, & peut-être	Vous pouvez disposer de son sort, et peut-être
Mais je ſoupçonne à tort, Seigneur, vôtre vertu,	Mais je soupçonne à tort, Seigneur, votre vertu,
Songez que dans vos fers il n’a pour toutes armes	Songez que dans vos fers il n’a pour toutes armes
Que mes triſtes ſoûpirs, & que mes foibles larmes.	Que mes tristes soupirs, et que mes faibles larmes.
Et c’eſt ce qui me tüe: Il cauſe vos douleurs	Et c’est ce qui me tue: Il cause vos douleurs
Ce trop heureux Amant, il fait couler vos pleurs,	Ce trop heureux Amant, il fait couler vos pleurs,
Il coûte des ſoûpirs qui ſont dignes d’envie,	Il coûte des soupirs qui sont dignes d’envie,
Pardonnez-moy, Seigneur, ſi dans mes déplaiſirs	Pardonnez-moi, Seigneur, si dans mes déplaisirs
Je pouſſe devant vous d’inutiles ſoûpirs:	Je pousse devant vous d’inutiles soupirs:
Eh! détournez les vôtres:	Eh! détournez les vôtres:
Et puiſque leurs regards sõt deſtinez pour d’autres,	Et puisque leurs regards sont destinés pour d’autres,
Laiſſez m’en éviter l’éclat impérieux;	Laissez m’en éviter l’éclat impérieux;
Vous voyez les combats que je rends, juſtes Dieux!	Vous voyez les combats que je rends, justes Dieux!
Que dois-je faire enfin? je fremis quand j'y penſe,	Que dois-je faire enfin? je frémis quand j’y pense,
Madame, j’ay beſoin de toute ma conſtance;	Madame, j’ai besoin de toute ma constance;
Que l’on faſſe venir le Prince Lucejus?	Que l’on fasse venir le Prince Lucejus?
Quel eſt vôtre deſſein? qu’en devons-nous attendre,	Quel est votre dessein? qu’en devons-nous attendre,
Dans un moment vous le pourez aprendre.	Dans un moment vous le pourrez apprendre.
Que dois-je croire, ah Dieux! dãs cette extremité?	Que dois-je croire, ah Dieux! dans cette extrémité?
Quand d’un trouble ſi grand je vous vois agité,	Quand d’un trouble si grand je vous vois agité,
Que vos regards ſur moy ne tõbent qu’avec peine,	Que vos regards sur moi ne tombent qu’avec peine,
Deviendrois-je, Seigneur, l’objet de vôtre haine?	Deviendrais-je, Seigneur, l’objet de votre haine?
Madame, & plût aux Dieux que l'on pût vous haïr?	Madame, et plût aux Dieux que l’on pût vous haïr?
Si malgré moy j’évite une fatale veuë,	Si malgré moi j’évite une fatale vue,
Un objet tel que vous porte un charme qui tuë.	Un objet tel que vous porte un charme qui tue.
Me faſſe repentir d’un genereux effort,	Me fasse repentir d’un généreux effort,
Je vous ay voulu perdre, & ce bras temeraire	Je vous ai voulu perdre, et ce bras téméraire
S’il étoit libre encor tâcheroit de le faire;	S’il était libre encor tâcherait de le faire;
Vous êtes mon rival, vous m’avez tout ôté,	Vous êtes mon rival, vous m’avez tout ôté,
Vous devez m'immoler à vôtre ſeureté,	Vous devez m’immoler à votre sûreté,
Je ſuis vôtre captif auſſi bien qu’Iſperie,	Je suis votre captif aussi bien qu’Ispérie,
Qui deviendroit funeſte à vos jours glorieux,	Qui deviendrait funeste à vos jours glorieux,
J’irois les attaquer à la face des Dieux,	J’irais les attaquer à la face des Dieux,
Perdant ce que je perds tout ſeroit legitime.	Perdant ce que je perds tout serait légitime.
Je pardonne aiſément à ce tranſport jaloux,	Je pardonne aisément à ce transport jaloux,
Si j’étois Lucejus je l’aurois comme vous,	Si j’étais Lucejus je l’aurais comme vous,
Vous m'avez dû haïr & ce n’eſt point un crime,	Vous m’avez dû haïr et ce n’est point un crime,
Prince, pour un rival la haine eſt legitime,	Prince, pour un rival la haine est légitime,
Je le ſuis, je l’avoüe, ah Dieux! vous le ſçavez	Je le suis, je l’avoue, ah Dieux! Vous le savez
Un triomphe immortel dont la gloire ſemée	Un triomphe immortel dont la gloire semée
De tout ce que j’ay fait paſſe la renommée,	De tout ce que j’ai fait passe la renommée,
Rare, mais cependant qui puiſſe étreimité:	Rare, mais cependant qui puisse être imité:
Oüy, Madame, aujourd'huy je veux, quoy qu’il m’en coûte,	Oui, Madame, aujourd’hui je veux, quoi qu’il m’en coûte,
Enſeigner aux mortels cette nouvelle route,	Enseigner aux mortels cette nouvelle route,
Leur montrer comme on peut domter ſa paſſion,	Leur montrer comme on peut dompter sa passion,
Et vainqueur d’Annibal vaincre encor Scipion:	Et vainqueur d’Hannibal vaincre encor Scipion:
Prince, raſſurez-vous, je vous donne la vie,	Prince, rassurez-vous, je vous donne la vie,
Ah! Seigneur, permettez qu’embraſſant vos genoux	Ah! Seigneur, permettez qu’embrassant vos genoux
Je rende à vos vertus...	Je rende à vos vertus…
Quelle grace, Seigneur, devõs-nous pas vous rẽdre?	Quelle grâce, Seigneur, devons-nous pas vous rendre?
Mais du grand Scipion nous devions tout attendre.	Mais du grand Scipion nous devions tout attendre.
Retournez à Zama couronner vôtre foy,	Retournez à Zama couronner votre foi,
Elle eſt un preſent digne & de vous, & de moy;	Elle est un présent digne et de vous, et de moi;
Je ne demande icy pour toute recompenſe,	Je ne demande ici pour toute récompense,
Pour le prix & le nœud d’une étroite alliance,	Pour le prix et le nœud d’une étroite alliance,
Amy de Scipion, & du peuple Romain;	Ami de Scipion, et du peuple Romain;
Je vais me preparer au Siege de Cartage,	Je vais me préparer au Siège de Carthage,
Et j’eſpere dans peu la rangeant ſous mes loix	Et j’espère dans peu la rangeant sous mes lois
Triompher d’Annibal une ſeconde fois.	Triompher d’Hannibal une seconde fois.
Adieu, vivez heureux.	Adieu, vivez heureux.
Admirons ce grand homme,	Admirons ce grand homme,
Le plus perfait Heros qu’ait jamais produit Rome.	Le plus parfait Héros qu’ait jamais produit Rome.
