ORAISON   DEDICATOIRE.	ORAISON DÉDICATOIRE.
DOVX IESVS, mon   Seigneur, mon Sauueur,   & mon Dieu, me voicy   proſterné deuant voſtre   Maieſté, vouant & conſacrant cét écrit à voſtre gloire:	DOUX JÉSUS, mon Seigneur, mon Sauveur, et mon Dieu, me voici prosterné devant votre Majesté, vouant et consacrant cet écrit à votre gloire:
ains qu'auec eux ie chante à iamais pour cantique de triomphe, le mot   que de tout mon cœur ie prononce,   en témoignage de fidelité parmy les   hazards de cette vie mortelle VIVE   IESVS, VIVE IESVS.	ains qu’avec eux je chante à jamais pour cantique de triomphe, le mot que de tout mon cœur je prononce, en témoignage de fidélité parmi les hasards de cette vie mortelle VIVE JÉSUS, VIVE JÉSUS.
Ouy, Seigneur   IESVS, viuez & regnez en nos   cœurs es ſiecles des ſiecles.	Oui, Seigneur JÉSUS, vivez et régnez en nos cœurs ès siècles des siècles.
PREMIERE PARTIE   DE L’INTRODVCTION,   CONTENANT LES AVIS ET EXERCICES   requis pour conduire l’Ame dés ſon premier   deſir de la vie deuote, iuſques à vne entiere   reſolution de l’embraſſer.	PREMIÈRE PARTIE DE L’INTRODUCTION, CONTENANT LES AVIS ET EXERCICES requis pour conduire l’Âme dès son premier désir de la vie dévote, jusqu’à une entière résolution de l’embrasser.
Deſcription de la vraye deuotion.	Description de la vraie dévotion.
CHAPITRE I.	CHAPITRE I.
VOVS aſpirez à la deuotion, tres-chere Philothée, parce qu’eſtant Chreſtienne, vous ſçauez que c’eſt vne vertu extremement agreable à la diuine Maieſté.	VOUS aspirez à la dévotion, très chère Philothée, parce qu’étant Chrétienne, vous savez que c’est une vertu extrêmement agréable à la divine Majesté.
Mais dautant que les petites fautes, que l’on commet au commencement de quelque affaire, s’agrandiſſent infiniment au progrez, & ſont preſque irreparables à la fin;	Mais d’autant que les petites fautes, que l’on commet au commencement de quelque affaire, s’agrandissent infiniment au progrès, et sont presque irréparables à la fin;
il faut auant toutes choſes que vous ſçachiez que c’eſt que la vertu de deuotion:	il faut avant toutes choses que vous sachiez que c’est que la vertu de dévotion:
Arelius peignoit toutes les faces des images qu’il faiſoit, à l’air & reſſemblance des femmes qu’il aymoit:	Arélius peignait toutes les faces des images qu’il faisait, à l’air et ressemblance des femmes qu’il aimait:
& chacun peint la deuotion ſelon ſa paſſion & fantaiſie.	et chacun peint la dévotion selon sa passion et fantaisie.
Vn autre s’eſtimera deuot, parce qu’il dit vne grande multitude d’oraiſons tous les iours, quoy qu’apres cela ſa langue ſe fonde en toutes paroles faſcheuſes, arrogantes & iniurieuſes, parmy ſes domeſtiques & voiſins.	Un autre s’estimera dévot, parce qu’il dit une grande multitude d’oraisons tous les jours, quoi qu’après cela sa langue se fonde en toutes paroles fâcheuses, arrogantes et injurieuses, parmi ses domestiques et voisins.
L’autre tire fort volontiers l’aumoſne de ſa bourſe, pour la donner aux pauures:	L’autre tire fort volontiers l’aumône de sa bourse, pour la donner aux pauvres:
mais il ne peut tirer la douceur de ſon cœur, pour pardonner à ſes ennemis:	mais il ne peut tirer la douceur de son cœur, pour pardonner à ses ennemis:
l’autre pardonnera à ſes ennemis, mais tenir raiſon à ſes creanciers, iamais qu’à viue force de iuſtice.	l’autre pardonnera à ses ennemis, mais tenir raison à ses créanciers, jamais qu’à vive force de justice.
Tous ces gens là ſont vulgairement tenus pour deuots, & ne le ſont pourtant nullement.	Tous ces gens là sont vulgairement tenus pour dévots, et ne le sont pourtant nullement.
Les gens de Saul cherchoient Dauid en ſa maiſon: Michol ayant mis vne ſtatuë dedans vn lict, & l’ayant couuerte des habillemens de Dauid, leur fit accroire que c’eſtoit Dauid meſme qui dormoit malade.	Les gens de Saül cherchaient David en sa maison: Michol ayant mis une statue dedans un lit, et l’ayant couverte des habillements de David, leur fit accroire que c’était David même qui dormait malade.
& le monde croit que ce ſoient gens vrayement deuots & ſpirituels:	et le monde croit que ce soient gens vraiment dévots et spirituels:
mais en verité ce ne ſont que des ſtatuës & fantoſmes de deuotion.	mais en vérité ce ne sont que des statues et fantômes de dévotion.
ains elle n’eſt autre choſe qu’vn vray amour de Dieu:	ains elle n’est autre chose qu’un vrai amour de Dieu:
mais non pas toutesfois vn amour tel quel:	mais non pas toutefois un amour tel quel:
car en tant que l’amour diuin embellit noſtre ame, il s’appelle grace, nous rendant agreables à ſa diuine Maieſté;	car en tant que l’amour divin embellit notre âme, il s’appelle grâce, nous rendant agréables à sa divine Majesté;
en tant qu’il nous donne la force de bien faire, il s’appelle charité:	en tant qu’il nous donne la force de bien faire, il s’appelle charité:
mais quand il eſt paruenu iuſques au degré de perfection, auquel il ne nous fait pas ſeulement bien faire, mais nous fait operer ſoigneuſement, frequemment & promptement, alors il s’appelle deuotion.	mais quand il est parvenu jusqu’au degré de perfection, auquel il ne nous fait pas seulement bien faire, mais nous fait opérer soigneusement, fréquemment et promptement, alors il s’appelle dévotion.
Les auſtruches ne volent iamais, les poules volent peſamment, toutesfois baſſement & rarement:	Les autruches ne volent jamais, les poules volent pesamment, toutefois bassement et rarement:
les gens de bien, qui n’ont pas encores atteint la deuotion, volent en Dieu par leurs bonnes actions, mais rarement, lentement & peſamment:	les gens de bien, qui n’ont pas encore atteint la dévotion, volent en Dieu par leurs bonnes actions, mais rarement, lentement et pesamment:
les perſonnes deuotes volent en Dieu, frequemment, promptement & hautement.	les personnes dévotes volent en Dieu, fréquemment, promptement et hautement.
& comme il appartient à la charité de nous faire generalement & vniuerſellement pratiquer tous les commandemens de Dieu, il appartient auſſi à la deuotion de les nous faire promptement & diligemment.	et comme il appartient à la charité de nous faire généralement et universellement pratiquer tous les commandements de Dieu, il appartient aussi à la dévotion de les nous faire promptement et diligemment.
C’eſt pourquoy celuy qui n’obſerue tous les commandemens de Dieu, ne peut eſtre eſtimé ny bon, ny deuot, puis que pour eſtre bon, il faut auoir la charité, & pour eſtre deuot, il faut auoir outre la charité, vne grande viuacité & promptitude aux actions charitables.	C’est pourquoi celui qui n’observe tous les commandements de Dieu, ne peut être estimé ni bon, ni dévot, puisque pour être bon, il faut avoir la charité, et pour être dévot, il faut avoir outre la charité, une grande vivacité et promptitude aux actions charitables.
Et d’autant que la deuotion giſt en certain degré d’excellente charité, non ſeulement elle nous rend prompts, actifs & diligens à l’obſeruation de tous les commandemens de Dieu: mais outre cela, elle nous prouoque à faire promptement & affectionnément le plus de bonnes œuures que nous pouuons, encores qu’elles ne ſoient aucunement commandées, ains ſeulement conſeillées ou inſpirées.	Et d’autant que la dévotion gît en certain degré d’excellente charité, non seulement elle nous rend prompts, actifs et diligents à l’observation de tous les commandements de Dieu: mais outre cela, elle nous provoque à faire promptement et affectionnément le plus de bonnes œuvres que nous pouvons, encore qu’elles ne soient aucunement commandées, ains seulement conseillées ou inspirées.
Car tout ainſi qu’vn homme qui eſt nouuellement guery de quelque maladie, chemine autant qu’il luy eſt neceſſaire, mais lentement & peſamment: de meſme le pecheur eſtant guery de ſon iniquité, il chemine autant que Dieu luy commande, peſamment neantmoins & lentement, iuſques à tant qu’il ayt atteint la deuotion;	Car tout ainsi qu’un homme qui est nouvellement guéri de quelque maladie, chemine autant qu’il lui est nécessaire, mais lentement et pesamment: de même le pécheur étant gueri de son iniquité, il chemine autant que Dieu lui commande, pesamment néanmoins et lentement, jusqu’à tant qu’il ait atteint la dévotion;
car alors comme vn homme bien ſain, non ſeulement il chemine, mais il court & ſaute en la voye des commandemens de Dieu, & de plus il paſſe & court dans les ſentiers des conſeils & inſpirations celeſtes.	car alors comme un homme bien sain, non seulement il chemine, mais il court et saute en la voie des commandements de Dieu, et de plus il passe et court dans les sentiers des conseils et inspirations célestes.
En fin la charité & la deuotion ne ſont non plus differentes l’vne de l’autre, que la flamme l’eſt du feu, d’autant que la charité eſtant vn feu ſpirituel, quand elle eſt fort enflammée, elle ſ’appelle deuotion:	Enfin la charité et la dévotion ne sont non plus différentes l’une de l’autre, que la flamme l’est du feu, d’autant que la charité étant un feu spirituel, quand elle est fort enflammée, elle s’appelle dévotion:
Proprieté & excellence de la deuotion.	Propriété et excellence de la dévotion.
CHAPITRE II.	CHAPITRE II.
Ainſi le monde, ma chere Philothée, diffame tant qu’il peut la ſaincte deuotion, dépeignant les perſonnes deuotes auec vn viſage faſcheux, triſte & chagrin:	Ainsi le monde, ma chère Philothée, diffame tant qu’il peut la sainte dévotion, dépeignant les personnes dévotes avec un visage fâcheux, triste et chagrin:
& publiant que la deuotion donné des humeurs melancholiques & inſupportables.	et publiant que la dévotion donné des humeurs mélancoliques et insupportables.
Mais comme Ioſué & Caleb proteſtoient que non ſeulement la terre promiſe eſtoit bonne & belle, ains auſſi que la poſſeſſion en ſeroit douce & agreable:	Mais comme Josué et Caleb protestaient que non seulement la terre promise était bonne et belle, ains aussi que la possession en serait douce et agréable:
de meſme le ſainct Eſprit par la bouche de tous les Saincts, & noſtre Seigneur par la ſienne meſme, nous aſſeure que la vie deuote eſt vne vie douce, heureuſe & amiable.	de même le saint Esprit par la bouche de tous les Saints, et notre Seigneur par la sienne même, nous assure que la vie dévote est une vie douce, heureuse et amiable.
Le monde voit que les deuots ieuſnent, prient & ſouffrent iniures, ſeruent les malades, donnent aux pauures, veillent, contraignent leur cholere, ſuffoquent & eſtouffent leurs paſſions, ſe priuent des plaiſirs ſenſuels, & font telles & autres ſortes d’actions, leſquelles en elles meſmes, & de leur propre ſubſtance & qualité, ſont aſpres & rigoureuſes.	Le monde voit que les dévots jeûnent, prient et souffrent injures, servent les malades, donnent aux pauvres, veillent, contraignent leur colère, suffoquent et étouffent leurs passions, se privent des plaisirs sensuels, et font telles et autres sortes d’actions, lesquelles en elles-mêmes, et de leur propre substance et qualité, sont âpres et rigoureuses.
Mais le monde ne voit pas la deuotion interieure & cordiale, laquelle rend toutes ces actions agreables, douces & faciles.	Mais le monde ne voit pas la dévotion intérieure et cordiale, laquelle rend toutes ces actions agréables, douces et faciles.
mais en le ſucçant elles le conuertiſſent en miel, parce que telle eſt leur proprieté.	mais en le suçant elles le convertissent en miel, parce que telle est leur propriété.
O mondain! les ames deuotes treuuent beaucoup d’amertumes en leurs exercices de mortification;	Ô mondain! les âmes dévotes trouvent beaucoup d’amertumes en leurs exercices de mortification;
mais en les faiſant elles les conuertiſſent en douceur & ſuauité;	mais en les faisant elles les convertissent en douceur et suavité;
les feux, les flammes, les rouës, les eſpées ſembloient des fleurs & des parfums aux Martyrs, par ce qu’ils eſtoient deuots.	les feux, les flammes, les roues, les épées semblaient des fleurs et des parfums aux Martyrs, par ce qu’ils étaient dévots.
Que ſi la deuotion peut donner de la douceur aux plus cruels tourmens, & à la mort meſme;	Que si la dévotion peut donner de la douceur aux plus cruels tourments, et à la mort même;
qu’eſt-ce qu'elle fera pour les actions de la vertu? Le ſucre adoucit les fruicts mal meurs, & corrige la crudité & nuiſance de ceux qui ſont bien meurs.	qu’est-ce qu’elle fera pour les actions de la vertu? Le sucre adoucit les fruits mal mûrs, et corrige la crudité et nuisance de ceux qui sont bien mûrs.
Or la deuotion eſt le vray ſucre ſpirituel, qui oſte l’amertume aux mortifications, & la nuiſance aux pauures, & l’empreſſement aux riches, la deſolation à l’oppreſſé, & l’inſolence au fauoriſé, la triſteſſe aux ſolitaires, & la diſſolution à celuy qui eſt en compagnie:	Or la dévotion est le vrai sucre spirituel, qui ôte l’amertume aux mortifications, et la nuisance aux pauvres, et l’empressement aux riches, la désolation à l’oppressé, et l’insolence au favorisé, la tristesse aux solitaires, et la dissolution à celui qui est en compagnie:
elle ſert de feu en Hiuer, & de roſée en Eſté:	elle sert de feu en Hiver, et de rosée en Été:
elle reçoit le plaiſir & la douleur auec vn cœur preſque touſiours ſemblable, & nous remplit d’vne ſuauité merueilleuſe.	elle reçoit le plaisir et la douleur avec un cœur presque toujours semblable, et nous remplit d’une suavité merveilleuse.
Contemplez l’eſchelle de Iacob, (car c'eſt le vray portrait de la vie deuote) les deux coſtez entre leſquels on monte, & auſquels les eſchellons ſe tiennent, repreſentent l’oraiſon, qui impetre l’amour de Dieu, & les Sacremens, qui le conferent:	Contemplez l’échelle de Jacob, (car c’est le vrai portrait de la vie dévote) les deux côtés entre lesquels on monte, et auxquels les échelons se tiennent, représentent l’oraison, qui impètre l’amour de Dieu, et les Sacrements, qui le confèrent:
Or voyez, ie vous prie, ceux qui ſont ſur l’eſchelle, ce ſont des hommes qui ont des cœurs angeliques, ou des Anges qui ont des corps humains.	Or voyez, je vous prie, ceux qui sont sur l’échelle, ce sont des hommes qui ont des cœurs angéliques, ou des Anges qui ont des corps humains.
Ils ne ſont pas ieunes:	Ils ne sont pas jeunes:
mais ils le ſemblent eſtre, parce qu’ils ſont pleins de vigueur & agilité ſpirituelle.	mais ils le semblent être, parce qu’ils sont pleins de vigueur et agilité spirituelle.
Ils ont des aiſles pour voler, & s’élancent en Dieu par la ſaincte oraiſon:	Ils ont des ailes pour voler, et s’élancent en Dieu par la sainte oraison:
mais ils ont des pieds pour cheminer auec les hommes par vne ſaincte & amiable conuerſation:	mais ils ont des pieds pour cheminer avec les hommes par une sainte et amiable conversation:
leurs viſages ſont beaux & gays, dautant qu’ils reçoiuent toutes choſes auec douceur & ſuauité:	leurs visages sont beaux et gais, d’autant qu’ils reçoivent toutes choses avec douceur et suavité:
le reſte de leurs corps eſt couuert, mais d’vne belle & legere robbe, par ce qu’ils vſent voirement de ce monde & des choſes mondaines:	le reste de leurs corps est couvert, mais d’une belle et légère robe, par ce qu’ils usent voirement de ce monde et des choses mondaines:
mais d’vne façon toute pure & ſincere, n’en prenant que legerement ce qui eſt requis pour leur condition, telles ſont les perſonnes deuotes.	mais d’une façon toute pure et sincère, n’en prenant que légèrement ce qui est requis pour leur condition, telles sont les personnes dévotes.
Si la charité eſt vn laict, la deuotion en eſt la creſme;	Si la charité est un lait, la dévotion en est la crème;
ſi elle eſt vne plante, la deuotion en eſt la fleur;	si elle est une plante, la dévotion en est la fleur;
ſi elle eſt vne pierre precieuſe, la deuotion en eſt l’eſclat:	si elle est une pierre précieuse, la dévotion en est l’éclat:
ſi elle eſt vne bauſme precieux, la deuotion en eſt l’odeur, & l’odeur de ſuauité, qui conforte les hommes, & reſiouït les Anges.	si elle est une baume précieux, la dévotion en est l’odeur, et l’odeur de suavité, qui conforte les hommes, et réjouit les Anges.
Que la deuotion eſt conuenable à toutes ſortes de vacations & profeſſions.	Que la dévotion est convenable à toutes sortes de vacations et professions.
CHAPITRE III.	CHAPITRE III.
La deuotion doit eſtre differemment exercée par le Gentil-homme, par l’artiſan, par le valet, par le Prince, par la vefue, par la fille, par la mariée, & non ſeulement cela:	La dévotion doit être différemment exercée par le Gentilhomme, par l’artisan, par le valet, par le Prince, par la veuve, par la fille, par la mariée, et non seulement cela:
mais il faut accommoder la pratique de la deuotion aux forces, aux affaires, & aux deuoirs de chaque particulier.	mais il faut accommoder la pratique de la dévotion aux forces, aux affaires, et aux devoirs de chaque particulier.
cette deuotion ne ſeroit-elle pas ridicule, déreglée & inſupportable? Cette faute neantmoins arriue bien ſouuent, & le monde qui ne diſcerne pas, ou ne veut pas diſcerner entre la deuotion & l’indiſcretion de ceux qui penſent eſtre deuots, murmure & blaſme la deuotion, laquelle ne peut mais de ces deſordres.	cette dévotion ne serait-elle pas ridicule, déréglée et insupportable? Cette faute néanmoins arrive bien souvent, et le monde qui ne discerne pas, ou ne veut pas discerner entre la dévotion et l’indiscrétion de ceux qui pensent être dévots, murmure et blâme la dévotion, laquelle ne peut mais de ces désordres.
Non Philothée, la deuotion ne gaſte rien quand elle eſt vraye, ains elle perfectionne tout: & lors qu’elle ſe rend contraire à la legitime vocation de quelqu’vn, elle eſt ſans doute fauſſe.	Non Philothée, la dévotion ne gâte rien quand elle est vraie, ains elle perfectionne tout: et lorsqu’elle se rend contraire à la légitime vocation de quelqu’un, elle est sans doute fausse.
L’abeille, dit Ariſtote, tire ſon miel des fleurs, ſans les intereſſer, les laiſſant entieres & fraiſches, comme elle les a trouuées;	L’abeille, dit Aristote, tire son miel des fleurs, sans les intéresser, les laissant entières et fraîches, comme elle les a trouvées;
mais la vraye deuotion fait encore mieux:	mais la vraie dévotion fait encore mieux:
car non ſeulement elle ne gaſte nulle ſorte de vocation ny d’affaires, ains au contraire elle les orne & embellit.	car non seulement elle ne gâte nulle sorte de vocation ni d’affaires, ains au contraire elle les orne et embellit.
Toutes ſortes de pierreries iettées dedans le miel, en deuiennent plus eſclattantes, chacune ſelon ſa couleur;	Toutes sortes de pierreries jetées dedans le miel, en deviennent plus éclatantes, chacune selon sa couleur;
le ſoin de la famille en eſt rendu paiſible, l’amour du mary & de la femme plus ſincere, le ſeruice du Prince plus fidele, & toutes ſortes d’occupations plus ſuaues & amiables.	le soin de la famille en est rendu paisible, l’amour du mari et de la femme plus sincère, le service du Prince plus fidèle, et toutes sortes d’occupations plus suaves et amiables.
C’eſt vn erreur, ains vne hereſie, de vouloir bannir la vie deuote de la compagnie des ſoldats, de la boutique des artiſans, de la cour des Princes, du meſnage des gens mariez.	C’est un erreur, ains une hérésie, de vouloir bannir la vie dévote de la compagnie des soldats, de la boutique des artisans, de la cour des Princes, du ménage des gens mariés.
mais auſſi outre ces trois ſortes de deuotion, il y en a pluſieurs autres propres à perfectionner ceux qui viuent és eſtats ſeculiers.	mais aussi outre ces trois sortes de dévotion, il y en a plusieurs autres propres à perfectionner ceux qui vivent ès états séculiers.
Abraham, Iſaac, & Iacob, Dauid, Iob, Tobie, Sara, Rebecca, & Iudith en font foy par l’ancien Teſtament:	Abraham, Isaac, et Jacob, David, Job, Tobie, Sara, Rebecca, et Judith en font foi par l’ancien Testament:
& quant au nouueau, ſainct Ioſeph, Lydia, & ſainct Creſpin furent parfaitement deuots en leurs boutiques:	et quant au nouveau, saint Joseph, Lydia, et saint Crépin furent parfaitement dévots en leurs boutiques:
ſaincte Anne, ſaincte Marthe, ſaincte Monique, Aquila, Priſcilla en leurs ménages;	sainte Anne, sainte Marthe, sainte Monique, Aquila, Priscilla en leurs ménages;
Cornelius, ſainct Sebaſtien, ſainct Maurice parmy les armes:	Cornélius, saint Sébastien, saint Maurice parmi les armes:
Conſtantin, Helene, ſainct Louys, le B. Amé, ſainct Edoüard, en leurs ſaincts thrones.	Constantin, Hélène, saint Louis, le B. Amé, saint Édouard, en leurs saints trônes.
Loth, dit ſainct Gregoire, qui fut ſi chaſte en la ville, ſe ſoüilla en la ſolitude:	Loth, dit saint Grégoire, qui fut si chaste en la ville, se souilla en la solitude:
où que nous ſoyons, nous pouuons & deuons aſpirer à la vie parfaite.	où que nous soyons, nous pouvons et devons aspirer à la vie parfaite.
CHAPITRE IV.	CHAPITRE IV.
LE ieune Tobie commandé d’aller en Ragés;	LE jeune Tobie commandé d’aller en Ragès;
ie ne ſçay nullement le chemin, dit il: va donc, replique le pere, & cherche quelque homme qui te conduiſe.	je ne sais nullement le chemin, dit-il: va donc, réplique le père, et cherche quelque homme qui te conduise.
Ie vous en dis de meſme, ma Philothée, voulez vous à bon eſcient vous acheminer à la deuotion? cherchez quelque homme de bien qui vous guide & conduiſe.	Je vous en dis de même, ma Philothée, voulez-vous à bon escient vous acheminer à la dévotion? cherchez quelque homme de bien qui vous guide et conduise.
C’eſt icy l’aduertiſſement des aduertiſſemens, quoy que vous cherchiez, dit le deuot Auila, vous ne trouuerez iamais ſi aſſeurément la volonté de Dieu, que par le chemin de cette humble obeïſſance tant recommandée, & pratiquée par tous les anciens deuots.	C’est ici l’avertissement des avertissements, quoi que vous cherchiez, dit le dévot Avila, vous ne trouverez jamais si assurément la volonté de Dieu, que par le chemin de cette humble obéissance tant recommandée, et pratiquée par tous les anciens dévots.
La bien-heureuſe mere Thereſe, voyant que madame Catherine de Cordoüe faiſoit de grandes penitences, deſira fort de l’imiter en cela, contre l’aduis de ſon Confeſſeur, qui le luy defendoit, auquel elle eſtoit tentée de ne point obeïr pour ce regard.	La bienheureuse mère Thérèse, voyant que madame Catherine de Cordoue faisait de grandes pénitences, désira fort de l’imiter en cela, contre l’avis de son Confesseur, qui le lui défendait, auquel elle était tentée de ne point obéir pour ce regard.
ma fille, tu tiens vn bon & aſſeuré chemin, vois tu la penitence qu’elle fait? mais moy ie fais plus de cas de ton obeïſſance:	ma fille, tu tiens un bon et assuré chemin, vois tu la pénitence qu’elle fait? mais moi je fais plus de cas de ton obéissance:
auſſi elle aimoit tant cette vertu, qu’outre l’obeïſſance quelle deuoit à ſes Superieurs elle en voüa vne toute particuliere à vn excellent homme s’obligeant de ſuiure ſa direction & conduite, dont elle fut infiniment conſolée;	aussi elle aimait tant cette vertu, qu’outre l’obéissance quelle devait à ses Supérieurs elle en voua une toute particulière à un excellent homme s’obligeant de suivre sa direction et conduite, dont elle fut infiniment consolée;
ce que ſaincte Catherine de Sienne loüe infiniment en ſes dialogues.	ce que sainte Catherine de Sienne loue infiniment en ses dialogues.
La deuote Princeſſe ſaincte Elizabeth ſe ſouſmit auec vne extréme obeïſſance au Docteur M. Conrad.	La dévote Princesse sainte Élisabeth se soumit avec une extrême obéissance au Docteur M. Conrad.
Et voicy l’vn des aduis que le grand ſainct Louys fit à ſon fils auant que mourir:	Et voici l’un des avis que le grand saint Louis fit à son fils avant que mourir:
Confeſſe toy ſouuent, élis vn Confeſſeur idoine, qui ſoit preud’homme, & qui te puiſſe ſeurement enſeigner à faire les choſes qui te ſont neceſſaires.	Confesse-toi souvent, élis un Confesseur idoine, qui soit prud’homme, et qui te puisse sûrement enseigner à faire les choses qui te sont nécessaires.
L’amy fidelle, dit l’Eſcriture ſaincte, eſt vne forte protection:	L’ami fidèle, dit l’Écriture sainte, est une forte protection:
celuy qui l’a trouué, a trouué vn threſor.	celui qui l’a trouvé, a trouvé un trésor.
ceux qui craignent Dieu le treuuent.	ceux qui craignent Dieu le trouvent.
Ces diuines paroles regardent principalement l’immortalité, comme vous voyez, pour laquelle il faut ſur toutes choſes auoir cét amy fidelle, qui garde nos actions par ſes aduis & conſeils, & par ce moyen nous garentir des embuſches & tromperies du malin:	Ces divines paroles regardent principalement l’immortalité, comme vous voyez, pour laquelle il faut sur toutes choses avoir cet ami fidèle, qui garde nos actions par ses avis et conseils, et par ce moyen nous garantir des embûches et tromperies du malin:
il nous ſeruira de medicament, pour alleger & conſoler nos cœurs és maladies ſpirituelles:	il nous servira de médicament, pour alléger et consoler nos cœurs ès maladies spirituelles:
il nous gardera du mal, & rendra noſtre bien meilleur, & quand il nous arriuera quelque infirmité, il empeſchera qu’elle ne ſoit pas à la mort, car il nous en releuera.	il nous gardera du mal, et rendra notre bien meilleur, et quand il nous arrivera quelque infirmité, il empêchera qu’elle ne soit pas à la mort, car il nous en relèvera.
Mais qui trouuera cet amy? le Sage reſpond, ceux qui craignent Dieu, c’eſt à dire les humbles, qui deſirent fort leur aduancement ſpirituel.	Mais qui trouvera cet ami? le Sage répond, ceux qui craignent Dieu, c’est-à-dire les humbles, qui désirent fort leur avancement spirituel.
Puis qu’il vous importe tant, Philothée, d’aller auec vne bonne guide en ce ſainct voyage de deuotion, priez Dieu auec vne grande inſtance, qu’il vous en fourniſſe d’vne qui ſoit ſelon ſon cœur:	Puisqu’il vous importe tant, Philothée, d’aller avec une bonne guide en ce saint voyage de dévotion, priez Dieu avec une grande instance, qu’il vous en fournisse d’une qui soit selon son cœur:
& ne doutez point, car quand il deuroit enuoyer vn Ange du ciel, comme il fit au ieune Tobie, il vous en donnera vne bonne & fidele.	et ne doutez point, car quand il devrait envoyer un Ange du ciel, comme il fit au jeune Tobie, il vous en donnera une bonne et fidèle.
Or ce doit touſiours eſtre vn Ange pour vous, c’eſt à dire, quand vous l’aurez trouuée, ne la conſiderez pas comme vn ſimple homme, & ne vous confiez point en icelle, ny en ſon ſçauoir humain, mais en Dieu, lequel vous fauoriſera, & parlera par l'entremiſe de cet homme, mettant dedans le cœur & dedans la bouche d’iceluy, ce qui ſera requis pour voſtre bon-heur:	Or ce doit toujours être un Ange pour vous, c’est-à-dire, quand vous l’aurez trouvée, ne la considérez pas comme un simple homme, et ne vous confiez point en icelle, ni en son savoir humain, mais en Dieu, lequel vous favorisera, et parlera par l’entremise de cet homme, mettant dedans le cœur et dedans la bouche d’icelui, ce qui sera requis pour votre bonheur:
Traitez auec luy à cœur ouuert, en toute ſincerité & fidelité, luy manifeſtant clairement voſtre bien & voſtre mal, ſans feintiſe, ny diſſimulation:	Traitez avec lui à cœur ouvert, en toute sincérité et fidélité, lui manifestant clairement votre bien et votre mal, sans feintise, ni dissimulation:
& par ce moyen voſtre bien ſera examiné & plus aſſeuré, & voſtre mal ſera corrigé & remedié;	et par ce moyen votre bien sera examiné et plus assuré, et votre mal sera corrigé et remédié;
ayez en luy vne extreme confiance meſlée d’vne ſacrée reuerence, en ſorte que la reuerence ne diminuë point la confiance, & que la confiance n’empeſche point la reuerence:	ayez en lui une extrême confiance mêlée d’une sacrée révérence, en sorte que la révérence ne diminue point la confiance, et que la confiance n’empêche point la révérence:
confiez vous en luy auec le reſpect d’vne fille enuers ſon pere, reſpectez-le auec la confiance d’vn fils enuers ſa mere:	confiez-vous en lui avec le respect d’une fille envers son père, respectez-le avec la confiance d’un fils envers sa mère:
Bref cette amitié doit eſtre forte & douce, toute ſaincte, toute ſacrée, toute diuine, & toute ſpirituelle.	Bref cette amitié doit être forte et douce, toute sainte, toute sacrée, toute divine, et toute spirituelle.
Et pour cela choiſiſſez-en vn entre mille, dit Auila;	Et pour cela choisissez-en un entre mille, dit Avila;
& moy ie dis entre dix mille:	et moi je dis entre dix mille:
car il s’en trouue moins que l’on ne ſçauroit dire, qui ſoient capables de cet office:	car il s’en trouve moins que l’on ne saurait dire, qui soient capables de cet office:
ſi l’vne de ces trois parties luy manque, il y a du danger:	si l’une de ces trois parties lui manque, il y a du danger:
mais ie vous dis derechef, demandez-le à Dieu, & l’ayant obtenu beniſſez ſa diuine Maieſté, demeurez ferme, & n’en cherchez point d’autres, ains allez ſimplement humblement, & confidemment:	mais je vous dis derechef, demandez-le à Dieu, et l’ayant obtenu bénissez sa divine Majesté, demeurez ferme, et n’en cherchez point d’autres, ains allez simplement humblement, et confidemment:
Qu'il faut commencer par la purgation de l'ame.	Qu’il faut commencer par la purgation de l’âme.
CHAPITRE V.	CHAPITRE V.
LES fleurs, dit l’Eſpoux ſacré, apparoiſſent en noſtre terre;	LES fleurs, dit l’Époux sacré, apparaissent en notre terre;
le temps d’émonder & tailler eſt venu.	le temps d’émonder et tailler est venu.
Qui ſont les fleurs de nos cœurs, ô Philothée, ſinon les bons deſirs? Or auſſi toſt qu’ils paroiſſent, il faut mettre la main à la ſerpe pour retrancher de noſtre conſcience toutes les œuures mortes & ſuperfluës:	Qui sont les fleurs de nos cœurs, ô Philothée, sinon les bons désirs? Or aussitôt qu’ils paraissent, il faut mettre la main à la serpe pour retrancher de notre conscience toutes les œuvres mortes et superflues:
la fille eſtrangere pour eſpouſer l’Iſraëlite, deuoit oſter la robbe de ſa captiuité, roigner ſes ongles, & raſer ſes cheueux:	la fille étrangère pour épouser l’Israélite, devait ôter la robe de sa captivité, rogner ses ongles, et raser ses cheveux:
puis roigner & raſer toutes ſortes d’empeſchemens, qui la détournent de l’amour de Dieu: c’eſt le commencement de noſtre ſanté, que d'eſtre purgé de nos humeurs peccantes.	puis rogner et raser toutes sortes d’empêchements, qui la détournent de l’amour de Dieu: c’est le commencement de notre santé, que d’être purgé de nos humeurs peccantes.
Sainct Paul tout en vn moment fut purgé d’vne purgation parfaicte, comme fut auſſi ſaincte Catherine de Gennes, ſaincte Magdelaine, ſainct Pelagie, & quelques autres:	Saint Paul tout en un moment fut purgé d’une purgation parfaite, comme fut aussi sainte Catherine de Gennes, sainte Madeleine, saint Pélagie, et quelques autres:
La purgation & gueriſon ordinaire, ſoit des corps, ſoit des eſprits, ne ſe fait que petit à petit, par progrez d’auancement en auancement, auec peine & loiſir.	La purgation et guérison ordinaire, soit des corps, soit des esprits, ne se fait que petit à petit, par progrès d’avancement en avancement, avec peine et loisir.
Les Anges ont des aiſles ſur l’eſchelle de Iacob:	Les Anges ont des ailes sur l’échelle de Jacob:
mais ils ne volent pas;	mais ils ne volent pas;
ains montent & deſcendent par ordre, d’eſchellon en eſchellon.	ains montent et descendent par ordre, d’échelon en échelon.
L’ame qui remonte du peché à la deuotion eſt comparée à l’Aube, laquelle s’eſleuant ne chaſſe pas les tenebres en vn inſtant, mais petit à petit:	L’âme qui remonte du péché à la dévotion est comparée à l’Aube, laquelle s’élevant ne chasse pas les ténèbres en un instant, mais petit à petit:
la gueriſon (dit l’Aphoriſme) qui ſe fait tout bellement, eſt touſiours plus aſſeurée;	la guérison (dit l’Aphorisme) qui se fait tout bellement, est toujours plus assurée;
mais elles s’en reuont à pied & au petit pas.	mais elles s’en revont à pied et au petit pas.
Il faut donc eſtre courageuſe & patiente, ô Philothée, en ceſte entrepriſe.	Il faut donc être courageuse et patiente, ô Philothée, en cette entreprise.
Leuez vous apres que vous aurez eſté aſſis:	Levez-vous après que vous aurez été assis:
& luy meſme pratiquant ceſte leçon & ayant eſté deſia laué & nettoié, demande de l’eſtre derechef.	et lui même pratiquant cette leçon et ayant été déjà lavé et nettoyé, demande de l’être derechef.
L’exercice de la purgation de l'ame ne ſe peut, ny doit finir qu’auec noſtre vie:	L’exercice de la purgation de l’âme ne se peut, ni doit finir qu’avec notre vie:
ne nous troublons donc point de nos imperfections, car noſtre perfection conſiſte à les combatre:	ne nous troublons donc point de nos imperfections, car notre perfection consiste à les combattre:
& nous ne ſçaurions les combatre ſans les voir, ny les vaincre ſans les rencontrer:	et nous ne saurions les combattre sans les voir, ni les vaincre sans les rencontrer:
noſtre victoire ne giſt pas à ne les ſentir point, mais à ne point leur conſentir.	notre victoire ne gît pas à ne les sentir point, mais à ne point leur consentir.
neantmoins nous ne ſommes iamais vaincus, ſinon lors que nous auons perdu ou la vie ou le courage.	néanmoins nous ne sommes jamais vaincus, sinon lorsque nous avons perdu ou la vie ou le courage.
Or les imperfections & pechez veniels ne nous ſçauroient oſter la vie ſpirituelle, car elle ne ſe perd que par le peché mortel.	Or les imperfections et péchés véniels ne nous sauraient ôter la vie spirituelle, car elle ne se perd que par le péché mortel.
Deliure moy Seigneur, diſoit Dauid, de la coüardiſe & découragement:	Délivre moi Seigneur, disait David, de la couardise et découragement:
c’eſt vne heureuſe condition pour nous en cette guerre, que nous ſoyons touſiours vainqueurs, pourueu que nous voulions combattre.	c’est une heureuse condition pour nous en cette guerre, que nous soyons toujours vainqueurs, pourvu que nous voulions combattre.
De la premiere purgation, qui eſt celle des pechez mortels.	De la première purgation, qui est celle des péchés mortels.
CHAPITRE VI.	CHAPITRE VI.
LA premiere purgation qu’il faut faire, c’eſt celle du peché;	LA première purgation qu’il faut faire, c’est celle du péché;
le moyen de la faire, c'eſt le S. Sacrement de penitence:	le moyen de la faire, c’est le S. Sacrement de pénitence:
liſez les bien, & remarquez de poinct en poinct en quoy vous auez offencé, à prendre depuis que vous euſtes l’vſage de raiſon iuſques à l’heure preſente.	lisez-les bien, et remarquez de point en point en quoi vous avez offensé, à prendre depuis que vous eûtes l’usage de raison jusqu’à l’heure présente.
Et ſi vous vous défiez de voſtre memoire, mettez en eſcrit ce que vous aurez remarqué:	Et si vous vous défiez de votre mémoire, mettez en écrit ce que vous aurez remarqué:
que par le peché vous auez perdu la grace de Dieu, quitté voſtre part de Paradis, accepté les peines eternelles de l’Enfer, & renoncé à l’amour eternel, de Dieu.	que par le péché vous avez perdu la grâce de Dieu, quitté votre part de Paradis, accepté les peines éternelles de l’Enfer, et renoncé à l’amour éternel, de Dieu.
Vous voyez bien, Philothée, que ie parle d’vne confeſſion generale de toute la vie, laquelle certes ie confeſſe bien n’eſtre pas touſiours abſoluëment neceſſaire, mais ie conſidere bien auſſi qu’elle vous ſera extrémement vtile en ce commencement:	Vous voyez bien, Philothée, que je parle d’une confession générale de toute la vie, laquelle certes je confesse bien n’être pas toujours absolument nécessaire, mais je considère bien aussi qu’elle vous sera extrêmement utile en ce commencement:
c’eſt pourquoy ie vous la conſeille extrémement.	c’est pourquoi je vous la conseille extrêmement.
Il arriue ſouuent que les confeſſions ordinaires de ceux qui viuent d’vne vie commune & vulgaire, ſont pleines de grands defauts.	Il arrive souvent que les confessions ordinaires de ceux qui vivent d’une vie commune et vulgaire, sont pleines de grands défauts.
Car ſouuent on ne ſe prepare point, ou fort peu, on n’a point la contrition requiſe:	Car souvent on ne se prépare point, ou fort peu, on n’a point la contrition requise:
ains il aduient maintesfois que l’on ſe va confeſſer auec vne volonté tacite de retourner au peché, dautãt qu’on ne veut pas éuiter l’occaſion du peché, ny prendre les expediens neceſſaires à l’amẽdement de la vie:	ains il advient maintes fois que l’on se va confesser avec une volonté tacite de retourner au péché, d’autant qu’on ne veut pas éviter l’occasion du péché, ni prendre les expédients nécessaires à l’amendement de la vie:
Mais outre cela la confeſſion generale nous appelle à la cognoiſſance de nous meſme, nous prouoque à vne ſalutaire confuſion pour noſtre vie paſſée, nous fait admirer la miſericorde de Dieu, qui nous a attendu en patience, elle appaiſe nos cœurs, délaſſe nos eſprits, excite en nous des bons propos, donne ſubiect à noſtre pere ſpirituel de nous faire des aduis plus conuenables à noſtre condition, & nous ouure le cœur, pour auec confiance nous bien déclarer aux confeſſions ſuiuantes.	Mais outre cela la confession générale nous appelle à la connaissance de nous-même, nous provoque à une salutaire confusion pour notre vie passée, nous fait admirer la miséricorde de Dieu, qui nous a attendu en patience, elle apaise nos cœurs, délasse nos esprits, excite en nous des bons propos, donne sujet à notre père spirituel de nous faire des avis plus convenables à notre condition, et nous ouvre le cœur, pour avec confiance nous bien déclarer aux confessions suivantes.
Parlant doncques d’vn renouuellement general de noſtre cour, & d’vne conuerſion vniuerſelle de noſtre ame à Dieu, par l’entrepriſe de la vie deuote, i’ay bien raiſon, ce me ſemble, Philothée, de vous conſeiller cette confeſſion.	Parlant donc d’un renouvellement général de notre cour, et d’une conversion universelle de notre âme à Dieu, par l’entreprise de la vie dévote, j’ai bien raison, ce me semble, Philothée, de vous conseiller cette confession.
CHAPITRE VII.	CHAPITRE VII.
TOVS les Iſraëlites ſortirent en effect de la terre d’Egypte, mais ils n’en ſortirent pas tous d’affection:	TOUS les Israélites sortirent en effet de la terre d’Égypte, mais ils n’en sortirent pas tous d’affection:
c’eſt pourquoy emmy le deſert pluſieurs d’entr’eux regrettoient de n’auoir pas les oignons & les chairs d’Egypte.	c’est pourquoi emmi le désert plusieurs d’entre eux regrettaient de n’avoir pas les oignons et les chairs d’Égypte.
Ainſi il y a des penitens, qui ſortent en effect du	Ainsi il y a des pénitents, qui sortent en effet du
