SONNET.	SONNET.
I.	I.
Comment se soustient-elle encor si fermement ?	Comment se soutient-elle encor si fermement?
Et si c’est sur les vents qu’elle a son fondement	Et si c’est sur les vents qu’elle a son fondement
Ces justes contrepoids qui nous l’ont balancee	Ces justes contrepoids qui nous l’ont balancée
Ne panchent-ils jamais d’un divers branslement ?	Ne penchent-ils jamais d’un divers branlement?
Et qui nous fait solide ainsi cet Element,	Et qui nous fait solide ainsi cet Élément,
Qui trouve autour de luy l’inconstance amassee ?	Qui trouve autour de lui l’inconstance amassée?
Il est ainsi, ce corps se va tout souslevant	Il est ainsi, ce corps se va tout soulevant
Sans jamais s’esbranler parmi l’onde et le vent,	Sans jamais s’ébranler parmi l’onde et le vent,
Voyant ces maux coulans, soufflans de tous costez	Voyant ces maux coulants, soufflants de tous côtés
Ne trouvoit tous les jours par exemple de mesme	Ne trouvait tous les jours par exemple de même
II.	II.
Quand je voy les efforts de ce Grand Alexandre,	Quand je vois les efforts de ce Grand Alexandre,
D’un Cesar dont le sein comblé de passions	D’un César dont le sein comblé de passions
Embraze tout de feu de ces ambitions,	Embrase tout de feu de ces ambitions,
Et n’en laisse apres soy memoire qu’en la cendre.	Et n’en laisse après soi mémoire qu’en la cendre.
Quand je voy que leur gloire est seulement de rendre,	Quand je vois que leur gloire est seulement de rendre,
Calmes dessous leurs loix toutes les nations	Calmes dessous leurs lois toutes les nations
Qui voyent le Soleil et monter et descendre :	Qui voient le Soleil et monter et descendre:
Que mes lauriers ne soyent de leurs lauriers honteux,	Que mes lauriers ne soient de leurs lauriers honteux,
Je les condamne tous & ne les puis deffendre :	Je les condamne tous et ne les puis défendre:
Ma belle c’est vers toy que tournent mes espris,	Ma belle c’est vers toi que tournent mes esprits,
Ces tirans-la faisoyent leur triomphe de prendre,	Ces tyrans-là faisaient leur triomphe de prendre,
Et je triompheroy de ce que tu m’as pris.	Et je triompherai de ce que tu m’as pris.
III.	III.
Sur le large pourpris de ce sec element,	Sur le large pourpris de ce sec élément,
Il ne croiroit de tout, rien qu’un poinct seulement	Il ne croirait de tout, rien qu’un point seulement
Mais s’il contemple apres ceste courtine bluë,	Mais s’il contemple après cette courtine bleue,
Ce cercle de cristal, ce doré firmament,	Ce cercle de cristal, ce doré firmament,
Il juge que son tour est grand infiniment,	Il juge que son tour est grand infiniment,
Et que ceste grandeur nous est toute incognuë.	Et que cette grandeur nous est toute inconnue.
Ainsi de ce grand ciel, où l’amour m’a guidé	Ainsi de ce grand ciel, où l’amour m’a guidé
De ce grand ciel d’Amour où mon œil est bandé	De ce grand ciel d’Amour où mon œil est bandé
Au reste des amours, je vois sous une nuict	Au reste des amours, je vois sous une nuit
Du monde d’Epicure en atomes reduit,	Du monde d’Épicure en atomes réduit,
IIII.	IIII.
En vain mille beautez à mes yeux se presentent,	En vain mille beautés à mes yeux se présentent,
Mes yeux leur sont ouvers et mon courage clos,	Mes yeux leur sont ouverts et mon courage clos,
Une seule beauté s’enflamme dans mes os	Une seule beauté s’enflamme dans mes os
Et mes os de ce feu seulement se contentent :	Et mes os de ce feu seulement se contentent:
Les vigueurs de ma vie et du temps qui m’absentent	Les vigueurs de ma vie et du temps qui m’absentent
Alterent moins mon ame, encor que mon propos	Altèrent moins mon âme, encor que mon propos
Et mes discrets desirs jamais ne se repentent.	Et mes discrets désirs jamais ne se repentent.
Tous ces esprits flotans, qui souillent aisement	Tous ces esprits flottants, qui souillent aisément
Des absentes amours la chaste souvenance :	Des absentes amours la chaste souvenance:
Mais pour tous vos efforts je demeure indompté :	Mais pour tous vos efforts je demeure indompté:
Ainsi je veux servir d’un patron de constance,	Ainsi je veux servir d’un patron de constance,
Comme ma belle fleur d’un patron de beauté.	Comme ma belle fleur d’un patron de beauté.
V.	V.
Que me donne l’absence, et les jours, et les nuicts	Que me donne l’absence, et les jours, et les nuits
Font tant, qu’à tous momens je ne sçay que je suis	Font tant, qu’à tous moments je ne sais que je suis
Un chagrin survenant mille chagrins m’attire	Un chagrin survenant mille chagrins m’attire
Et me cuidant aider moy-mesme je me nuis,	Et me cuidant aider moi-même je me nuis,
L’infini mouvement de mes roulans ennuis	L’infini mouvement de mes roulants ennuis
M’emporte & je le sens, mais je ne le puis dire.	M’emporte et je le sens, mais je ne le puis dire.
Je suis cet Acteon de ces chiens deschiré !	Je suis cet Actéon de ces chiens déchiré!
Et l’esclat de mon ame est si bien alteré	Et l’éclat de mon âme est si bien altéré
Deux Desses nous ont tramé tout nostre sort	Deux Déesses nous ont tramé tout notre sort
Mais pour divers sujets nous trouvons mesme mort	Mais pour divers sujets nous trouvons même mort
VI.	VI.
Mon Dieu, que je voudrois que ma main fust oisive,	Mon Dieu, que je voudrais que ma main fût oisive,
Que ma bouche et mes yeux reprissent leur devoir	Que ma bouche et mes yeux reprissent leur devoir
Escrire est peu : c’est plus de parler & de voir	Écrire est peu: c’est plus de parler et de voir
De ces deux œuvres l’une est morte & l’autre vive.	De ces deux œuvres l’une est morte et l’autre vive.
Quelque beau trait d’amour que nostre main escrive,	Quelque beau trait d’amour que notre main écrive,
Ni le semblable poix, que l’œil pourroit avoir	Ni le semblable poix, que l’œil pourrait avoir
Et de nos vives voix la vertu plus naïve.	Et de nos vives voix la vertu plus naïve.
Et ces fruits mi rongez dont nous le nourrissons	Et ces fruits mi rongés dont nous le nourrissons
L’Amour mourroit de faim et cherroit en ruine :	L’Amour mourrait de faim et cherrait en ruine:
Escrivons attendant de plus fermes plaisirs,	Écrivons attendant de plus fermes plaisirs,
Et si le temps domine encor sur nos desirs,	Et si le temps domine encor sur nos désirs,
Faisons que sur le temps la constance domine.	Faisons que sur le temps la constance domine.
VII.	VII.
Des plumages si beaux sur mon corps attachez,	Des plumages si beaux sur mon corps attachés,
On auroit beau tenir mes esprits empeschez	On aurait beau tenir mes esprits empêchés
Sur les aisles du vent je guiderois mes aisles	Sur les ailes du vent je guiderais mes ailes
J’irois jusqu’au sejour où mes biens sont cachez,	J’irais jusqu’au séjour où mes biens sont cachés,
Ainsi voyant de moy ces ennuis arrachez	Ainsi voyant de moi ces ennuis arrachés
Je ne sentirois plus ces absences cruelles,	Je ne sentirais plus ces absences cruelles,
Colombelles helas ! que j’ay bien souhaité	Colombelles hélas! que j’ai bien souhaité
Que mon corps vous semblast autant d’agilité	Que mon corps vous semblât autant d’agilité
Mais quoy, je le souhaite, & me trompe d’autant,	Mais quoi, je le souhaite, et me trompe d’autant,
Ferois-je bien voller un amour si constant	Ferais-je bien voler un amour si constant
VIII.	VIII.
Ce tresor que j’ay pris avecques tant de peine	Ce trésor que j’ai pris avecques tant de peine
Je le veux avec peine encore conserver,	Je le veux avec peine encore conserver,
Tardif a reposer, prompt a me relever,	Tardif a reposer, prompt a me relever,
Et tant veiller qu’en fin on ne me le suprenne.	Et tant veiller qu’en fin on ne me le surprenne.
Encor que des mes yeux la garde plus certaine	Encor que des mes yeux la garde plus certaine
Et qu’il me peut encor en l’absence arriver	Et qu’il me peut encor en l’absence arriver
Qu’un autre plus prochain me l’empoigne & l’emmaine.	Qu’un autre plus prochain me l’empoigne et l’emmène.
La seule foy m’asseure & m’oste le soucy :	La seule foi m’assure et m’ôte le souci:
Et ne changera point pourveu que je ne change.	Et ne changera point pourvu que je ne change.
Il faut tenir bon œil & bon pied sur ce point,	Il faut tenir bon œil et bon pied sur ce point,
A gaigner un beau bien on gaigne une loüange,	A gagner un beau bien on gagne une louange,
Mais on en gaigne mille à ne le perdre point.	Mais on en gagne mille à ne le perdre point.
IX.	IX.
Que vous croyez au moins que je vous suis fidelle,	Que vous croyez au moins que je vous suis fidèle,
Ou si vous le croyez, qu’à la moindre querelle	Ou si vous le croyez, qu’à la moindre querelle
Belle, pour qui je meurs, belle, pensez vous bien	Belle, pour qui je meurs, belle, pensez-vous bien
Que je ne sente point cette injure cruelle ?	Que je ne sente point cette injure cruelle?
Plus sanglante beaucoup, que la peine éternelle	Plus sanglante beaucoup, que la peine éternelle
Où malgré tout le monde encor je me retiens,	Où malgré tout le monde encor je me retiens,
Il est vray toutesfois, vos beautez infinies,	Il est vrai toutefois, vos beautés infinies,
Quand je vivrois encor cent mille & mille vies,	Quand je vivrais encor cent mille et mille vies,
Que je ne fusse en reste à leur valeur parfaicte :	Que je ne fusse en reste à leur valeur parfaite:
Mais croyez-le ou non, la preuve est toute faicte	Mais croyez-le ou non, la preuve est toute faite
X.	X.
Je ne bouge non plus qu’un escueil dedans l’onde	Je ne bouge non plus qu’un écueil dedans l’onde
Qui fait fort à l'orage, & le fait reculer,	Qui fait fort à l’orage, et le fait reculer,
Il me trouve affermi, qui cherche à m'esbranler,	Il me trouve affermi, qui cherche à m’ébranler,
Deusse-je voir bransler contre moy tout le monde.	Dussé-je voir branler contre moi tout le monde.
Chacun qui voit combien tous les jours je me fonde	Chacun qui voit combien tous les jours je me fonde
Trouble la terre & l'air afin de me troubler	Trouble la terre et l’air afin de me troubler
Et ne pouvant rien plus, pour le moins il en gronde.	Et ne pouvant rien plus, pour le moins il en gronde.
Ce propos enchanteur qui tend a mabuser	Ce propos enchanteur qui tend a m’abuser
Et me ravir le bien que leur rage m'envie.	Et me ravir le bien que leur rage m’envie.
Laissons laissons le dire un seul mot me suffit	Laissons laissons le dire un seul mot me suffit
Qu'en la guerre d'amour une ame bien nourrie	Qu’en la guerre d’amour une âme bien nourrie
Emporte tout l'honneur emportant le profit.	Emporte tout l’honneur emportant le profit.
XI	XI
Que de l'ardant amour dont j'estois embrazé :	Que de l’ardent amour dont j’étais embrasé:
Mais depuis que vostre œil sur moy s'est appaisé	Mais depuis que votre œil sur moi s’est apaisé
L'amour mesme de qui j'espreuve l'assistance	L’amour même de qui j’épreuve l’assistance
Qui sçait combien l'esprit de l'homme est fort aisé	Qui sait combien l’esprit de l’homme est fort aisé
D'aller aux changemens, se tient comme abusé	D’aller aux changements, se tient comme abusé
Voyant qu'en vous aimans j'aime sans repentance.	Voyant qu’en vous aimant j’aime sans repentance.
Il s'en remonstre assez qui bruslent vivement,	Il s’en remontre assez qui brûlent vivement,
Mais la fin de leur feu qui se va consommant	Mais la fin de leur feu qui se va consommant
Je laisse ces amans croupir en leurs humeurs	Je laisse ces amants croupir en leurs humeurs
Et me tiens pour contens, s'il vous plaist de comprendre	Et me tiens pour contents, s’il vous plaît de comprendre
XII.	XII.
Mon cœur ne te rends point à ces ennuis d'absence,	Mon cœur ne te rends point à ces ennuis d’absence,
Et quelques forts qu'ils soyent sois encore plus fort	Et quelques forts qu’ils soient sois encore plus fort
Quand mesme tu serois sur le poinct de la mort	Quand même tu serais sur le point de la mort
Mon coeur ne te rends point, & reprens ta puissance.	Mon coeur ne te rends point, et reprends ta puissance.
Que si tant de combats te donnent cognoissance	Que si tant de combats te donnent connaissance
Garde toy de tomber en un tel desconfort	Garde toi de tomber en un tel déconfort
Que ton amour jamais y perde son essence.	Que ton amour jamais y perde son essence.
Laisse laisse courir ces torrens desbordez,	Laisse laisse courir ces torrents débordés,
Et monte sur les rocs de ce mont de constance :	Et monte sur les rocs de ce mont de constance:
Ainsi dessus les monts de ce sage chef Romain	Ainsi dessus les monts de ce sage chef Romain
Differa ses combats du jour au lendemain,	Différa ses combats du jour au lendemain,
Se mocqua d'Hannibal, rompant sa violence.	Se moqua d’Hannibal, rompant sa violence.
XIII.	XIII.
Qu'on te donnast un poinct pour bien te soustenir	Qu’on te donnât un point pour bien te soutenir
Tu branlerois le monde, & le ferois venir,	Tu branlerais le monde, et le ferais venir,
Puis que ton arc si beau, ta main estoit si forte	Puis que ton arc si beau, ta main était si forte
Si tu pouvois encore au monde revenir	Si tu pouvais encore au monde revenir
Dans l'amour de mon cœur s'esforce à retenir	Dans l’amour de mon cœur s’efforce à retenir
Tu trouverois ton poinct peut estre en quelque sorte.	Tu trouverais ton point peut être en quelque sorte.
Pourroit-on voir jamais plus de solidité	Pourrait-on voir jamais plus de solidité
Qu'en ce qui bransle moins plus il est agité	Qu’en ce qui branle moins plus il est agité
Il est seur, Archimede, & je n'en doute point	Il est sûr, Archimède, et je n’en doute point
Pour bransler tout le monde & s'asseure d'un point	Pour branler tout le monde et s’assure d’un point
XIIII.	XIIII.
Quand le vaillant Hector, le grand rampart de Troye,	Quand le vaillant Hector, le grand rempart de Troie,
Sortir tout enflammé, sur les nefs des Gregeois,	Sortir tout enflammé, sur les nefs des Grégeois,
Et qu'Achille charmoit d'une plaintive voix	Et qu’Achille charmait d’une plaintive voix
Son oisive douleur, sa vengeance de joye.	Son oisive douleur, sa vengeance de joie.
Comme quand le Soleil dedans l'onde flamboye	Comme quand le Soleil dedans l’onde flamboie
La Grece tout ainsi flottante ceste fois	La Grèce tout ainsi flottante cette fois
Eust peur d'estre à la fin la proye de sa proye.	Eut peur d’être à la fin la proie de sa proie.
Soustint ceste fureur & dompta cet effort,	Soutint cette fureur et dompta cet effort,
J'eusse perdu de mesme en ceste horrible absence	J’eusse perdu de même en cette horrible absence
Mon amour, assailli d'une armee d'ennuis,	Mon amour, assailli d’une armée d’ennuis,
Dans le travail des jours, dans la langeur des nuicts	Dans le travail des jours, dans la langueur des nuits
Si je ne l'eusse armé d'un bouclier de constance.	Si je ne l’eusse armé d’un bouclier de constance.
XV.	XV.
Et la longue terreur de l'empire Romain,	Et la longue terreur de l’empire Romain,
Qui donna tant de peine à son cœur, à sa main,	Qui donna tant de peine à son cœur, à sa main,
Apres avoir dompté presque la terre & l'onde,	Après avoir dompté presque la terre et l’onde,
Et porté dans le ciel tout l'orgueil de son sein,	Et porté dans le ciel tout l’orgueil de son sein,
Esprouva mais trop tard, qu'un superbe dessein	Éprouva mais trop tard, qu’un superbe dessein
Fondé dessus le vent il faut en fin qu'il fonde	Fondé dessus le vent il faut en fin qu’il fonde
Ceste insolente là la pompe qu'elle aima	Cette insolente là la pompe qu’elle aima
Le brasier devorant du feu la consuma :	Le brasier dévorant du feu la consuma:
Ton feu dura vingt jours, & bruslas pour si peu,	Ton feu dura vingt jours, et brûlas pour si peu,
Helas que dirois-tu si tu voyais qu'un feu	Hélas que dirais-tu si tu voyais qu’un feu
XVI.	XVI.
Je prens exemple en toy, courageuse Numance,	Je prends exemple en toi, courageuse Numance,
L'un des grands fleaux de Rome, & comme toy je veux	L’un des grands fléaux de Rome, et comme toi je veux
Praticquant la valeur, apprendre à nos neveux	Pratiquant la valeur, apprendre à nos neveux
Qu'il faut vaincre en l'assaut, mourir en la deffence.	Qu’il faut vaincre en l’assaut, mourir en la défense.
Durant tes quatorze ans, l'insolente arrogance	Durant tes quatorze ans, l’insolente arrogance
Contre tant de vertu s'arrachoit les cheveux	Contre tant de vertu s’arrachait les cheveux
Et s'arrachoit plus fort encore l'esperance :	Et s’arrachait plus fort encore l’espérance:
Que te laisser toy-mesme à toy-mesme dompter,	Que te laisser toi-même à toi-même dompter,
Et toy tu ne laissas que tes murs & ta cendre :	Et toi tu ne laissas que tes murs et ta cendre:
Ainsi tous ces ennuis dont je vaincs les efforts	Ainsi tous ces ennuis dont je vaincs les efforts
S'ils se trouvent en fin plus rusez que plus forts,	S’ils se trouvent en fin plus rusés que plus forts,
J'aime mieux comme toy mourir que de me rendre.	J’aime mieux comme toi mourir que de me rendre.
XVII.	XVII.
D’un parti ma raison, mes sens d’autre parti,	D’un parti ma raison, mes sens d’autre parti,
Dont le bruslant discord ne peut estre amorti	Dont le brûlant discord ne peut être amorti
Mais mes sens sont armez d’un verre si fragile	Mais mes sens sont armés d’un verre si fragile
Que si le cœur bientost ne s’en est departi	Que si le cœur bientôt ne s’en est départi
Tout l’heur vers ma raison se verra converti,	Tout l’heur vers ma raison se verra converti,
Comme au party plus fort plus juste & plus utile.	Comme au parti plus fort plus juste et plus utile.
Mes sens veulent ployer sous ce pesant fardeau	Mes sens veulent ployer sous ce pesant fardeau
Des ardeurs que me donne un esloigné flambeau,	Des ardeurs que me donne un éloigné flambeau,
Faisons comme dans Rome, à ce peuple mutin	Faisons comme dans Rome, à ce peuple mutin
De mes sens inconstans arrachons-les en fin,	De mes sens inconstants arrachons-les en fin,
XVIII.	XVIII.
Ne vous estonnez point si mon esprit qui passe	Ne vous étonnez point si mon esprit qui passe
De travail en travail par tant de mouvemens,	De travail en travail par tant de mouvements,
Depuis qu’il est banni dans ces esloignemens,	Depuis qu’il est banni dans ces éloignements,
Tout agile qu’il est ne change point de place.	Tout agile qu’il est ne change point de place.
Ce que vous en voyez, quelque chose qu’il face,	Ce que vous en voyez, quelque chose qu’il face,
Qu’il ne voudrait jamais souffrir de changemens	Qu’il ne voudrait jamais souffrir de changements
Si ce n’est que le feu se peust changer de place.	Si ce n’est que le feu se pût changer de place.
Les foibles mouvemens, les dures fermetez :	Les faibles mouvements, les dures fermetés:
Mais voulez vous avoir plus claire cognoissance	Mais voulez-vous avoir plus claire connaissance
Que mon espoir se meurt & ne se change point ?	Que mon espoir se meurt et ne se change point?
Il tournoye à l’entour du poinct de la constance	Il tournoie à l’entour du point de la constance
Comme le ciel tournoye à l’entour de son poinct.	Comme le ciel tournoie à l’entour de son point.
XIX.	XIX.
Qui traine lentement les ondes dans la mer,	Qui traine lentement les ondes dans la mer,
Sans que les Aquilons le façent escumer	Sans que les Aquilons le fassent écumer
Et contemplant le cours de ces maux que j’espreuve	Et contemplant le cours de ces maux que j’éprouve
Ce fleuve dis-je alors ne sçait que c’est d’aimer,	Ce fleuve dis-je alors ne sait que c’est d’aimer,
Si quelque flamme eust peu ses glaces allumer	Si quelque flamme eût pu ses glaces allumer
Il trouveroit l’amour ainsi que je le treuve.	Il trouverait l’amour ainsi que je le trouve.
S’il le sentoit si bien, il auroit plus de flots,	S’il le sentait si bien, il aurait plus de flots,
L’Amour est de la peine & non point du repos,	L’Amour est de la peine et non point du repos,
Si son esprit constant la deffend du trespas,	Si son esprit constant la défend du trépas,
Mais qui meurt en la peine il ne merite pas	Mais qui meurt en la peine il ne mérite pas
XX.	XX.
Les Toscans batailloyent donnant droit dedans Rome	Les Toscans bataillaient donnant droit dedans Rome
Les armes à la main, la fureur sur le front,	Les armes à la main, la fureur sur le front,
Quand on veit un Horace avancé sur le pont,	Quand on vit un Horace avancé sur le pont,
Et d’un coup arrester tant d’hommes par un homme.	Et d’un coup arrêter tant d’hommes par un homme.
Apres un long combat & brave qu’on renomme	Après un long combat et brave qu’on renomme
De sa main le passage & s’eslance d’un bond	De sa main le passage et s’élance d’un bond
Dans le Tybre, se sauve, et sauve tout en somme,	Dans le Tibre, se sauve, et sauve tout en somme,
De la foule d’ennuis qui troublent mes esprits,	De la foule d’ennuis qui troublent mes esprits,
Il fait ferme & se bat avec tant de constance	Il fait ferme et se bat avec tant de constance
Que pres des coups il est esloingné de danger,	Que près des coups il est éloigné de danger,
Et s’il se doit enfin dans ses larmes plonger,	Et s’il se doit enfin dans ses larmes plonger,
Le dernier desespoir sera son esperance.	Le dernier désespoir sera son espérance.
XXI.	XXI.
Je veux je veux avoir tout le monde à tesmoin,	Je veux je veux avoir tout le monde à témoin,
Et ceux qui sont plus prez, & ceux qui sont plus loin	Et ceux qui sont plus près, et ceux qui sont plus loin
Ces secretes humeurs qu'hipocrites j'appelle	Ces secrètes humeurs qu’hypocrites j’appelle
Blasment secretement à l'oreille en un coin	Blâment secrètement à l’oreille en un coin
La peine que je prens d'en prendre tant de soin,	La peine que je prends d’en prendre tant de soin,
Tandis que chacun d'eux ces propres sens recelle,	Tandis que chacun d’eux ces propres sens recèle,
Ainsi nous differons, que leurs cœurs sont couverts	Ainsi nous différons, que leurs cœurs sont couverts
Et que le mien fait voir ses mouvemens ouverts :	Et que le mien fait voir ses mouvements ouverts:
Mais je ne puis rougir d'aimer si dignement,	Mais je ne puis rougir d’aimer si dignement,
Et plus mon bel amour tous leurs amours surmonte :	Et plus mon bel amour tous leurs amours surmonte:
XXII.	XXII.
On dit que dans le ciel, les diverses images	On dit que dans le ciel, les diverses images
Des astres l'un à l'autre ensemble rapportez	Des astres l’un à l’autre ensemble rapportés
Engendrent ici bas tant de diversitez	Engendrent ici bas tant de diversités
Et tantost de profits & tantost de dommages :	Et tantôt de profits et tantôt de dommages:
Tous leurs estats leur font à leur tour leur homages,	Tous leurs états leur font à leur tour leur hommages,
Ont en maintes façons certains points limitez	Ont en maintes façons certains points limités
Qui leur font & laisser & perdre leur visages.	Qui leur font et laisser et perdre leur visages.
Si ce n'est pour accroistre encores ses vigueurs,	Si ce n’est pour accroître encore ses vigueurs,
Mais non pas pour jamais d'un seul moment descendre.	Mais non pas pour jamais d’un seul moment descendre.
Non pas s'il me falloit descendre dans la mort :	Non pas s’il me fallait descendre dans la mort:
En somme il est, s'il faut par le ciel le comprendre,	En somme il est, s’il faut par le ciel le comprendre,
Ferme ne plus ne moins que l'estoile du Nort.	Ferme ne plus ne moins que l’étoile du Nord.
XXIII.	XXIII.
Avant que j'eusse appris d'aimer solidement,	Avant que j’eusse appris d’aimer solidement,
Mais si je n'eusse veu cest astre consumant	Mais si je n’eusse vu cet astre consumant
Ore je vois combien c'est une humeur estrange	Ore je vois combien c’est une humeur étrange
De vivre, mais mourir, parmy le changement,	De vivre, mais mourir, parmi le changement,
Et que l'amour luy mesme en gronde tellement	Et que l’amour lui-même en gronde tellement
Qu'il est certain qu'en fin, quoy qu'il tarde il s'en vange.	Qu’il est certain qu’en fin, quoi qu’il tarde il s’en venge.
Si tu prens un chemin après tant de destours,	Si tu prends un chemin après tant de détours,
Un bord après l'orage, & puis reprens ton cours,	Un bord après l’orage, et puis reprends ton cours,
Un erreur, on dira que tu l'as merité,	Un erreur, on dira que tu l’as mérité,
Si l'amour n'est point feint il aura le courage	Si l’amour n’est point feint il aura le courage
XXIIII.	XXIIII.
Mon Soleil qui brillez de vos yeux dans mes yeux,	Mon Soleil qui brillez de vos yeux dans mes yeux,
Et pour trop de clarté leur ostez la lumiere,	Et pour trop de clarté leur ôtez la lumière,
Je ne voy rien que vous, & mon ame est si fiere	Je ne vois rien que vous, et mon âme est si fière
Qu’elle ne daigne plus aimer que dans les cieux.	Qu’elle ne daigne plus aimer que dans les cieux.
Tout autre amour me semble un enfer furieux,	Tout autre amour me semble un enfer furieux,
J’en laisse franchement plus franche la carriere	J’en laisse franchement plus franche la carrière
A ceux qui sont plus mal et pensent faire mieux.	À ceux qui sont plus mal et pensent faire mieux.
Mais outre encor je sens quelque plus vive force	Mais outre encor je sens quelque plus vive force
Qui me feroit aimer malgré moy ce Soleil :	Qui me ferait aimer malgré moi ce Soleil:
Cette force est en vous dont la beauté puissante	Cette force est en vous dont la beauté puissante
La beauté sans pareil, encor qu’elle s’absente	La beauté sans pareil, encor qu’elle s’absente
A tué cest amant, cest amant sans pareil.	A tué cet amant, cet amant sans pareil.
XXV.	XXV.
De se sacrifier à l'autel des beautez,	De se sacrifier à l’autel des beautés,
Vous verrez que le vent de leurs legeretez	Vous verrez que le vent de leurs légèretés
Mais moy, qui si long temps à vos yeux me consume	Mais moi, qui si longtemps à vos yeux me consume
Je ne consume point pourtant mes fermetez,	Je ne consume point pourtant mes fermetés,
Et d'autant plus avant au feu vous me mettez	Et d’autant plus avant au feu vous me mettez
Plus l'or de mon amour a durer s'accoustume.	Plus l’or de mon amour à durer s’accoutume.
Pour vous, belle, le tout de ce tout ne m'est rien,	Pour vous, belle, le tout de ce tout ne m’est rien,
Ces biens sont povretez au regard de ce bien,	Ces biens sont pauvretés au regard de ce bien,
S'en trouve qui voudra vivement offencé,	S’en trouve qui voudra vivement offensé,
Pour moy j'aimerois mieux mourir en vos martyres,	Pour moi j’aimerais mieux mourir en vos martyres,
XXVI.	XXVI.
Les vents grondoyent en l'air, les plus sombres nuages	Les vents grondaient en l’air, les plus sombres nuages
Nous desroboyent le jour pesle mesle entassez	Nous dérobaient le jour pêle-mêle entassés
Les abismes d'enfer estoyent au ciel poussez	Les abîmes d’enfer étaient au ciel poussés
La mer s'enfloit des monts, & le monde d'orages :	La mer s’enflait des monts, et le monde d’orages:
Quand je vis qu'un oyseau delaissant nos rivages	Quand je vis qu’un oiseau délaissant nos rivages
Y pose de son nid les festus ramassez	Y pose de son nid les fétus ramassés
Et rappaise soudain ses escumeuses rages.	Et rapaise soudain ses écumeuses rages.
L'autre jour se logea dedans ma passion	L’autre jour se logea dedans ma passion
Et combla de bon-heur mon ame infortunee.	Et combla de bonheur mon âme infortunée.
Apres le trouble, enfin, il me donna la paix :	Après le trouble, enfin, il me donna la paix:
Mais le calme de mer n'est qu'une fois l'annee	Mais le calme de mer n’est qu’une fois l’année
Et celui de mon ame y sera pour jamais.	Et celui de mon âme y sera pour jamais.
STANCES.	STANCES.
Et deslors qu'il sortoit de son tendre berçeau,	Et dès lors qu’il sortait de son tendre berceau,
Clair au poind qu'on le veit autant que le flambeau	Clair au point qu’on le vit autant que le flambeau
Ce feu sur le poignant de sa premier Aurore	Ce feu sur le poignant de sa premier Aurore
Nous enbasmoit les champs du nectar de ses pleurs,	Nous embaumait les champs du nectar de ses pleurs,
Et les champs repousseoient un doux printemps de fleurs,	Et les champs repoussaient un doux printemps de fleurs,
Encore les pleurs couloyent, les fleurs croissoyent encore.	Encore les pleurs coulaient, les fleurs croissaient encore.
Les lis croissoyent sur tout, le lis que ce feu mesme	Les lis croissaient sur tout, le lis que ce feu même
Regardoit d'un rayon si benin de ses yeux	Regardait d’un rayon si bénin de ses yeux
On voit de meilleur œil, tousjour ce que lon aime.	On voit de meilleur œil, toujours ce que l’on aime.
La mere des amours, à demy fletrissante	La mère des amours, à demi flétrissante
Les palmes qu'elle donne aux Amans courageux	Les palmes qu’elle donne aux Amants courageux
Enlasserent plus fort leur force renaissante.	Enlacèrent plus fort leur force renaissante.
Mais depuis que du temps la course coustumiere	Mais depuis que du temps la course coutumière
Anima, de ce feu, les grillantes ardeurs,	Anima, de ce feu, les grillantes ardeurs,
Les corps ne sentoyent plus, du Soleil, que froideurs,	Les corps ne sentaient plus, du Soleil, que froideurs,
Et les ames brusloyent dessous ceste lumiere.	Et les âmes brûlaient dessous cette lumière.
Des rayons pallissans d'une fausse beauté,	Des rayons pâlissants d’une fausse beauté,
Tout aussi tost qu'il veit brusler ceste clarté,	Tout aussitôt qu’il vit brûler cette clarté,
Il se leve, ravi de ces flammes nouvelles :	Il se lève, ravi de ces flammes nouvelles:
Voici, voici, dit-il, du secours à l'Amour,	Voici, voici, dit-il, du secours à l’Amour,
Et pour luy faire honneur il volette alentour :	Et pour lui faire honneur il volette alentour:
Mais il en fist la preuve & se brusla les aisles.	Mais il en fit la preuve et se brûla les ailes.
O presage asseuré, s'escria-t-il à l'heure,	Ô présage assuré, s’écria-t-il à l’heure,
Que ce flambeau si beau n'esclaire point en vain,	Que ce flambeau si beau n’éclaire point en vain,
Que ce repos certain me serve de demeure.	Que ce repos certain me serve de demeure.
Je voy de toutes pars ma torche consumée	Je vois de toutes pars ma torche consumée
Ce feu, ce feu, tout seul, peut rallumer mes feux :	Ce feu, ce feu, tout seul, peut rallumer mes feux:
Car tous les autres feux n'ont que de la fumee.	Car tous les autres feux n’ont que de la fumée.
Deslors Amour perdit franchement sa franchise	Dès lors Amour perdit franchement sa franchise
Et de tous ces beaux champs en fist un beau desert,	Et de tous ces beaux champs en fit un beau désert,
Il maistrisoit n'aguere, & maintenant il sert,	Il maîtrisait naguère, et maintenant il sert,
Mais ce service là valloit bien sa maistrise.	Mais ce service là valait bien sa maîtrise.
Pour un gage certain qu'elle l'avoit soustrait ;	Pour un gage certain qu’elle l’avait soustrait ;
Mais gardez vous, dit-il, gardez qu'un jour le trait	Mais gardez vous, dit-il, gardez qu’un jour le trait
Elle les prend soudain d'aise toute ravie,	Elle les prend soudain d’aise toute ravie,
Se glisse dedans l'air où sont les demi-dieux,	Se glisse dedans l’air où sont les demi-dieux,
Eslance tout d'un coup cent flesches de ses yeux	Élance tout d’un coup cent flèches de ses yeux
En frappe tout un monde, & leur oste la vie.	En frappe tout un monde, et leur ôte la vie.
Les Nimphes d'alentour, comme elles l'apperceurent,	Les Nymphes d’alentour, comme elles l’aperçurent,
Se cacheront de honte aux ombrages des bois :	Se cacheront de honte aux ombrages des bois:
S'en vint & leur osta la honte quelles eurent.	S’en vint et leur ôta la honte quelles eurent.
Cependant les beautez luy croissoyent davantage,	Cependant les beautés lui croissaient davantage,
Pour achever le poinct de ses perfections,	Pour achever le point de ses perfections,
Mais elle croissoit plus encore de courage.	Mais elle croissait plus encore de courage.
Ainsi d'un haut dessein vivement animee,	Ainsi d’un haut dessein vivement animée,
Prend la fleche, qu'Amour luy mesme avoit preveu,	Prend la flèche, qu’Amour lui-même avait prévu,
Tire à force, fend l'air & va dedans le feu	Tire à force, fend l’air et va dedans le feu
Où sa fleche luy fust tout d'un coup allumee,	Où sa flèche lui fut tout d’un coup allumée,
Accolle sa beauté contre ceste grandeur,	Accole sa beauté contre cette grandeur,
Et trouvant sa ardeur pareille à sa grandeur,	Et trouvant sa ardeur pareille à sa grandeur,
Amans, ces doubles feux que vous meslez ensemble	Amants, ces doubles feux que vous mêlez ensemble
Ne sont que le pourtrait de ces deux feux jumeaux	Ne sont que le portrait de ces deux feux jumeaux
Qui calment les courroux des bouillonnantes eaux,	Qui calment les courroux des bouillonnantes eaux,
Et rasseurent la nef des vents dont elle tremble.	Et rassurent la nef des vents dont elle tremble.
Puissiez vous, tout ainsi que ces germaines flammes,	Puissiez-vous, tout ainsi que ces germaines flammes,
Survivre l'un à l'autre & jamais ne mourir,	Survivre l’un à l’autre et jamais ne mourir,
D'ames pour vos amours, & d'amour pour vos ames.	D’âmes pour vos amours, et d’amour pour vos âmes.
CHANSON	CHANSON
Esloigné de vostre beauté ?	Éloigné de votre beauté?
Tout ainsi qu'une ame captive	Tout ainsi qu’une âme captive
Au gouffre d'une obscurité,	Au gouffre d’une obscurité,
Qui n'attend tremblante à tout'heure	Qui n’attend tremblante à toute heure
Que le jour qu'il faut qu'elle meure.	Que le jour qu’il faut qu’elle meure.
Je ne vois par tout que des ombres,	Je ne vois partout que des ombres,
Les jours luisans sont des nuicts sombres,	Les jours luisants sont des nuits sombres,
Les nuicts des Enfers à mes yeux,	Les nuits des Enfers à mes yeux,
Sont beaux au pris de mes tenebres.	Sont beaux au pris de mes ténèbres.
Ce monde plain d'inquietudes	Ce monde plain d’inquiétudes
Qui flotte tout autour de moy,	Qui flotte tout autour de moi,
Ce ne sont que solitudes	Ce ne sont que solitudes
Toutes plaines de mon esmoy,	Toutes plaines de mon émoi,
Mais vuides de la douce vie	Mais vides de la douce vie
Je fons comme fondroit la cire	Je fonds comme fondrait la cire
Aupres d'un brasier enflammé,	Auprès d’un brasier enflammé,
Je sens plus mon feu ranimé,	Je sens plus mon feu ranimé,
Mais ce feu tant plus il s'augmente	Mais ce feu tant plus il s’augmente
Helas ! tant plus il me tourmente,	Hélas! tant plus il me tourmente,
Je meurs il est certain, ma belle.	Je meurs il est certain, ma belle.
Et ce peu d'ame que je tiens	Et ce peu d’âme que je tiens
Ce n'est que ceste humeur fidelle	Ce n’est que cette humeur fidèle
Le reste d'elle qui s'envole	Le reste d’elle qui s’envole
Ne me laisse que ma parole.	Ne me laisse que ma parole.
Que mes maux sont bien commencez,	Que mes maux sont bien commencés,
Mais je dois bien encore craindre,	Mais je dois bien encore craindre,
Qu'ils ne soyent pas si tost passez,	Qu’ils ne soient pas si tôt passés,
Et que mes fresles destinees	Et que mes frêles destinées
N'ont point leurs bornes terminees.	N’ont point leurs bornes terminées.
Mon Dieu ! que ceste heure incertaine	Mon Dieu! que cette heure incertaine
Et que ma belle si lointaine	Et que ma belle si lointaine
M'en garde les secours lointains !	M’en garde les secours lointains!
Pareil martyre à mon martyre?	Pareil martyre à mon martyre?
Ainsi mon ame repoussee	Ainsi mon âme repoussée
Paisible à l'abry de son port	Paisible à l’abri de son port
Sera desormais balançee	Sera désormais balancée
Dans les tempestes de la mort,	Dans les tempêtes de la mort,
Mais sa nef sera la constance,	Mais sa nef sera la constance,
Durant ceste triste fortune	Durant cette triste fortune
La voix de mes gemissemens	La voix de mes gémissements
Y prendra les soulagemens,	Y prendra les soulagements,
Et jusques à ce que je vienne	Et jusques à ce que je vienne
Belle au moins qu'il vous en souviennent.	Belle au moins qu’il vous en souviennent.
Lors me rendant en mille sortes	Lors me rendant en mille sortes
Tant de plaisirs que j'ay perdus	Tant de plaisirs que j’ai perdus
Tant & tant d'esperances mortes	Tant et tant d’espérances mortes
Trempes au miel de la presence	Trempes au miel de la présence
Les amertumes de l'absence.	Les amertumes de l’absence.
Doux objet de mes desirs,	Doux objet de mes désirs,
Charme de mon ame seduite,	Charme de mon âme séduite,
Où vous envollez vous si vite ?	Où vous envolez-vous si vite?
Me laissant dans ces desplaisirs	Me laissant dans ces déplaisirs
Où vous m'avez ainsi reduite,	Où vous m’avez ainsi réduite,
Sera-ce donc à ceste fois	Sera-ce donc à cette fois
Donra ceste entorce à ma vie,	Donnera cette entorse à ma vie,
Et que ma languissante voix	Et que ma languissante voix
Ceste offence est hors de pardon :	Cette offense est hors de pardon:
Car au lieu de prendre les armes	Car au lieu de prendre les armes
Pour me sauver de ces vacarmes	Pour me sauver de ces vacarmes
Vous me laissez à l’abandon	Vous me laissez à l’abandon
L’ame aux douleurs	L’âme aux douleurs
Les yeux aux larmes	Les yeux aux larmes
Ceste orpheline desolee	Cette orpheline désolée
D’une nuict de chagrins voilee	D’une nuit de chagrins voilée
A faute d’estre controlee.	À faute d’être contrôlée.
Quand vous serez doncques absent	Quand vous serez doncques absent
L’as d’où voulez vous que je tire	L’as d’où voulez-vous que je tire
Moyen d’affoiblir mon martire ?	Moyen d’affaiblir mon martyre?
Qui se va sur moy renfonçant	Qui se va sur moi renfonçant
Alors que vostre œil se retire.	Alors que votre œil se retire.
Il faut que je le confesse,	Il faut que je le confesse,
La foule des maux m’oppresse	La foule des maux m’oppresse
Par une idee de liese.	Par une idée de liesse.
Je n’ay point l’esprit contrefait,	Je n’ai point l’esprit contrefait,
Et n’est possible que j’assemble	Et n’est possible que j’assemble
Ces deux contraires tout ensemble,	Ces deux contraires tout ensemble,
Que je sois pour vous tout à fait,	Que je sois pour vous tout à fait,
Et que pour l’autre je le semble.	Et que pour l’autre je le semble.
Il faut prouver que je vous aime,	Il faut prouver que je vous aime,
Je voudrois en ce mal extreme,	Je voudrais en ce mal extrême,
Mon remede fust prest de mesme.	Mon remède fût prêt de même.
J’endurerois mille fois mieux	J’endurerais mille fois mieux
Tout ce mal qu’il faut que j’endure	Tout ce mal qu’il faut que j’endure
Mais je suis mise a l’adventure,	Mais je suis mise a l’aventure,
Et le beau secours de vos yeux	Et le beau secours de vos yeux
S’enfuit du mal qui me demeure.	S’enfuit du mal qui me demeure.
J'augmente par ma doleance	J’augmente par ma doléance
De mes malheurs ma violence,	De mes malheurs ma violence,
Ne despend plus que du silence.	Ne dépend plus que du silence.
Adieu beaux yeux, yeux tant aimez	Adieu beaux yeux, yeux tant aimés
Allez où vostre ame est poussee,	Allez où votre âme est poussée,
Chez nourrissons de ma pensee	Chez nourrissons de ma pensée
Je ne vous laisseray jamais	Je ne vous laisserai jamais
Encore que vous m'avez laissee.	Encore que vous m’avez laissée.
Un bien qu'on desire tant	Un bien qu’on désire tant
Il ennuye à qui l'attend	Il ennuie à qui l’attend
De me voir tant abusé,	De me voir tant abusé,
Et la longue experience	Et la longue expérience
Me rendra plus advisé :	Me rendra plus avisé:
Un bien qu'on, &c.	Un bien qu’on, etc.
Quoy donc ? ce peu de journee	Quoi donc? ce peu de journée
Prises si mal volontiers	Prises si mal volontiers
Mais des siecles tout entiers ?	Mais des siècles tout entiers?
Un bien qu'on, &c.	Un bien qu’on, etc.
En la langueur où je suis	En la langueur où je suis
Que le temps qui tout devore	Que le temps qui tout dévore
Ne devore mes ennuis :	Ne dévore mes ennuis:
Un bien qu'on, &c.	Un bien qu’on, etc.
Mais c'est que ma belle flame	Mais c’est que ma belle flamme
N'a point d'autre qualité,	N’a point d’autre qualité,
Qui court vers l'éternité :	Qui court vers l’éternité:
Un bien qu'on, &c.	Un bien qu’on, etc.
Ce mal sourd comme la mort,	Ce mal sourd comme la mort,
La medecine est trop mole	La médecine est trop molle
Et le mal beaucoup plus fort :	Et le mal beaucoup plus fort:
Un bien qu'on, &c.	Un bien qu’on, etc.
Ceste absence si cruelle	Cette absence si cruelle
Me met en estrange point,	Me met en étrange point,
Je meurs de ne la voir point.	Je meurs de ne la voir point.
Un bien qu'on, &c.	Un bien qu’on, etc.
Soleil, de tes premiers feux	Soleil, de tes premiers feux
Pour Daphné, je fais mon conte	Pour Daphné, je fais mon conte
Que nous sçavons bien tous deux.	Que nous savons bien tous deux.
Un bien qu'on, &c.	Un bien qu’on, etc.
Haste donc pour moy la suite	Hâte donc pour moi la suite
De tes journaliers plaisirs,	De tes journaliers plaisirs,
Les aisles de mes desirs :	Les ailes de mes désirs:
Un bien qu'on, &c.	Un bien qu’on, etc.
La fin de mon triste esmoy,	La fin de mon triste émoi,
Voy ma Belle, & pren bien garde	Vois ma Belle, et prends bien garde
Qu'elle sente comme moy	Qu’elle sente comme moi
Un bien qu'on desire tant,	Un bien qu’on désire tant,
Il ennuye à qui l'attend.	Il ennuie à qui l’attend.
ELEGIE.	ÉLÉGIE.
Esteignent vos fureurs au poinct de leur naissance,	Éteignent vos fureurs au point de leur naissance,
Vous n'entrebatez plus de souspirs vostre flanc,	Vous n’entrebattez plus de soupirs votre flanc,
En quoy, la mort vous tient ? & ce front teint en cendre	En quoi, la mort vous tient? et ce front teint en cendre
Vous marque les tombeaux où vous allez descendre ?	Vous marque les tombeaux où vous allez descendre?
Si vous pouviez encor revoir dedans les cieux	Si vous pouviez encor revoir dedans les cieux
Ce feu, qui s'est caché des pointes de vos yeux	Ce feu, qui s’est caché des pointes de vos yeux
Vous vivriez dites-vous, mais la clarté ravie	Vous vivriez dites-vous, mais la clarté ravie
Ravit en mesme temps l'esclair de votre vie.	Ravit en même temps l’éclair de votre vie.
Ny faire beau visage en ces affreux ennuis,	Ni faire beau visage en ces affreux ennuis,
Ce contraire est trop grand vivre auprès de ma Belle	Ce contraire est trop grand vivre auprès de ma Belle
Il faut donques mourir & par necessité	Il faut donques mourir et par nécessité
Qu'à la fin vostre Hyver succede à vostre Esté.	Qu’à la fin votre Hiver succède à votre Été.
Papillons bien aimez, nourrissons de mon ame,	Papillons bien aimés, nourrissons de mon âme,
Puisque votre origine est prise de ma flame	Puisque votre origine est prise de ma flamme
Et que ma flame garde encore son ardeur	Et que ma flamme garde encore son ardeur
D'où vous vient d'où vous vient cette prompte froideur ?	D’où vous vient d’où vous vient cette prompte froideur?
Me l'avez-vous changé si soudain en fumee ?	Me l’avez-vous changé si soudain en fumée?
Vous me laissez, ingrats, & la desloyauté	Vous me laissez, ingrats, et la déloyauté
Est-ce que vous craignez que votre tendre veu	Est-ce que vous craignez que votre tendre vue
Se rebouche si bien contre la pointe aiguë	Se rebouche si bien contre la pointe aiguë
Des rayons du Soleil, qu'à l'espreuve du jour	Des rayons du Soleil, qu’à l’épreuve du jour
On ne vous juge point de vrais enfans d'Amour ?	On ne vous juge point de vrais enfants d’Amour?
Et que ces beaux esprits dont on fait tant de compte,	Et que ces beaux esprits dont on fait tant de compte,
S'ils vous ont descouvers ne vous couvrent de honte ?	S’ils vous ont découverts ne vous couvrent de honte?
Ne despleust d'aventure aux yeux de la beauté	Ne déplût d’aventure aux yeux de la beauté
Pour qui vous travaillez, & par trop de coustume,	Pour qui vous travaillez, et par trop de coutume,
Helas ! ne mourez point & servez pour le moins	Hélas! ne mourez point et servez pour le moins
A ma fidelité de fideles tesmoins,	À ma fidélité de fidèles témoins,
Que si des Basilics l’œil malin vous offence	Que si des Basilics l’œil malin vous offense
Marchant parmi ces fleurs, j'en prendray la deffense,	Marchant parmi ces fleurs, j’en prendrai la défense,
Et du miroir luisant de mon authorité	Et du miroir luisant de mon autorité
J'esteindray tout soudain ceste malignité :	J’éteindrai tout soudain cette malignité:
Et quand les vents battroyent votre nef si fragile	Et quand les vents battraient votre nef si fragile
Vous ne sçauriez vous perdre au Phare de mon feu.	Vous ne sauriez vous perdre au Phare de mon feu.
Ils vous don'ront tousjours leur veuë toute entiere	Ils vous donneront toujours leur vue toute entière
Si ce n'est pour la forme, au moins pour la matiere.	Si ce n’est pour la forme, au moins pour la matière.
Que si vostre langueur ne se peut secourir,	Que si votre langueur ne se peut secourir,
Si vous avez du tout resolu de mourir,	Si vous avez du tout résolu de mourir,
Mourez, mourez au moins d'une mort qui soit digne	Mourez, mourez au moins d’une mort qui soit digne
De vostre belle vie, & faites que le Cygne	De votre belle vie, et faites que le Cygne
Sur le bord de sa mort, se charme par les miens	Sur le bord de sa mort, se charme par les miens
Ce dernier feu laissant votre mourante bouche,	Ce dernier feu laissant votre mourante bouche,
Beaucoup plus doucement que quand au fort du jour	Beaucoup plus doucement que quand au fort du jour
Les brandons qu'il vomit grillent notre sejour.	Les brandons qu’il vomit grillent notre séjour.
Mourez, mes vers, mourez, puisque c'est vostre envie,	Mourez, mes vers, mourez, puisque c’est votre envie,
Ce qui vous sert de mort, me servira de vie.	Ce qui vous sert de mort, me servira de vie.
L'orage de mes maux, qui me va repoussant	L’orage de mes maux, qui me va repoussant
Du bien tant desiré dont je me trouve absent,	Du bien tant désiré dont je me trouve absent,
Que je le romps luy-mesme, & d'une humeur diverse	Que je le romps lui-même, et d’une humeur diverse
A ces esprits qui vont d'onde en onde sautant,	À ces esprits qui vont d’onde en onde sautant,
Change en un naturel si bien ceste coustume,	Change en un naturel si bien cette coutume,
Que tous ces monts de flots il les couvre d'escume,	Que tous ces monts de flots il les couvre d’écume,
Et sentiront tousjours s'ils veulent m'approcher,	Et sentiront toujours s’ils veulent m’approcher,
Qu'ils sont mols comme une eau, moy dur comme un rocher.	Qu’ils sont mols comme une eau, moi dur comme un rocher.
Mourez, mes vers, mourez, puisque c'est vostre envie	Mourez, mes vers, mourez, puisque c’est votre envie
Ce qui vous sert de mort me servira de vie.	Ce qui vous sert de mort me servira de vie.
Ne se va tant soit peu dans un feu consumant,	Ne se va tant soit peu dans un feu consumant,
Et d'autant plus ce feu dans son ardeur persiste	Et d’autant plus ce feu dans son ardeur persiste
Et mille fois remis dans le plomb qu'il soustient	Et mille fois remis dans le plomb qu’il soutient
Plus brillant & plus beau mille fois il revient :	Plus brillant et plus beau mille fois il revient:
Mon amour est de mesme; & tous les maux qu'il treuve	Mon amour est de même; et tous les maux qu’il trouve
Ne luy servent de rien que d'une vive espreuve,	Ne lui servent de rien que d’une vive épreuve,
Dont le brasier, encor qu'il se sente cuisant,	Dont le brasier, encor qu’il se sente cuisant,
Luy fait l'ame plus nette & le front plus muisant.	Lui fait l’âme plus nette et le front plus muisant.
Ce qui vous sert de mort me servira de vie.	Ce qui vous sert de mort me servira de vie.
On n'eust jamais cognu le Scevole Romain	On n’eût jamais connu le Scévole Romain
Cesar sans les Gaulois, Scipion sans Carthage	César sans les Gaulois, Scipion sans Carthage
Le sommeillant repos endormoit leur courage,	Le sommeillant repos endormait leur courage,
Et leur nom dans la mort s'alloit desja plonger	Et leur nom dans la mort s’allait déjà plonger
S'il n'eust trouvé sa vie en cherchant le danger.	S’il n’eût trouvé sa vie en cherchant le danger.
Mon Amour cherche ainsi, pour se montrer si brave	Mon Amour cherche ainsi, pour se montrer si brave
Des perils de l'Amour le peril le plus grave,	Des périls de l’Amour le péril le plus grave,
Qu'il sçait que c'est de batre & non d'estre batu.	Qu’il sait que c’est de battre et non d’être battu.
Mourez, mes vers, mourez, puis que c'est vostre envie,	Mourez, mes vers, mourez, puisque c’est votre envie,
Quand je fus, par malheur, de ma belle distrait	Quand je fus, par malheur, de ma belle distrait
J'emportay dans mon cœur, non le vulgaire trait	J’emportai dans mon cœur, non le vulgaire trait
Dont mille ames gisoyent à ses pieds comme morts	Dont mille âmes gisaient à ses pieds comme morts
Mais les traits qui m'avoyent navré de mille sortes	Mais les traits qui m’avaient navré de mille sortes
Dont elle mesme encore à l'ennuy se blessa	Dont elle-même encore à l’ennui se blessa
Et pour gage cerain d'Amour me les laissa.	Et pour gage certain d’Amour me les laissa.
Je n'en retienne point la memoire recente ?	Je n’en retienne point la mémoire récente?
Et sans ceste memoire, un amour si vivant	Et sans cette mémoire, un amour si vivant
Mourez, mes vers, mourez, puis que c'est vostre envie,	Mourez, mes vers, mourez, puisque c’est votre envie,
Ce qui vous sert de mort me servira de vie.	Ce qui vous sert de mort me servira de vie.
Tout ainsi que l'on dit de ce mont embrasé,	Tout ainsi que l’on dit de ce mont embrasé,
Dont le foudre & le vent ne peut estre appaisé,	Dont le foudre et le vent ne peut être apaisé,
Qu'il ne vommisse en haut, des cavernes profondes	Qu’il ne vomisse en haut, des cavernes profondes
D'un abisme grondant, ses feux à grosses ondes :	D’un abîme grondant, ses feux à grosses ondes:
Au lieu de l'estouffer l'en flamme de ses eaux :	Au lieu de l’étouffer l’en flamme de ses eaux:
Mon cœur bruslant de mesme en mesme violence	Mon cœur brûlant de même en même violence
Et quoy que le feu meure en la glace autrement,	Et quoique le feu meure en la glace autrement,
Mes feux tout au rebours y trouvent aliment,	Mes feux tout au rebours y trouvent aliment,
Mourez, mes vers, mourez, puis que c'est vostre envie,	Mourez, mes vers, mourez, puisque c’est votre envie,
Ce qui vous sert de mort me servira de vie.	Ce qui vous sert de mort me servira de vie.
La nature est flottante, & par ses mouvements,	La nature est flottante, et par ses mouvements,
Elle se peint le front de divers changemens :	Elle se peint le front de divers changements:
Qu'ainsi comme elle pert visage apres visage	Qu’ainsi comme elle perd visage après visage
Elle perdra sa vie à la fin par la mort :	Elle perdra sa vie à la fin par la mort:
Ne change point du tout & sa vie estouffee	Ne change point du tout et sa vie étouffée
Ne servira jamais à la mort de Trophee :	Ne servira jamais à la mort de Trophée:
Enfin j'auray dit vray, ne fust-ce que ce poinct,	Enfin j’aurai dit vrai, ne fût-ce que ce point,
Que j'aime de l'esprit & l'esprit ne meurt point.	Que j’aime de l’esprit et l’esprit ne meurt point.
Mourez, mes vers, mourez, puis que c'est vostre envie,	Mourez, mes vers, mourez, puisque c’est votre envie,
Ce qui vous sert de mort me servira de vie.	Ce qui vous sert de mort me servira de vie.
Que ce mal est contraire à mes plaisirs passez,	Que ce mal est contraire à mes plaisirs passés,
Et que je pers beaucoup par mes longues souffrances	Et que je perds beaucoup par mes longues souffrances
Mais cet amour pourtant dont mon cœur est touché	Mais cet amour pourtant dont mon cœur est touché
N'est point par son essence à l'absence attaché,	N’est point par son essence à l’absence attaché,
Ce n'est point la cause, aussi ne sçauroit-elle	Ce n’est point la cause, aussi ne saurait-elle
Faire mourir l'effect d'une chose immortelle :	Faire mourir l’effet d’une chose immortelle:
Au contraire le bien dont on s'est retiré	Au contraire le bien dont on s’est retiré
Est d'autant plus aimé plus il est desiré.	Est d’autant plus aimé plus il est désiré.
Ce qui vous sert de mort me servira de vie.	Ce qui vous sert de mort me servira de vie.
Je fendray donques l'air par mes gemissemens	Je fendrai donques l’air par mes gémissements
Mais puis que nos Amours, qui fuyent les ruines,	Mais puis que nos Amours, qui fuient les ruines,
Sont des roses privez, nourrissons des espines	Sont des roses privés, nourrissons des épines
Et changeant de pasture à leurs cœur affamez	Et changeant de pâture à leurs cœur affamés
Apprenons-leur eux mesme a ne changer jamais.	Apprenons-leur eux-mêmes à ne changer jamais.
Dans les esprits bien nez qui sentent bien empraintes	Dans les esprits bien nés qui sentent bien empreintes
Les flesches de l'amour, de miel & de fiel taintes,	Les flèches de l’amour, de miel et de fiel teintes,
L'absence les renforce & le fait plus parfait.	L’absence les renforce et le fait plus parfait.
Mourez, mes vers, mourez, puis que c'est vostre envie,	Mourez, mes vers, mourez, puisque c’est votre envie,
Ainsi les tourtereau, qui perdent leur ami,	Ainsi les tourtereau, qui perdent leur ami,
Languit la voix és bois vive & morte à demi,	Languit la voix ès bois vive et morte à demi,
Et ces mignons d'Amour tesmoignent qu'en leur perte	Et ces mignons d’Amour témoignent qu’en leur perte
Ils gaignent par leurs feux la perte plus ouverte,	Ils gagnent par leurs feux la perte plus ouverte,
Et tous seuls dans ce dueil qui leur est tant amer	Et tous seuls dans ce deuil qui leur est tant amer
Apprennent doucement que c'est de bien aimer.	Apprennent doucement que c’est de bien aimer.
En quelque part qu'il soit jusqu'au vif sa pensee	En quelque part qu’il soit jusqu’au vif sa pensée
L'Amour dans ses vergers aveugle le conduit,	L’Amour dans ses vergers aveugle le conduit,
Mourez, mes vers, mourez, puis que c'est vostre envie,	Mourez, mes vers, mourez, puisque c’est votre envie,
Ce qui vous sert de mort me servira de vie.	Ce qui vous sert de mort me servira de vie.
STANCES B. D. F.	STANCES B. D. F.
Depuis ce triste jour que mon ame captive	Depuis ce triste jour que mon âme captive
S'empestra des liens de vos cruelles loix,	S’empêtra des liens de vos cruelles lois,
Et que pour vous servir, elle tenoit craintive	Et que pour vous servir, elle tenait craintive
J'arrestay mes desirs du vent de l'inconstance	J’arrêtai mes désirs du vent de l’inconstance
D'espoir & desespoir tous les jours combatus,	D’espoir et désespoir tous les jours combattus,
Je leur choisi le port de vos belles vertus.	Je leur choisis le port de vos belles vertus.
Il sembloit que l'amour me prestoit la main forte	Il semblait que l’amour me prêtait la main forte
Tant il avoit son front serain de tous costez,	Tant il avait son front serein de tous côtés,
Vous mesme, en vos discours, monstriez en quelque sorte	Vous-même, en vos discours, montriez en quelque sorte
Je ne sçay quoy de plus que les divinitez.	Je ne sais quoi de plus que les divinités.
Mais ce calme d'Amour ne couvoit un orage	Mais ce calme d’Amour ne couvait un orage
Et vous sous les douceurs de vostre beau langage,	Et vous sous les douceurs de votre beau langage,
Desguisiez un esprit contraire à vos propos.	Déguisiez un esprit contraire à vos propos.
Meritoit la faveur d'un aimable recueil,	Méritait la faveur d’un aimable recueil,
Je n'euz, pour le loyer de si belle entreprise,	Je n’eus, pour le loyer de si belle entreprise,
Que les esclairs tranchans du courroux de vostre œil.	Que les éclairs tranchants du courroux de votre œil.
Desdains dessus desdains, martyre sur martyre	Dédains dessus dédains, martyre sur martyre
Couronnoyent les travaux de ma fidelité,	Couronnaient les travaux de ma fidélité,
Quoy qu'autant que i'estois digne de vostre Empire	Quoiqu’autant que j’étais digne de votre Empire
Quand j'eus beaucoup souffert, ma longue patience	Quand j’eus beaucoup souffert, ma longue patience
Blessee, se changea par contrainte en fureur,	Blessée, se changea par contrainte en fureur,
Pouvois-je sans mourir, voir mourir mon honneur ?	Pouvais-je sans mourir, voir mourir mon honneur?
L'enfer mesme voyant les langueurs de ma vie	L’enfer même voyant les langueurs de ma vie
Quoy qu'il soit insensible en print quelque pitié,	Quoiqu’il soit insensible en prit quelque pitié,
Et des sanglants cordeaux de la jalouse envie	Et des sanglants cordeaux de la jalouse envie
Entortilla les nœuds de vostre autre amitié.	Entortilla les nœuds de votre autre amitié.
Confessez franchement, vous qui sentez ces peines	Confessez franchement, vous qui sentez ces peines
Qu'en matiere d'Amour les offences certaines	Qu’en matière d’Amour les offenses certaines
Sont certaines aussi de leurs punitions.	Sont certaines aussi de leurs punitions.
Et je vous plains encor ne fust-ce que ce point,	Et je vous plains encor ne fût-ce que ce point,
Qu'à tout le moins pour moy vous sçavez le remede	Qu’à tout le moins pour moi vous savez le remède
Mais pour vous mesme, helas ! vous ne le sçavez point.	Mais pour vous-même, hélas! vous ne le savez point.
Peut estre que changeant encore de courage	Peut être que changeant encore de courage
Vos malheurs envers vous se pourroyent bien changer,	Vos malheurs envers vous se pourraient bien changer,
Et que ne trouvant point de sujet davantage	Et que ne trouvant point de sujet davantage
Je le crois pour le moins, & faites-vous l'espreuve	Je le crois pour le moins, et faites-vous l’épreuve
D'autant plus librement qu'il est plus deffendu,	D’autant plus librement qu’il est plus défendu,
Qu'un bien fait à propos ne peut estre perdu.	Qu’un bien fait à propos ne peut être perdu.
Sur la mort du B.D.F.	Sur la mort du B.D.F.
STANCES :	STANCES:
Braves enfans de Mars, nourrissons de Bellonne,	Braves enfants de Mars, nourrissons de Bellonne,
Qui portez dans vos mais les glaives tous sanglans	Qui portez dans vos mais les glaives tous sanglants
Dont vous perçez le dos, l'estomac , & les flancs	Dont vous percez le dos, l’estomac, et les flancs
Et vous mon Roy, premier de rang & de courage,	Et vous mon Roi, premier de rang et de courage,
Ame de tous ces corps qui vous vont tous fuyant,	Âme de tous ces corps qui vous vont tous fuyant,
A qui l'Europe un jour doit un entier hommage.	À qui l’Europe un jour doit un entier hommage.
J'apprestois des lauriers pour ceindre vos victoires	J’apprêtais des lauriers pour ceindre vos victoires
Vos triomphes d'honneur estoyent desjà tous prests,	Vos triomphes d’honneur étaient déjà tous prêts,
Mais quoy ! faut il mesler les Lauriers de Cyprez	Mais quoi! faut-il mêler les Lauriers de Cyprès
Et de mon triste dueil la joye de vos gloires !	Et de mon triste deuil la joie de vos gloires!
Où m'avez-vous laissé ces aimables delices,	Où m’avez-vous laissé ces aimables délices,
Hé ! cuidez vous qu'on puisse ainsi vivre à demi,	Hé! cuidez-vous qu’on puisse ainsi vivre à demi,
Si ce n'est comme on vit au milieu des supplices ?	Si ce n’est comme on vit au milieu des supplices?
Qui couroit genereux aux dangers comme vous,	Qui courait généreux aux dangers comme vous,
A-il tout seul laissé, dans le malheur des coups,	A-il tout seul laissé, dans le malheur des coups,
L'ame, de luy, de nous & de moy desunie ?	L’âme, de lui, de nous et de moi désunie?
Encore que vostre coup de la coulpe s'exempte,	Encore que votre coup de la coulpe s’exempte,
Et que son meurtrier aille au rang des innocens,	Et que son meurtrier aille au rang des innocents,
Si faut-il, quel qu'il soit, pour contenter mes sens	Si faut-il, quel qu’il soit, pour contenter mes sens
Aveugle il a guidé son aveugle fortune;	Aveugle il a guidé son aveugle fortune;
Et si son cœur n'a fait un si piteux dessein,	Et si son cœur n’a fait un si piteux dessein,
Et de luy seul nous vient ceste perte commune.	Et de lui seul nous vient cette perte commune.
Mais en quelque façon qu'elle soit advenue	Mais en quelque façon qu’elle soit advenue
Je vois mon pauvre ami sur la poudre estendu,	Je vois mon pauvre ami sur la poudre étendu,
Et les glaçons tous froids de ce sang respandu	Et les glaçons tous froids de ce sang répandu
Où jadis luy bouilloit sa valeur si cognüe.	Où jadis lui bouillait sa valeur si connue.
Ces playes, que je voy perçee ainsi ces armes,	Ces plaies, que je vois percée ainsi ces armes,
Mais dolent de l'effort d'un dueil si violent,	Mais dolent de l’effort d’un deuil si violent,
Qu'il arreste & devore, & ma voix, & mes larmes.	Qu’il arrête et dévore, et ma voix, et mes larmes.
Ce sont des maux lesgers qui s'envolent par là,	Ce sont des maux légers qui s’envolent par là,
Mais ce mal est plus grand que non pas tous ceux là	Mais ce mal est plus grand que non pas tous ceux-là
Un mal sous qui mon sens & s'estouffe & s'estonne.	Un mal sous qui mon sens et s’étouffe et s’étonne.
Mais à ce mien ami, pour marque plus notoire	Mais à ce mien ami, pour marque plus notoire
Que je l'ay tant aimé, je luy garde un tombeau :	Que je l’ai tant aimé, je lui garde un tombeau:
Mais un tombeau tousjours esclairé d'un flambeau,	Mais un tombeau toujours éclairé d’un flambeau,
Ah, que c'est peu de l'homme ! & que ceste lmumiere	Ah, que c’est peu de l’homme! et que cette lumière
Qui nous fait vivre peu de peu de vent s'estaint,	Qui nous fait vivre peu de peu de vent s’éteint,
Et souvent les premiers la trouvent la premiere.	Et souvent les premiers la trouvent la première.
Heureux qui ne tient point sa vie à l'adventure,	Heureux qui ne tient point sa vie à l’aventure,
Mais quand la mort s'approche il a tant de bon heur	Mais quand la mort s’approche il a tant de bon heur
Qu'il l'attend pour le moins sur le pas de l'honneur	Qu’il l’attend pour le moins sur le pas de l’honneur
Et pour elle jamais ne change de posture.	Et pour elle jamais ne change de posture.
STANCES	STANCES
Il esparpille en l'air sa chevelure blonde	Il éparpille en l’air sa chevelure blonde
Tout beau, tout rayonneux, tout brillant de clarté,	Tout beau, tout rayonneux, tout brillant de clarté,
Et se donne luy mesme en son triomphe au monde.	Et se donne lui-même en son triomphe au monde.
Nimphe serois-tu point ceste mesme lumiere,	Nymphe serais-tu point cette même lumière,
Qui laisses dans le Ciel ta course coustumiere	Qui laisses dans le Ciel ta course coutumière
A quelque Phaëton qui t'ait importuné ?	À quelque Phaéton qui t’ait importuné?
Ou bien, le monde est-il de deux torches orné	Ou bien, le monde est-il de deux torches orné
Du Soleil la seconde, & de toy la premiere ?	Du Soleil la seconde, et de toi la première?
Qui nous donne le jour plus fort que de coustume	Qui nous donne le jour plus fort que de coutume
Au sortir esclatant de ses sombres rideaux,	Au sortir éclatant de ses sombres rideaux,
Car à ces beaux flambeaux leur noirceur se consume.	Car à ces beaux flambeaux leur noirceur se consume.
A voir tant de splendeur qui de tes yeux flamboye,	À voir tant de splendeur qui de tes yeux flamboie,
A voir tout ce bel or qui sur ton dos ondoye,	À voir tout ce bel or qui sur ton dos ondoie,
Tout tremblotant d'Amour, transformez en Zephirs,	Tout tremblotant d’Amour, transformés en Zéphirs,
Et ce sein, qui s'estraint & s'estend de souspirs,	Et ce sein, qui s’étreint et s’étend de soupirs,
Que nos yeux ont de bien, & nos ames de joye !	Que nos yeux ont de bien, et nos âmes de joie!
Quiconque soit celuy pour lequel tu t'enflames	Quiconque soit celui pour lequel tu t’enflammes
Il faut qu'il soit quelqu'un d'entre les plus grands Dieux	Il faut qu’il soit quelqu’un d’entre les plus grands Dieux
Ce sont glaçons pour nous, et pour luy seul des flammes	Ce sont glaçons pour nous, et pour lui seul des flammes
Luy & nous te voyons, mais non pas tout de mesme,	Lui et nous te voyons, mais non pas tout de même,
Luy ravy de l'ardeur de son amour extresme	Lui ravi de l’ardeur de son amour extrême
Te voit pour te cherir ou pour te desirer,	Te voit pour te chérir ou pour te désirer,
Et nous ne te voyons que pour mieux admirer	Et nous ne te voyons que pour mieux admirer
Les divines beautez qui l'aiment & qu'il aime.	Les divines beautés qui l’aiment et qu’il aime.
Tu n'esclaires qu'un Dieu qui tout à toy se donne	Tu n’éclaires qu’un Dieu qui tout à toi se donne
Un Dieu seul, tout le reste est gisant dans la nuict,	Un Dieu seul, tout le reste est gisant dans la nuit,
Qui sent soudain la nuict, & soudain l'abandonne.	Qui sent soudain la nuit, et soudain l’abandonne.
Que vous estes heureus, Nimphe & Dieu tous ensemble	Que vous êtes heureux, Nymphe et Dieu tous ensemble
Puis qu'en vous tout l'amour des amours se rassemble	Puis qu’en vous tout l’amour des amours se rassemble
Nompareille beauté, nompareille grandeur	Nonpareille beauté, nonpareille grandeur
On ne voit rien ici qui semble vostre ardeur,	On ne voit rien ici qui semble votre ardeur,
Aussi ne voit-on rien au monde qui vous semble.	Aussi ne voit-on rien au monde qui vous semble.
Ma belle languissoit dans sa funeste couche	Ma belle languissait dans sa funeste couche
Où la mort ces beaux yeux de leurs traits desarmoit,	Où la mort ces beaux yeux de leurs traits désarmait,
Les lys dessus son front, les roses sur sa bouche.	Les lys dessus son front, les roses sur sa bouche.
L'air paraissoit autour tout noir, des nuits funebres	L’air paraissait autour tout noir, des nuits funèbres
Qui des jours de la vie esteignent le flambeau :	Qui des jours de la vie éteignent le flambeau:
Elle perdoit déjà son corps dans le tombeau,	Elle perdait déjà son corps dans le tombeau,
Et sauvoit dans le Ciel son ame des tenebres,	Et sauvait dans le Ciel son âme des ténèbres,
Toute la terre estoit de dueil toute couverte	Toute la terre était de deuil toute couverte
L'ame mesme sans corps, sembloit moins belle aux Dieux,	L’âme même sans corps, semblait moins belle aux Dieux,
Et ce qu'ils en gagnoyent leur sembloit une perte.	Et ce qu’ils en gagnaient leur semblait une perte.
Que ce rare tresor ne me fust tout ravi,	Que ce rare trésor ne me fût tout ravi,
S'il l'eust esté, je l'eusse incontinent suyvi,	S’il l’eût été, je l’eusse incontinent suivi,
Ainsi que l'ombre suit une lumiere esteinte	Ainsi que l’ombre suit une lumière éteinte
Nostre fortune enfin de toutes pars poussee	Notre fortune enfin de toutes pars poussée
A force de malheur fut preste à renverser,	À force de malheur fut preste à renverser,
Ma belle en se mourant, & moi pour me presser	Ma belle en se mourant, et moi pour me presser
L'amour, qui la voyoit cruellement ravie	L’amour, qui la voyait cruellement ravie
S'enflame de colere à voir mourir son feu,	S’enflamme de colère à voir mourir son feu,
L'esvente de son aisle & luy donne la vie.	L’évente de son aile et lui donne la vie.
Mais l'amour au voler se trouva tout estrange,	Mais l’amour au voler se trouva tout étrange,
Car la douleur tenoit engourdis les Zephirs :	Car la douleur tenait engourdis les Zéphirs:
Je les luy r'animois du vent de mes souspirs	Je les lui ranimais du vent de mes soupirs
Et s'il a fait du bien j'ay part à la louange.	Et s’il a fait du bien j’ai part à la louange.
Ma belle cependant recommence a reprendre	Ma belle cependant recommence à reprendre
Qui pourfilent son corps de traits encore plus beaux	Qui pourfilent son corps de traits encore plus beaux
Et renaist tout ainsi qu'un Phœnix de sa cendre.	Et renaît tout ainsi qu’un Phœnix de sa cendre.
L'enfer de mes ennuis dedans l'air s'est perdu :	L’enfer de mes ennuis dedans l’air s’est perdu:
Que si j'ay du repos de l'avoir entendu	Que si j’ai du repos de l’avoir entendu
Qu'aurois-je pour l'avoir s'il me donnoit des aisles ?	Qu’aurais-je pour l’avoir s’il me donnait des ailes?
N'auray-je doncques point encor que des oreilles ?	N’aurai-je doncques point encor que des oreilles?
Et mes yeux seront-ils encor de vous privez ?	Et mes yeux seront-ils encor de vous privés?
De vous ma belle, a qui les biens sont arrivez,	De vous ma belle, à qui les biens sont arrivés,
Au moins triste langueur de ma longue distance	Au moins triste langueur de ma longue distance
Qui m'enchaines les jours comme insensiblement	Qui m’enchaines les jours comme insensiblement
Mais ne me trouvez point de fin à ma constance.	Mais ne me trouvez point de fin à ma constance.
STANCES	STANCES
N'est ce donc pas assez que je sois tout en flamme	N’est ce donc pas assez que je sois tout en flamme
Tout en flamme de vous, & pour vous mon flambeau,	Tout en flamme de vous, et pour vous mon flambeau,
Si pour mieux me fermer la porte de votre ame	Si pour mieux me fermer la porte de votre âme
Vous ne m'ouvriez encore celle de mon tombeau.	Vous ne m’ouvriez encore celle de mon tombeau.
Pour tant d'entiers tesmoins de ma fidelité,	Pour tant d’entiers témoins de ma fidélité,
Et les rompez plustost comme de petits fleuves,	Et les rompez plutôt comme de petits fleuves,
Mais que vous restoit-il, si vous pour tant de geines	Mais que vous restait-il, si vous pour tant de gênes
Que vous m'avez donné, ne m'avez point perdu?	Que vous m’avez donné, ne m’avez point perdu?
Si mesme pour le mal de vos injustes haines	Si même pour le mal de vos injustes haines
Mon innocent Amour du bien vous a rendu ?	Mon innocent Amour du bien vous a rendu?
Quand vous dardiez sur moi vos flammesches bruslantes,	Quand vous dardiez sur moi vos flammèches brûlantes,
Je presentois sur moi mon ame à leurs ardeurs,	Je présentais sur moi mon âme à leurs ardeurs,
Tant plus je leur rendois de plus douces odeurs.	Tant plus je leur rendais de plus douces odeurs.
J'ay languy tout un temps en ce long sacrifice,	J’ai langui tout un temps en ce long sacrifice,
Et s'il fust onc Martyr de l'amoureux supplice,	Et s’il fût onc Martyr de l’amoureux supplice,
Ou jamais il n'en fust, ou n'en fust jamais tel.	Ou jamais il n’en fut, ou n’en fut jamais tel.
Ores que j'attendois que vostre ame apaisee	Ores que j’attendais que votre âme apaisée
Print enfin le chemin d'une aimable douceur,	Prît enfin le chemin d’une aimable douceur,
La voila de nouveau remise en sa brisee,	La voilà de nouveau remise en sa brisée,
Et moi plus esgaré du chemin le plus seur.	Et moi plus égaré du chemin le plus sûr.
De deffis ombrageux et d'inconstants soupçons,	De défis ombrageux et d’inconstants soupçons,
Et si nos passions estoyent d'humeurs esgales,	Et si nos passions étaient d’humeurs égales,
Mais quoi ! si je ne meurs moymesme il faut qu'ils vivent	Mais quoi! si je ne meurs moi-même il faut qu’ils vivent
Et que leur sort se trouve avec le mien conjoint,	Et que leur sort se trouve avec le mien conjoint,
Que si vos cruautez encores vous poursuyvent	Que si vos cruautés encore vous poursuivent
Ils ne peuvent mourir, & moi ne mourir point.	Ils ne peuvent mourir, et moi ne mourir point.
C'est ce que vous cerchez : car m'ostant la creance	C’est ce que vous cherchez: car m’ôtant la créance
Que toute Amante doit par droit à son Amant,	Que toute Amante doit par droit à son Amant,
Car le feu ne vit point s'il n'a son aliment.	Car le feu ne vit point s’il n’a son aliment.
Helas ! ne m'ostez point si promptement la vie	Hélas! ne m’ôtez point si promptement la vie
Vous seule de moy seul pouvez estre servie	Vous seule de moi seul pouvez être servie
Comme un Soleil de l'Aigle estre bien regardé.	Comme un Soleil de l’Aigle être bien regardé.
Sur la fievre	Sur la fièvre
Que faites vous dedans mes os	Que faites vous dedans mes os
Petites vapeurs enflammees,	Petites vapeurs enflammées,
Dont les petillantes fumees	Dont les pétillantes fumées
Vous me portez de veine en veine	Vous me portez de veine en veine
Les cuisans tisons de vos feux,	Les cuisants tisons de vos feux,
Je perds le cours de mon haleine.	Je perds le cours de mon haleine.
Mes yeux crevez de vos ennuis	Mes yeux crevés de vos ennuis
Sont bandez de tant de nuages,	Sont bandés de tant de nuages,
Qu'en ne voyant que des ombrages	Qu’en ne voyant que des ombrages
Ils voyent des profondes nuits.	Ils voient des profondes nuits.
Mon cerveau siege de mon ame	Mon cerveau siège de mon âme
N'est plus que l'horrible prison	N’est plus que l’horrible prison
De votre plus horrible flamme.	De votre plus horrible flamme.
Tous songes de vos frenaisies,	Tous songes de vos frénésies,
Qui grotesquent mes fantasies	Qui grotesquent mes fantaisies
De feu, de terre, d'air & d'eau.	De feu, de terre, d’air et d’eau.
C'est un chaos que ma pensee	C’est un chaos que ma pensée
Qui m'eslance ores sur les monts,	Qui m’élance ores sur les monts,
Ore m'abisme dans un fond,	Ore m’abîme dans un fond,
Ma voix qui n'a plus qu'un filet	Ma voix qui n’a plus qu’un filet
A peine, à peine encore tire	À peine, à peine encore tire
De l'enfer des maux où elle est.	De l’enfer des maux où elle est.
Las ! mon angoisse est bien extresme,	Las! mon angoisse est bien extrême,
Je trouve tout a dire en moy,	Je trouve tout à dire en moi,
Je suis bien souvent en esmoy,	Je suis bien souvent en émoi,
Si c'est moy-mesme que moy-mesme.	Si c’est moi-même que moi-même.
A ce mal dont je suis frappé	À ce mal dont je suis frappé
Dont amour frappe nos courages,	Dont amour frappe nos courages,
Mais, amour, je suis bien trompé.	Mais, amour, je suis bien trompé.
Au prix d'un mal si furieux,	Au prix d’un mal si furieux,
J'aimerois cent mille fois mieux	J’aimerais cent mille fois mieux
Faire l'amour toute ma vie.	Faire l’amour toute ma vie.
