OUY, Sunnon, je le veux, je l’attens de ton zele,	Oui, Sunnon, je le veux, je l’attends de ton zèle,
Parle, trace à mes yeux la peinture fidelle	Parle, trace à mes yeux la peinture fidèle
Des ſentimens divers du Peuple & des Soldats.	Des sentiments divers du Peuple et des Soldats.
Seigneur.....	Seigneur…
Parle te dis-je, & ne me flatte pas.	Parle te dis-je, et ne me flatte pas.
Je ſçay que le traité que je viens de conclure	Je sais que le traité que je viens de conclure
De la plûpart des miens excite le murmure,	De la plupart des miens excite le murmure,
Que ne penêtrant point dans mes juſtes deſſeins	Que ne pénétrant point dans mes justes desseins,
On me voit à regret dans le Camp des Romains,	On me voit à regret dans le Camp des Romains,
Je le ſçay, dy le reſte, il ne me faut rien taire.	Je le sais, dis le reste, il ne me faut rien taire.
Puiſque vous m’ordonnez, Seigneur, d’eſtre ſincere,	Puisque vous m’ordonnez, Seigneur, d’être sincère,
Je ne vous cele point que de ce changement	Je ne vous cèle point que de ce changement
Les Peuples étonnez cherchent le fondement;	Les Peuples étonnés cherchent le fondement;
Quoy Segeſte, dit-on, par qui la Germanie	Quoi Ségeste, dit-on, par qui la Germanie
Juſqu’icy des Romains brava la tyrannie,	Jusqu’ici des Romains brava la tyrannie,
Qui de flots de leur ſang couvrit nos Champs vingt fois,	Qui de flots de leur sang couvrit nos Champs vingt fois,
Qui fit trembler le Tybre au bruit de ſes exploits,	Qui fit trembler le Tibre au bruit de ses exploits,
Ce Segeſte aujourd’huy peut étouffer ſa haine?	Ce Ségeste aujourd’hui peut étouffer sa haine?
Et mêler ſes Drapeaux avec l’Aigle Romaine?	Et mêler ses drapeaux avec l’Aigle Romaine?
Je fais plus. Du Senat je brigue la faveur,	Je fais plus. Du Sénat je brigue la faveur,
Son eſtime eſt pour moy le comble du bon-heur,	Son estime est pour moi le comble du bonheur,
Et c’eſt avec plaiſir que j’entens qu’il me nomme	Et c’est avec plaisir que j’entends qu’il me nomme
Allié de l’Empire, & Citoyen de Rome,	Allié de l’Empire, et Citoyen de Rome,
Je regarde ces noms comme un illuſtre prix:	Je regarde ces noms comme un illustre prix:
Toy même à ce diſcours tu me parois ſurpris!	Toi-même à ce discours tu me parais surpris!
Mais aprens les raiſons de ce qu’on m’a vû faire,	Mais apprends les raisons de ce qu’on m’a vu faire,
Et ne condamne plus une paix neceſſaire.	Et ne condamne plus une paix nécessaire.
Les Dieux me ſont témoins que dans tous mes deſſeins,	Les Dieux me sont témoins que dans tous mes desseins,
Me propoſant pour bût le ſalut des Germains	Me proposant pour but le salut des Germains
Sans regarder jamais ma grandeur ny ma gloire,	Sans regarder jamais ma grandeur ni ma gloire
J'ay combatu pour eux & cherché la victoire;	J’ai combattu pour eux et cherché la victoire;
Pendant plus de vingt ans par un heureux effort	Pendant plus de vingt ans par un heureux effort
Entre l’Empire & moy j'ay ſuſpendu le ſort;	Entre l’Empire et moi j’ai suspendu le sort;
Mais dans ce même temps Rome eſtoit occupée	Mais dans ce même temps Rome était occupée
A la perte d’Antoine ou du jeune Pompée,	À la perte d’Antoine et du jeune Pompée,
Et ſes Chefs diviſez par leurs propres fureurs	Et les Chefs divisés par leurs propres fureurs
Nous laiſſoient aiſément reculer nos mal-heurs,	Nous laissaient aisément reculer nos malheurs,
Maintenant que par tout regne une paix profonde	Maintenant que partout règne une paix profonde
Qu'Auguſte ſous ſes loix fait trembler tout le monde,	Qu’Auguste sous ses lois fait trembler tout le monde,
Devois-je attendre icy qu’il raſſemblât ſur nous	Devais-je attendre ici qu’il rassemblât sur nous
Tout l’effort, tous les traits de ſon vaſte courroux?	Tout l’effort, tous les traits de son vaste courroux?
J’ay cru devoir ceder, puiſqu’un leger hommage	J’ai cru devoir céder, puisqu’un léger hommage
M'aſſuroit le repos & détournoit l’orage,	M’assurait le repos et détournait l’orage,
Ce n’eſt pas que ſouvent un reſte de fierté	Ce n’est pas que souvent un reste de fierté
Ne m’ait preſque contraint de rompre le traité,	Ne m’ait presque contraint de rompre le traité,
Mais de mille Heros la perte encore éclate;	Mais de mille Héros la perte encore éclate;
Et qu’ont fait contre Rome Annibal, Mithridate,	Et qu’ont fait contre Rome, Annibal, Mithridate,
Nicomede, Pirrus, tant d’autres Rois fameux?	Nicomède, Pyrrhus, tant d’autres rois fameux?
Eſtois-je plus puiſſant? eſtois-je plus heureux!	Étais-je plus puissants? étais-je plus heureux!
J'ay ſauvé mes Etats en finiſſant la guerre,	J’ai sauvé mes États en finissant la guerre,
Et quand je me ſoûmets avec toute la terre,	Et quand je me soumets avec toute la terre,
J’obeïs aux decrets des Dieux & du deſtin	J’obéis aux décrets des Dieux et du destin
Qui veulent que tout cede à l’Empire Romain.	Qui veulent que tout cède à l’Empire Romain.
Je croy de cette Paix les cauſes legitimes;	Je crois de cette Paix les causes légitimes;
Des Princes vos voiſins vous ſuivez les maximes;	Des Princes vos voisins vous suivez les maximes;
Cependant ſi je puis en vous obeïſſant	Cependant si je puis en vous obéissant
Vous oppoſer, Seigneur, un interẽt puiſſant,	Vous opposer, Seigneur, un intérêt puissant,
J'oſeray dire encor qu’une immortelle gloire	J’oserai dire encore qu’une immortelle gloire
Auroit à l’avenir tranſmis vôtre memoire,	Aurait à l’avenir transmis votre mémoire,
Si voyant l’Univers par les Romains dompté	Si voyant l’Univers par les Romains dompté
Vous ſeul aviez joüy de vôtre liberté	Vous seul aviez joui de votre liberté
Pour abattre l’orgueil & le pouvoir de Rome,	Pour abattre l’orgueil et le pouvoir de Rome,
Peut être ne faut-il que le bras d’un ſeul homme?	Peut-être ne faut-il que le bras d’un seul homme?
Vous l’avez dit cent fois: Eh! qui pouvoir, Seigneur?	Vous l’avez dit cent fois: Eh! qui pouvait, Seigneur?
Prétendre mieux que vous à ce ſupréme honneur;	Prétendre mieux que vous à ce suprême honneur;
Rome s’aſſure en vain ſur la foy des Oracles,	Rome s’assure en vain sur la foi des Oracles,
Les Mortels quelquefois y mettent des obſtacles,	Les Mortels quelquefois y mettent des obstacles,
Ils relevent un trône, un Eſtat abatu,	Ils relèvent un trône, un État abattu,
Et font changer les Dieux à force de vertu.	Et font changer les Dieux à force de vertu.
Mais ſans déveloper un ſi profond miſtere;	Mais sans développer un si profond mystère;
Arminius croit-il ce traitté ſalutaire?	Arminius croit-il ce traité salutaire?
Vôtre amitié confond vos droits avec les ſiens,	Votre amitié confond vos droits avec les siens,
Vous l’allez confirmer par de plus forts liens,	Vous l’allez confirmer par de plus fort liens,
Bien-tôt en épouſant la Princeſſe Iſmenie	Bientôt en épousant la Princesse Isménie
Il verra ſa famille avec là vôtre unie,	Il verra sa famille avec la vôtre unie,
On dit que cét hymen ſi long-temps differé	On dit que cet hymen si longtemps différé
A ſon retour icy doit eſtre celebré,	À son retour ici doit être célébré,
Déja tous nos Soldats en preparent la feſte,	Déjà tous nos Soldats en préparent la fête,
Déja chacun s’attend.....	Déjà chacun s’attend…
C’eſt en vain qu’on l’apprête;	C’est en vain qu’on l’apprête;
Cependant garde-toy de parler déſormais	Cependant garde-toi de parler désormais
D’un hymen que les Dieux ont rompu pour jamais.	D’un hymen que les Dieux ont rompu pour jamais.
Ciel! qu’entens-je, Seigneur? qui peut être la cauſe?	Ciel! qu’entends-je, Seigneur? qui peut être la cause?
Un obſtacle invincible à cet hymen s’oppoſe,	Un obstacle invincible à cet hymen s’oppose,
Je le romps à regret; Je plains Arminius,	Je le romps à regret; Je plains Arminius,
Mais enfin j’ay promis Iſmenie à Varus,	Mais enfin j’ai promis Isménie à Varus,
Le rang de Gouverneur de ces vaſtes Provinces	Le rang de Gouverneur de ces vastes Provinces
Eſleve ce Romain au deſſus de nos Princes,	Élève ce Romain au-dessus de nos Princes,
Il adore ma fille, & ſon cœur amoureux	Il adore ma fille, et son cœur amoureux
Me preſſe chaque jour de les unir tous deux,	Me presse chaque jour de les unir tous deux,
Je m'y ſuis engagé, ma parole eſt donnée.	Je m’y suis engagé, ma parole est donnée.
A ce diſcours, mon ame interdite, étonnée,	À ce discours, mon âme interdite, étonnée,
De ſoupçons differens ſe laiſſant agiter,	De soupçons différents se laissant agiter,
Ne ſçait auquel, Seigneur, elle doit s'arrêter.	Ne sait auquel, Seigneur, elle doit s’arrêter.
Eh quoy! par vôtre choix, dés ſa tendre jeuneſſe	Eh quoi! par quel choix, de sa tendre jeunesse
Arminius receut la foy de la Princeſſe?	Aminius reçut la foi de la Princesse?
Il luy donna la ſienne? & juſques à ce jour	Il lui donna la sienne? et jusques à ce jour
Vous-même avez pris ſoin de nourrir leur amour?	Vous-même avez pris soin de nourrir leur amour?
De ce grand changement que faut-il que je penſe!	De ce grand changement que faut-il que je pense!
Croiray-je qu’oubliant une longue alliance,	Croirai-je qu’oubliant une longue alliance,
Par des conſeils flatteurs réglant tous vos deſſeins,	Pas des conseils flatteurs réglant tous vos desseins,
Vous ſacrifiez tout au pouvoir des Romains?	Vous sacrifiez tout au pouvoir des Romains?
Pardonnez-moy, Seigneur, mais Dieux que puis-je croire!	Pardonnez-moi, Seigneur, mais Dieux que puis-je croire!
Quel ſujet?....	Quel sujet?…
Ne croy rien de funeſte à ma gloire,	Ne crois rien de funeste à ma gloire,
Si j’étouffe ce feu que j’avois allumé,	Si j’étouffe ce feu que j’avais allumé,
Le ſeul Arminius en doit eſtre blâmé,	Le seul Arminius en doit être blâmé,
Juges-en. Au moment que l’ont m’eut fait entendre	Juges-en. Au moment que l’on m’eut fait entendre
Qu'aux faveurs de Ceſar j'avois droit de prétendre,	Qu’aux faveurs de César j’avais droit de prétendre,
Sans vouloir ſeparer nos communs interêts,	Sans vouloir séparer nos communs intérêts,
J'exigeay que ce Prince entrât dans cette paix;	J’exigeai que ce Prince entrât dans cette paix;
Je dépêchay vers luy; je crus qu’en diligence	Je dépêchai vers lui; Je crus qu’en diligence
Il viendroit confirmer cette auguſte alliance,	Il viendrait confirmer cette auguste alliance,
Il differa pourtant: Je preſſay; mais en vain,	Il différa pourtant: Je pressai; mais en vain,
J'ignore s’il revient, s’il s'arrête en chemin,	J’ignore s’il revient, s’il s’arrête en chemin,
Mais pendant quatre mois ſans daigner me répondre	Mais pendant quatre mois sans daigner me répondre
Par ſes retardemens je me ſuis veu confondre:	Par ses retardements je me suis vu confondre:
Les Romains me preſſoient, & j’étois menacé	Les Romains me pressaient, et j’étais menacé
De voir rompre ſans fruit le traitté commencé,	De voir rompre sans fruit le traité commencé,
Je l’ay conclu tout ſeul; & ma fille eſt le gage	Je l’ai conclu tout seul; et ma fille est le gage
Qui de cette union doit aſſurer l’ouvrage;	Qui de cette union doit rassurer l’ouvrage;
Le Prince m’a quitté, j’ay fait ma paix ſans luy,	Le Prince m’a quitté, j’ai fait ma paix sans lui,
Je ne m'en repens pas: on m’apprend aujourd’huy,	Je ne m’en repends pas; on m’apprend aujourd’hui,
Que dans tous nos Etats à ma honte il publie	Que dans tous nos États à ma honte il publie
Que je trahis mon ſang, mes amis, ma patrie;	Que je trahis mon sang, mes amis, ma patrie;
Que mandiant la paix les armes à la main,	Que mandant la paix les armes à la main,
Je vends la Germanie à l’Empereur Romain,	Je vends la Germanie à l’Empereur Romain,
Et je deviens ſuſpect par ce lâche artifice	Et je deviens suspect par ce lâche artifice
Aux peuples que mes ſoins ſauvent du précipice,	Aux peuples que mes soins sauvent du précipice,
Je ſuis même averty qu’il conſpire en ſecret,	Je suis même averti qu’il conspire en secret,
S’il arrive en ce Camp il ſe perd, c’en eſt fait,	S’il arrive en ce Camp il se perd, c’en est fait,
S’il trâme les projets que l’on m’a fait entendre	S’il trame les projets que l’on m’a fait entendre
De le faire punir, je ne puis me deffendre;	De le faire punir, je ne puis me défendre;
Je t’avoüeray bien plus. Je croy que ſans douleur	Je t’avouerai bien plus. Je crois que sans douleur
Je livrerois ce Prince à ſon dernier mal-heur,	Je livrerai ce Prince à son dernier malheur,
Sa fortune, ſon nom, la gloire de ſa vie,	Sa fortune, son nom, la gloire de sa vie,
Ont verſé dans mon cœur une ſecrete envie	Ont versé dans mon cœur une secrète envie
Qui me force à rougir de voir entre ſes mains	Qui me force à rougir de voir entre ses mains
Le pouvoir que j'avois jadis ſur les Germains.	Le pouvoir que j’avais jadis sur les Germains.
Cependant quel que ſoit l’interêt qui me preſſe,	Cependant quelque soit l’intérêt qui me presse,
Sa franchiſe, ſon rang, ſa vertu, ſa jeuneſſe,	Sa franchise, son rang, sa vertu, sa jeunesse,
Le ſoin de mon honneur, un reſte de pitié;	Le soin de son honneur, un reste de pitié;
Enfin, le ſouvenir d’une longue amitié	Enfin, le souvenir d’une longue amitié
Me porteroit peut-eſtre à prendre ſa deffence;	Me porterait peut-être à prendre sa défense;
Mais je crains des Romains la haine & la vangeance,	Mais je crains des Romains la haine et la vengeance.
Je voudrois que ce Prince inſpiré par les Dieux,	Je voudrais que ce Prince inspiré par les Dieux,
Bien loin de s’aprocher s’éloignât de ces lieux,	Bien loin de s’approcher s’éloignât de ces lieux,
Il n’a plus de ma part que des vœux a prétendre.	Il n’a plus de ma part que des vœux à prétendre.
Ah! Seigneur, ſur ſes jours voudroit-on entreprendre?	Ah! Seigneur, sur ses jours voudraient-on entreprendre?
Il ſe confie à vous, vous l’appellez, Eh quoy?	Il se confie à vous, vous l’appelez, Eh quoi?
Vous verroit-on pour luy violer vôtre foy?	Vous verrait-on pour lui violer votre foi?
Laiſſeriez-vous?.....	Laisseriez-vous?…
Varus dans ce Camp eſt le maître,	Varus dans ce Camp est le maître,
Arminius ſe perd, s’il oſe icy parêtre,	Aminius se perd, s’il ose ici paraître,
A moins que des Romains déſarmant le courroux,	À moins que les Romains désarmant le courroux,
Ce Prince ambitieux ne tombe à leurs genoux;	Ce Prince ambitieux ne tombe à leurs genoux;
Mais le ſoin de ſon ſort me cauſe peu de peine,	Mais le soin de son sort me cause peu de peine,
Ma fille ſeule, helas! m’inquiette & me gêne,	Ma fille seule, hélas! m’inquiète et me gêne,
Je viens de la mander, je l’attens en ces lieux,	Je viens de la mander, je l’attends en ces lieux,
Elle vient, laiſſez-nous, que luy diray-je? ô Dieux!	Elle vient, laissez-nous, que lui dirai-je? ô Dieux!
DE vôtre part, Seigneur, on eſt venu me dire	DE votre art, Seigneur, on est venu me dire
Que vous aviez icy quelque ordre à me preſcrire,	Que vous aviez ici quelque ordre à me prescrire,
J’ay d’abord vers ces lieux précipité mes pas,	J’ai d’abord vers ces lieux précipité mes pas,
Que voulez-vous Seigneur?	Que voulez-vous Seigneur?
Ce que je veux? helas!	Ce que je veux? hélas!
Que ne puis-je à jamais ma fille vous le taire.	Que ne puis-je à jamais ma fille vous le taire.
Vous ſoûpirez Seigneur, Ciel! quel eſt ce miſtere?	Vous soupirez Seigneur, Ciel! quel est ce mystère?
Dans de profonds chagrins vous me voyez plongé,	Dans de profonds chagrins vous me voyez plongé,
Et ce n'eſt que pour vous que je ſuis affligé.	Et ce n’est que pour vous que je suis affligé.
Pour moy grands Dieux! ſerois-je aſſez infortunée	Pour moi grands Dieux! serais-je assez infortunée
Pour troubler le bon-heur de vôtre deſtinée?	Pour troubler le bonheur de votre destinée?
Qu'ay-je pû faire helas! quel crime ay-je commis?	Qu’ai-je pu faire, hélas! Quel crime ai-je commis?
Je ne vous blâme point. Les deſtins ennemis	Je ne vous blâme point. Les destins ennemis
Vous demandent ma fille un cruel ſacrifice,	Vous demandent ma fille un cruel sacrifice,
Et de vôtre douleur me rendent le complice,	Et de votre douleur me rendent le complice,
Ils contraignent ma main de vous porter les coups.	Ils contraignent ma main de vous porter les coups.
Comment?	Comment?
Vous l'entendrez, ſur tout conſultez-vous;	Vous l'entendrez, surtout consultez-vous;
D'un effort vertueux vous croyez-vous capable?	D’un effort vertueux vous croyez-vous capable?
Sentez-vous vôtre cœur conſtant, inébranlable,	Sentez-vous cotre cœur constant, inébranlable,
Répondez-moy?	Répondez-moi?
Seigneur, s’il ne faut que mourir	Seigneur, s’il ne faut que mourir
Sans foibleſſe au trépas vous me verrez m’offrir,	Sans faiblesse au trépas vous me verrez m’offrir,
Vôtre fille en mourant aura ſoin de ſa gloire,	Votre fille en mourant aura soin de sa gloire,
Et ne laiſſera point une indigne memoire;	Et ne laissera point une indigne mémoire;
Expliquez-vous, le Ciel a-t’il juré ma mort?	Expliquez-vous, le ciel a-t-il juré ma mort?
Non, vos jours ne ſont point pourſuivis par le ſort,	Non, vos jours ne sont point poursuivis pas le sort,
Mais quand ſes dures loix vous auroient condamnée,	Mais quand ses dures lois vous auraient condamnée,
Croyez-vous que mon cœur vous eût abandonnée?	Croyez-vous que mon cœur vous eût abandonnée?
Quel eſt donc cét effort?	Que est donc cet effort?
Souvenez-vous au moins	Souvenez-vous au moins
Quels ont eſté pour vous mon amour & mes ſoins,	Quels ont été pour vous mon amour et mes soins,
Songez que de vos maux j'ay fremy par avance,	Songez que de vos maux j’ai frémi par avance,
Et que vous me devez entiere obeïſſance;	Et que vous me devez entière obéissance;
Je croy par ce diſcours vous devoir préparer	Je crois par ce discours vous devoir préparer
Au ſecret que je vais enfin vous déclarer;	Au secret que je vais enfin vous déclarer;
Dés vos plus jeunes ans vous eſperez ma fille,	Dès vos plus jeunes ans vous espérez ma fille,
De voir Arminius entrer dans ma famille;	De voir Arminius entrer dans ma famille;
Cependant à ce Prince il ne faut plus penſer.	Cependant à ce Prince il ne faut plus penser.
Ah! quel projet, Seigneur, venez-vous m’annoncer:	Ah! quel projet, Seigneur, venez-vous m’annoncer:
Dans quel temps?......	Dans quel temps?…
Je vous plains, comme vous je ſoûpire,	Je vous plains, comme vous je soupire,
Mais Rome le deffend, je ne puis l’en dédire,	Mais Rome le défend, je ne puis l’en dédire,
D’autres raiſons encor s’oppoſent à vos vœux,	D’autres raisons encore s’opposent à vos vœux,
Et me forcent de rompre un hymen mal-heureux.	Et me forcent de rompre un hymen malheureux.
De ce coup impreveû juſtement confonduë,	De ce coup imprévu justement confondue,
Dieux! quelle horreur je ſens dans mon ame éperduë;	Dieux! quelle horreur je sens dans mon âme éperdue;
Ah! Seigneur, pardonnez dans cette extremité	Ah! Seigneur pardonnez dans cette extrémité
Si j’oſe m’expliquer avec ſincerité,	Si j’ose m’exprimer avec sincérité,
Vôtre bonté pour moy banniſſant la contrainte	Votre bonté pour moi bannissant la contrainte
M'a permis de tout temps de vous parler ſans crainte,	M’a permis de tous temps de vous parler sans crainte,
Vous diſiez que le ſort n’attaquoit point mes jours?	Vous disiez que le sort n’attaquait point mes jours?
Eh cét Arreſt funeſte en termine le cours.	Eh cet Arrêt funeste en termine le cours.
Qu'entens-je! vous cedez à l’ardeur qui vous preſſe;	Qu’entends-je! Vous cédez à l’ardeur qui vous presse;
Ma fille s’abandonne à toute ſa foibleſſe;	Ma fille s’abandonne à toute sa faiblesse;
Quoy? loin de m’obeïr vôtre devoir trahy....	Quoi? Loin de m’obéir votre devoir trahi…
Eh! mon malheur ne vient que d’avoir obey;	Eh! mon malheur ne vient que d’avoir obéi;
Arminius courant de victoire en victoire	Aminius courant de victoire en victoire
En vain pour m’enflâmer faiſoit parler ſa gloire,	En vain pour s’enflammer faisait parler sa gloire,
Ses ſoins pour moy, ſes feux, & ſes heureux combats,	Ses soins pour moi, ses feux, et ses heureux combats,
Luy gagnoient mon eſtime, & ne m’engageoient pas;	Lui gagnaient mon estime, et ne m’engageaient pas;
Souvenez-vous, Seigneur, que vous vintes vous-même	Souvenez-vous, Seigneur, que vous vintes vous-même
Joindre à ſes vœux ardens vôtre pouvoir ſuprême,	Joindre à ses vœux ardents votre pouvoir suprême,
Et par les juſtes droits que vous avez ſur moy	Et par les justes droits que vous avez sur moi
A ce jeune Héros vous promîtes ma foy,	À ce jeune Héros vous promîtes ma foi,
J’obeïs ſans effort: cét ordre légitime	J’obéis sans effort: cet ordre légitime
Fit alors ſucceder la tendreſſe à l’eſtime;	Fit alors succéder la tendresse à l’estime;
Mais pourray-je étouffer, Seigneur, ſans déſeſpoir	Mais pourrai-je étouffer, Seigneur, sans désespoir
Des feux qu’ont allumé l’eſtime & le devoir?	Des feux qu’ont allumé l’estime et le devoir?
Recevez mieux des loix preſcrites par un Pere,	Recevez mieux des lois prescrites par un Père,
Et bien loin de fremir d’un effort neceſſaire,	Et bien loin de frémir d’un effort nécessaire,
Montrez.....	Montrez…
C’en eſt donc fait; & vous ne penſez plus	C’en est donc fait; et vous ne pensez plus
A vos engagemens avec Arminius,	À vos engagements avec Arminius,
Vous avez oublié qu’avec mon hymenée	Vous avez oublié qu’avec mon hyménée
A mon frere, ſa ſœur fur auſſi deſtinée;	À mon frère, sa sœur fut aussi destinée;
Des yeux de Polixene il a ſenty les coups,	Des yeux de Polixène il a senti les coups,
Elle vient en ces lieux le prendre pour époux,	Elle vient en ces lieux le prendre pour époux,
Verra-t’elle.....	Verra-t-elle…
Je ſçay que Sigiſmond l'adore;	Je sais que Sigismond l'adore;
Mais il faut qu’il immole un feu que Rome abhorre,	Mais il faut qu’il immole un feu que Rome abhorre,
Et mon fils par Ceſar fait Chevalier Romain	Et mon fils par César fait Chevalier Romain
Ne peut ſans ſon aveû diſpoſer de ſa main.	Ne peut sans son aveu disposer de sa main.
Mais ne penſons qu’à vous. Ce que je viens dedire	Mais ne pensons qu’à vous. Ce que je viens de dire
N’eſt pas la ſeule loy que je dois vous preſcrire,	N’est pas la seule loi que je vous dois prescrire,
Et vous devez encor....	Et vous devez encore…
Eh! que dois-je, Seigneur?	Eh! que dois-je, Seigneur?
Quoy ne ſuffit-il pas de bannir de mon cœur....	Quoi ne suffit-il pas de bannir de mon cœur…
Non, il ne ſuffit pas, & vous l’allez apprendre,	Non, il ne suffit pas, et vous l’allez apprendre,
C’eſt peu pour vous de rompre une union ſi tendre,	C’est peu pour vous de rompre une union si tendre,
Il faut encor ſentir en faveur de Varus	Il faut encore sentir en faveur de Varus
Tout ce que vôtre cœur ſent pour Arminius,	Tout ce que votre cœur sent pour Arminius,
Ce Romain deſormais ne ſonge qu’à vous plaire,	Ce Romain désormais ne songe qu’à vous plaire,
Voilà l’époux enfin que vous deſtine un pere,	Voilà l’époux enfin que vous destine un père,
Fuyez Arminius, & pour mieux m’obeïr	Fuyez Arminius, et pour mieux m’obéir
Portez-vous, s’il le faut, juſques à le haïr.	Portez-vous, s’il le faut, jusques à le haïr.
Je ne puis étouffer le trop juſte murmure	Je ne puis étouffer le trop juste murmure
Qui s’éleve en mon cœur contre une loy ſi dure,	Qui s’élève en mon cœur contre une loi si dure,
Quoy donc? vous pretendez forcer des ſentimens	Quoi donc? Vous prétendez forcer des sentiments
Qu’ont aſſuré vos ſoins, l’habitude & le temps,	Qu’ont assure vos soins, l’habitude et le temps,
Dés que j’ouvris les yeux vos diſcours, vôtre zele	Dès que j’ouvris les yeux vos discours, votre zèle
M'inſpirerent pour Rome une haine immortelle,	M’inspirèrent pour Rome une haine immortelle,
Et moy pour ſatisfaire à vos premiers deſſeins	Et moi pour satisfaire à vos premiers desseins
Aymant Arminius, j’ay haï les Romains.	Aimant Arminius j’ai haï les Romains.
Seigneur, c’eſt bien aſſez de contraindre mon ame	Seigneur, c’est bien assez de contraindre mon âme
De s'attacher ſans ceſſe à combattre ma flâme,	De s’attacher sans cesse à combattre ma flamme,
De perdre pour jamais un légitime eſpoir,	De perdre pour jamais un légitime espoir,
Que j'avois trop conçeu ſur la foy du devoir,	Que j’avais trop conçu sur la foi du devoir,
Daignez vous contenter de cette obeïſſance,	Daignez vous contenter de cette obéissance,
Ne forcez point mon cœur à plus de violence,	Ne forcez point mon cœur à plus de violence,
Et croyez que c’eſt trop de vouloir en un jour	Et croyez que c’est trop de vouloir en un jour
Changer l’amour en haine, & la haine en amour;	Changer l’amour en haine, et la haine en amour;
Pour vous faire obeïr à cette loy ſi dure	Pour vous faire obéir à cette loi si dure
D'un effort genereux vôtre vertu m’aſſure,	D’un effort généreux votre vertu m’assure,
Varus vient. Vous ſçavez quel eſt vôtre devoir,	Varus vient. Vous savez quel est votre devoir,
Préparez-vous, ma fille, à le bien recevoir.	Préparez-vous, ma fille, à le bien recevoir.
Quelle gêne?	Quelle gêne?
JE viens d’annoncer à ma fille	JE viens d’annoncer à ma fille
L’honneur dont vôtre amour veut combler ma famille;	L’honneur dont votre amour veut combler ma famille;
Seigneur, elle eſt toûjours prête à ſubir mes loix,	Seigneur, elle est toujours prête à subir mes lois,
Ses plus tendres deſirs ſe reglent par mon choix,	Ses plus tendres désirs se règlent par mon choix,
Vous pouvez ſans contrainte expliquer vôtre flâme,	Vous pouvez sans contrainte expliquer votre flamme,
Je vous laiſſe, Seigneur.	Je vous laisse, Seigneur.
VOus vous troublez, Madame;	VOus vous troublez, Madame;
Je connois les raiſons; on veut vous arracher	Je connais les raisons; on veut vous arracher
Un Amant dés l'enfance à vos deſirs ſi cher,	Un amant dès l’enfance à vos désirs si cher,
Un Amant ſi long-temps avoüé par un pere,	Un amant si longtemps avoué par un père,
Jeune, charmant, enfin trop digne de vous plaire,	Jeune charmant, enfin trop digne de vous plaire,
Mais c’eſt peu: l’on vous offre encore un autre époux	Mais c’est peu: l’on vous ôte encore un autre époux
Qu'un long âge a rendu moins aimable pour vous;	Qu’un long âge a rendu moins aimable pour vous;
Je ſeray le premier à me rendre juſtice,	Je serai le premier à me rendre justice,
Mes ſoûpirs ſont pour vous un triſte ſacrifice,	Mes soupirs sont pour vous un triste sacrifice,
Un Amant tel que moy ne doit point ſe flater,	Un Amant tel que moi ne doit point se flatter,
D'autres s’attacheroient à vous repreſenter;	D’autres s’attacheraient à vous représenter;
Traçant de leurs travaux une brillante hiſtoire,	Traçant de leurs travaux une brillante histoire,
Qu'un front ne vieillit point environné de gloire,	Qu’un front ne vieillit point environné de gloire,
Qu’un long amas d’honneur des exploits éclatans	Qu’un long amas d’honneur des exploits éclatants
Reparent quelquefois les injures des ans.	Réparent quelquefois les injures des ans.
Que c’eſt même à vos yeux un plus grand avantage,	Que c’est même à vos yeux un plus grand avantage,
De charger de vos fers un captif de mon âge,	De charger de vos fers un captif de mon âge,
Et d’embraſer un cœur, que les ans, la raiſon	Et d’embraser un cœur, que les ans, la raison
Sembloient devoir ſauver de ce fatal poiſon;	Semblaient devoir sauver de ce fatal poison;
Cependant aujourd’huy, je ne veux point, Madame,	Cependant aujourd’hui, je ne veux point, Madame,
Prêter auprés de vous ces ſecours à ma flâme;	Prêter auprès de vous ces secours à ma flamme;
Je ſçay que dans un cœur plein de ſa paſſion	Je sais que dans ce cœur plein de sa passion
De ſemblables diſcours font peu d’impreſſion	De semblables discours font peu d’impression
Mais je crois qu’à mes vœux vôtre ame inacceſſible	Mais je crois qu’à mes vœux votre âme inaccessible
Au bon-heur des Germains ſe montrera ſenſible,	Au bonheur des Germains se montrera sensible,
Que le juſte deſir d’aſſurer pour jamais	Que le juste désir d’assurer pour jamais
A vôtre pere, aux ſiens, l’abondance & la paix,	À votre père, aux siens, l’abondance et la paix,
A l'offre de ma main vous rendra moins contraire,	À l’offre de ma main vous rendra moins contraire,
C’eſt par là ſeulement que je pretens vous plaire,	C’est par là seulement que je prétends vous plaire,
Faites pour la Patrie en donnant vôtre foy,	Faites pour la patrie en donnant votre foi,
Ce que je n’oſe encor vous demander pour moy.	Ce que je n’ose encore vous demander pour moi.
Helas! puis-je Seigneur?	Hélas! puis-je, Seigneur?
Non, arrêtez, Madame,	Non, arrêtez, Madame,
Et ſuſpendez encor le deſtin de ma flâme,	Et suspendez encore le destin de ma flamme,
Avant que me l'apprendre, attendez pour le moins	Avant que me l’apprendre, attendez pour le moins
Que mes profonds reſpects, que le temps, que mes ſoins,	Que mes profonds respects, que le temps, que mes soins,
Que mes ſinceres vœux, mes ardens ſacrifices	Que mes sincères vœux, mes ardents sacrifices
Puiſſent de mon Rival balancer les ſervices;	Puissent de mon Rival balancer les services;
Sur tout ne craignez point que j’aille contre vous	Surtout ne craignez point que j’aille contre vous
Solliciter un Pere, allumer ſon courroux,	Solliciter un Père, allumer son courroux,
Je ne veux employer ſa puiſſance abſoluë	Je ne veux employer sa puissance absolue
Qu’à me faire accorder l’honneur de vôtre vûë,	Qu’à me faire accorder l’honneur de votre vue,
A prévenir vos vœux & vos moindres deſirs,	À prévenir vos vœux et vos moindres désirs,
Des graces de Ceſar j’ay comblé vôtre pere,	Des grâces de César j’ai comblé votre père,
Et des bienfaits nouveaux vont chercher vôtre frere,	Et des bienfaits nouveaux vont chercher votre frère,
Tout vous retracera mon amour, mes tranſports;	Tout vous retracera mon amour, mes transports;
Vous pourrez, ſur mon ſort vous expliquer alors,	Vous pourrez sur mon sort vous expliquer alors,
Adieu Madame.	Adieu Madame.
O Coup, ô diſgrace imprevûë,	Ô Coup, ô disgrâce imprévue,
Mal-heureuſe!	Malheureuse!
Quoy donc?	Quoi donc?
Ma mort eſt reſoluë,	Ma mort est résolue,
Mon Pere me condamne, il m’ôte Arminius,	Mon Père me condamne, il m’ôte Arminius,
Barſine, c’eſt vouloir que je ne vive plus.	Barsine, c’est vouloir que je ne vive plus.
Pere injuſte! pourquoy tyranniſer ma vie?	Père injuste! pourquoi tyranniser ma vie?
Puis-je aimer, ou haïr au gré de vôtre envie?	Puis-je aimer, ou haïr au gré de votre envie?
Ne concevez-vous point en m'impoſant ces loix	Ne concevez-vous point en m’imposant ces lois
Qu’un cœur comme le mien ne ſe rend qu’une fois?	Qu’un cœur comme le mien ne se rend qu’une fois?
Déplorables effets de l’amitié Romaine!	Déplorables effets de l’amitié Romaine!
Periſſe Rome, objet trop digne de ma haine:	Périsse Rome, objet trop digne de ma haine:
Toy, cher Arminius, qu'on arrache à ma foy	Toi, cher Arminius, qu’on arrache à ma foi,
Tu ſçais que je ne vis qu’autant que je te voy,	Tu sais que je ne vis qu’autant que je te vois,
Reçoy de mon amour mes jours que je t’immole;	Reçois de mon amour mes jours que je t’immole;
Mais fuy loin de ces lieux, écarte-toy, cours, vole;	Mais fuis loin de ces lieux, écarte toi, cours, vole;
Si toûjours à te voir j’ay borné mes ſouhaits,	Si toujours à te voir j’ai borné mes souhaits,
Maintenant je les borne à ne te voir jamais,	Maintenant je les borne à ne te voir jamais,
Viendrois-tu dans ce Camp pour ſervir de victime	Viendrais-tu dans ce Camp pour servir de victime
Au Rival odieux dont le pouvoir m’opprime?	Au Rival odieux dont le pouvoir m’opprime?
C’eſt le dernier mal-heur que j'aye à redouter,	C’est le dernier malheur que j’ai à redouter,
Courons, hazardons tout, afin de l’éviter,	Courons, hasardons tout, afin de l’éviter,
Faiſons partir vers luy quelque amy plein de zele.	Faisons partir vers lui quelque ami plein de zèle.
Vien Barſine....	Viens Barsine…
APprenez une heureuſe nouvelle,	APprenez une heureuse nouvelle,
Madame, Arminius va paroître à vos yeux,	Madame, Arminius va paraître à vos yeux,
Il vient en ce moment d’arriver en ces lieux,	Il vient en ce moment d’arriver en ces lieux,
Sigiſmond s’avançant dans la forêt prochaine	Sigismond s’avançant dans la forêt prochaine
Eſt allé hors du Camp recevoir Polixene;	Est allé hors du Camp recevoir Polixène;
Que le Prince ſon Frere à voulu devancer;	Que le Prince son Frère a voulu devancer;
J’ay crû que je devois venir vous l’annoncer,	J’ai cru que je devais venir vous l’annoncer,
Pour eftre le premier à vous marquer mon zele;	Pour être le premier à vous marquer mon zèle;
Madame, en d’autres lieux mon devoir me rappelle,	Madame, en d’autres lieux le devoir me rappelle,
J’y cours.	J’y cours.
QU’ay-je entendu? dans quel temps juſtes Dieux,	Qu’ai-je entendu? dans quels temps justes Dieux,
Allez vous preſenter mon Amant à mes yeux;	Allez vous présenter mon Amant à mes yeux;
Quels malheurs! quels combats! quel ſpectacle barbare	Quels malheurs! quels combats! quel spectacle barbare
Ce funeſte retour aujourd’huy me prépare?	Ce funeste retour aujourd’hui me prépare?
De quel œil ſe verront mon Pere & mon amant?	De quel œil se verront mon Père et mon amant?
Ah! pouvois-je prévoir cét affreux changement?	Ah! pouvais-je prévoir cet affreux changement?
Juſqu’icy les deſtins propices, & fidelles	Jusqu’ici les destins propices et fidèles
Marquoient tous mes momens par des faveurs nouvelles,	Marquaient tous mes moments par des faveurs nouvelles,
Mais dans un ſeul inſtant leurs tyranniques loix	Mais dans un seul instant leurs tyranniques lois
Ont fait tomber ſur moy tous les maux à la fois;	Ont fait tomber sur moi tous les maux à la fois;
Je reſſens en un jour plus d’ennuis, plus d’allarmes,	Je ressens en un jour plus d’ennuis, plus d’alarmes,
Qu'en dix ans de bon-heur je n’ay trouvé de charmes;	Qu’en dix ans de bonheur je n’ai trouvé de charmes;
C’en eſt trop, juſtes Dieux! & ſi vôtre rigueur	C’en est trop, justes Dieux! et si votre vigueur
Condamnoit les tranſports d’une innocente ardeur;	Condamnait les transports d’une innocente ardeur;
Si vous vouliez punir mon ame trop charmée	Si vous vouliez punir mon âme trop charmée
Des ſenſibles douceurs d’aimer & d’eſtre aimée,	Des sensibles douceurs d’aimer et d’être aimée,
Helas! pour me punir n’eſtoit-ce point aſſez	Hélas! pour me punir, n’était-ce point assez
D’égaler mes douleurs à mes plaiſirs paſſez?	D’égaler mes douleurs à mes plaisirs passés?
Ah! Madame eſperez....	Ah! Madame espérez…
Que veux-tu que j'eſpere?	Que veux-tu que j'espère?
Tu le vois mieux que moy, tout me devient contraire;	Tu le vois mieux que moi, tout me devient contraire;
Mais c’eſt trop m’attendrir, mes ſoûpirs & mespleurs	Mais c’est trop m’attendrir, mes soupirs et mes pleurs
M'arrêtent en ces lieux ſans parer mes malheurs;	M’arrêtent en ces lieux sans parer mes malheurs;
Courons donc à mon Frere apprendre ma diſgrace,	Courons donc à mon Frère apprendre ma disgrâce,
Il m’aime, un ſort pareil aujourd'huy le menace,	Il m’aime, un sort pareil aujourd’hui le menace,
Cherchons-le, puiſſions-nous accorder en ce jour	Cherchons-le, puissions-nous accorder en ce jour
Les devoirs oppoſez du ſang & de l’amour.	Les devoirs opposés du sang et de l’amour.
QUE fait Arminus, dy, l’as-tu veu, Barſine:	Que fait Arminius, dis, l’as-tu vu, Barsine:
Attendra-t’il icy le ſort qu’on luy deſtine?	Attendra-t-il ici le sort qu’on lui destine?
De ces lieux ennnemis ne veut-il point ſortir:	De ces lieux ennemis ne veut-il point sortir:
A s’éloigner, Madame, il ne peut conſentir,	À s’éloigner, Madame, il ne peut consentir,
En vain de vôtre part à vos ordres fidelles	En vain de votre part à vos ordres fidèles
J’ay peint vôtre douleur, vôtre crainte mortelle,	J’ai peint votre douleur, votre crainte mortelle,
En vain à ce Heros j’ay prédit, j'ay tracé	En vain à ce héros j’ai prédit, j’ai tracé
Les perils, les malheurs dont il eſt menacé,	Les périls, les malheurs dont il est menacé,
Conſtant dans ſes projets, & toûjours intrepide	Constant dans ses projets, et toujours intrépide
Il s’abandonne entier à l’amour qui le guide,	Il s’abandonne entier à l’amour qui le guide,
Et croit que de Segeſte ayant receu la foy	Et croit que de Ségeste ayant reçu la foi
Il peut paroître icy ſans danger, ſans effroy,	Il peut paraître ici sans danger, sans effroi,
Qu’on reſpecte toûjours même pendant la guerre,	Qu’on respecte toujours même pendant le guerre,
Ce fameux droit des gens ſaint par toute la terre;	Ce fameux droit des gens saint par toute le terre;
Mais à l’heureux Ceſar, dût-il eſtre immolé,	Mais à l’heureux César, dût-il être immolé,
Il ne veut point partir ſans vous avoir parlé.	Il ne veut point partir sans vous avoir parlé.
Helas! à quels tourmens, ſa fermeté m’expoſe?	Hélas! À quels tourments, sa fermeté m’expose?
Il perira, Barſine; & j’en ſeray la cauſe:	Il périra , Barsine; et j’en serai la cause:
Va, retourne vers luy, qu’il parte en ce moment,	Va, retourne vers lui, qu’il parte en ce moment,
Je le veux, je l’ordonne, & s’il m’aime ardemment,	Je le veux, je l’ordonne, et s’il m’aime ardemment,
De ſon amour pour moy la marque la plus chere	De son amour pour moi la marque la plus chère,
C’eſt de fuïr les Romains, & Varus, & mon Pere,	C’est de fuir les Romains, et Varus, et mon Père,
Qu’il re s’obſtine plus à demeurer icy,	Qu’il ne s’obstine pas à demeurer ici,
Cours, redouble tes pas....	Cours, redouble tes pas…
Madame le voicy.	Madame le voici.
MAdame, malgré vous, malgré vôtre défence,	MAdame, malgré vous, malgré votre défense,
J’oſe juſqu’en ces lieux chercher vôtre preſence,	J’ose jusqu’en ces lieux chercher votre présence,
Quand Segeſte s’obſtine à me manquer de foy,	Quand Ségeste s’obstine à me manquer de foi,
Je viens voir ſi ſa fille eſt plus juſte pour moy;	Je viens voir si sa fille est plus juste pour moi;
Enfin pour diſpoſer de ma funeſte vie	Enfin pour disposer de ma funeste vie
Je viens lire mon ſort dans les yeux d’Iſmenie	Je viens lire mon sort dans les yeux d’Isménie
S’ils peuvent ſans regret conſentir à me voir	S’ils peuvent sans regret consentir à me voir
Je n’abandonne point un legitime eſpoir,	Je n’abandonne point un légitime espoir,
S’ils daignent me montrer leur tendreſſe ordinaire,	S’ils daignent me montrer leur tendresse ordinaire,
En vain à mon amour tout le refte eſt contraire;	En vain à mon amour tout le reste est contraire;
Mais ſi d’intelligence avec mes ennemis	Mais si d’intelligence avec mes ennemis
Ils détruiſent l’eſpoir qu’ils m’ont toûjours permis,	Ils détruisent l’espoir qu’ils m’ont toujours permis,
Sans laiſſer aux Romains le ſoin de me pourſuivre	Sans laisser aux Romains le soin de me poursuivre
Madame, avec plaiſir je vay ceſſer de vivre.	Madame, avec plaisir je vais cesser de vivre.
Dans un temps moins cruel; vous le ſçavez Seigneur,	Dans un temps moins cruel; vous le savez Seigneur,
J’aurois à vous revoir borné tout mon bon-heur;	J’aurais à vous revoir borné tout mon bonheur;
Mais helas! la douceur d’une ſi chere veuë	Mais hélas! la douceur d’une si chère vue
Par une juſte crainte eſt icy ſuſpenduë,	Par une juste crainte est ici suspendue,
Je vous vois à regret dans ce Camp malheureux,	Je vous vois à regret dans ce Camp malheureux,
Où vous n’avez pour vous que mes timides vœux,	Où vous n’avez pour vous que mes timides vœux,
Où de voſtre Rival la puiſſance m’allarme,	Où de votre Rival la puissance m’alarme,
Où pour vous perdre, enfin, tout conſpire, tout s’arme,	Où pour vous perdre, enfin, tout conspire, tout s’arme,
Falloit-il dans ces lieux venir porter vos pas;	Fallait-il dans ces lieux venir porter vos pas;
Que venez-vous chercher?	Que venez-vous chercher?
Ne le ſçavez-vous pas?	Ne le savez-vous pas?
Abſent depuis ſix mois de tout ce que j’adore,	Absent depuis six mois de tout ce que j’adore,
Je ne pouvois ſans vous vivre un moment encore,	Je ne pouvais sans vous vivre un moment encore,
J’ay volé vers ce Camp plein d’amour, & d’eſpoirs:	J’ai volé vers ce Camp, plein d’amour et d’espoirs:
Eh qui jamais Madame auroit oſé prévoir	Eh qui jamais Madame aurait osé prévoir
Le funeſte deſſein qu'a formé voſtre Pere;	Le funeste dessein qu’a formé votre Père;
Je ſçavois qu’engagé dans un party contraire	Je savais qu’engagé dans un parti contraire
Ce Prince s’eſtoit joint avec mes ennemis;	Ce Prince s’était joint avec mes ennemis;
Mais devois-je penſer qu’indignement ſoûmis	Mais devais-je penser qu’indignement soumis
Il n’eût point conſervé des droits ſur une Armée	Il n’eût point conservé des droits sur une Armée
A vaincre les Romains long-temps accoutumée;	À vaincre les Romains longtemps accoutumée;
Qu’il reconnût icy Varus pour Souverain,	Qu’il reconnut ici Varus pour Souverain,
Et voulût vous forcer de luy donner la main?	Et voulut vous forcer de lui donner la main?
Pouvois-je ſoupçonner....	Pouvais-je soupçonner…
Oûy vous deviez tout croire	Oui vous deviez tout croire
Des fureurs des Romains jaloux de vôtre gloire,	Des fureurs des Romains jaloux de votre gloire,
Et ne deviez-vous pas ſur tout vous défier	Et ne deviez-vous pas surtout vous défier
D’un Prince qui de Rome a voulu s’appuyer;	D’un Prince qui de Rome a voulu s’appuyer;
Falloit-il s'expoſer à la pourſuite injuſte.....	Fallait-il s’exposer à la poursuite injuste…
Eh Madame l’amour raiſonne-t-il ſi juſte;	Eh Madame l’amour raisonne-t-il si juste;
J’eſperois, & j'eſpere encore en ce moment	J’espérais, et j’espère encore en ce moment
De ramener Segeſte à ſon premier ſerment;	De ramener Ségeste à son premier serment;
Vous le voyez, ce Prince évite mes aproches,	Vous le voyez, ce Prince évite mes approches,
Il ne ſoûtiendra point ma veuë, & mes reproches,	Il ne soutiendra point ma vue et mes reproches,
Raſſurons-nous: bien-tôt par un effort heureux.	Rassurons-nous: bientôt par un effort heureux.
Helas! Seigneur, ceſſons de nous tromper tous deux,	Hélas! Seigneur, cessons de nous tromper tous deux,
En vain vous vous flattez de regagner mon Pere;	En vain vous vous flattez de regagnez mon Père;
Mais quand il changeroit, que prétendez-vous faire?	Mais quand il changerait, que prétendez-vous faire?
Seuls contre les Romains armez contre vos jours;	Seul contre les Romains armés contre vos jours;
Sans forces, ſans ſoldats.....	Sans forces, sans soldats…
Nous aurons du ſecours.	Nous aurons du secours.
Oüy Madame, aprenez que toute mon armée	Oui Madame, apprenez que toute mon armée
Dans les bois de Teutberg par mon ordre enfermée,	Dans les bois de Teutberg par mon ordre enfermée,
Prête à tout entreprendre en ce même moment,	Prête à tout entreprendre en ce même moment,
N’attend que ma preſence & mon commandement;	N’attends que ma présence et mon commandement;
En divers petits corps ces troupes diviſées	En divers petits corps ces troupes divisées
Ont fait dans nos Etats cent marches oppoſées,	Ont fait dans nos États cent marches opposés,
Et paſſant par des lieux inconnus aux Romains	Et passant par des lieux inconnus aux Romains
Dans les eaux, dans les bois, ſe traçant des chemins	Dans les eaux, dans les bois, se traçant des chemins
Aprés trois mois de ſoins, de perils, & de peines,	Après trois mois de soins, de périls et de peines,
Se ſont jointes enfin dans les forêts prochaines.	Se sont jointes enfin dans les forêts prochaines.
Madame, tout eſt prêt à marcher ſous ma loy,	Madame, tout est prêt à marcher sous ma loi,
Vôtre frere conſpire & s’unit avec moy,	Votre frère conspire, et s’unit avec moi,
Je viens de luy parler: il ne voit qu’avec peine	Je viens de lui parler: il ne voit qu’avec peine
Segeſte adorateur de la grandeur Romaine,	Ségeste adorateur de la grandeur Romaine,
Et ne peut endurer qu’un ordre rigoureux	Et ne peut endurer qu’un ordre rigoureux
Refuſe Polixene à ſon cœur amoureux,	Refuse Polixène à son cœur amoureux,
Un interẽt commun dans mes deſſeins l’engage.	Un intérêt commun dans mes desseins l’engage.
Et nous allons tous deux....	Et nous allons tous deux…
Ah! quittez ce langage,	Ah! quittez ce langage,
Un ſeul mot peut vous perdre, & ces funeſteslieux	Un seul mot peut vous perdre, et ces funestes lieux
Pour obſerver vos pas ont peut-être des yeux,	Pour observer vos pas ont peut-être des yeux,
Ne vous aſſurez point ſur vôtre rang ſuprême,	Ne vous assurez point sur votre rang suprême,
Segeſte prévenu, Seigneur, n’eſt plus le même,	Ségeste prévenu, Seigneur, n’est plus le même,
Il ne connoît que Rome, & les droits les plus ſaints	Il ne connaît que Rome, et les droits les plus saints
Contre elle dans ſon cœur n’ont que des titres vains;	Contre elle dans son cœur n’ont que des titres vains;
Cher Prince, épargnez-moy les tourmens que j’endure,	Cher Prince, épargnez-moi les tourments que j’endure,
Fuyez ce Camp fatal; l’amour vous en conjure,	Fuyez ce Camp fatal; l’amour vous y conjure,
Le plaiſir que je ſens tandis que je vous voy,	Le plaisir que je sens tandis que je vous vois,
Cede à vôtre peril qui me glace d’effroy;	Cède à votre péril qui me glace d’effroi;
Partez, je vous l’ordonne, & ne puis m’en deffendre.	Partez, je vous l’ordonne, et ne puis m’en défendre.
Les larmes que m'arrache un interêt ſi tendre	Les larmes que m’arrache un intérêt si tendre
Prince, tant de ſoûpirs ne vous font que trop voir	Prince, tant de soupirs ne vous font que trop voir
Que vôtre cœur faiſoit ma joye & mon eſpoir,	Que votre cœur faisait ma joie et mon espoir,
Et je vous perds? auſſi dans ma douleur profonde	Et je vous perds? aussi dans ma douleur profonde
Je ne compte pour rien tout le reſte du monde,	Je ne compte pour rien tout le reste du monde,
Tout eſt perdu pour moy. Si pourtant deſormais	Tout est perdu pour moi. Si pourtant désormais
Je puis juſqu’à la mort former quelques ſouhais,	Je puis jusqu’à la mort former quelque souhait,
Je demande à l’amour qu’il conſerve en vôtre ame	Je demande à l’amour qu’il conserve en votre âme
L’éternel ſouvenir du feu qui nous enflame,	L’éternel souvenir du feu qui vous enflamme,
Que tandis que je vais vous tout ſacrifier,	Que tandis que je vais vous tout sacrifier,
Il vous empêche au moins, Prince, de m’oublier,	Il vous empêche au moins, Prince, de m’oublier,
Non juſqu’à vous cauſer un ſupplice trop rude,	Non jusqu’à vous causer un supplice trop rude,
C’eſt aller qu’il vous donne un peu d’inquietude;	C’est assez qu’il vous donne un peu d’inquiétude;
Helas! ce n’eſt pas trop, allez, quittez ces lieux;	Hélas! ce n’est pas trop, allez, quittez ces lieux;
Dans ce dernier ſoûpir, recevez mes adieux.	Dans ce dernier soupir, recevez mes adieux.
Non, je ne reçois point un adieu ſi funeſte,	Non, je ne reçois point un adieu si funeste,
S’il faut, vous perdre helas! que m'importe du reſte?	S’il faut, vous perdre hélas! que m’importe du reste?
Madame, quelque ſort qui me ſoit préparé	Madame, quelque sort qui me soit préparé
Je dois l’attendre icy d’un viſage aſſuré.	Je dois l’attendre ici d’un visage assuré.
Voulez-vous que montrant une indigne foibleſſe	Voulez-vous que montrant une indigne faiblesse
J’aille loin de vos yeux expirer de triſteſſe?	J’aille loin de vos yeux expirer de tristesse?
Vous livrer à Varus; ah! s’il me faut mourir	Vous livrer à Varus; ah! s’il me faut mourir
Que ce ſoit pour la gloire & pour vous conquerir,	Que ce soit pour la gloire et pour vous conquérir,
Quel ordre; quel départ: Dieux quand je l’enviſage,	Quel ordre; quel départ: Dieux quand je l’envisage,
Je fremis, & je ſens chanceler mon courage;	Je frémis, et je sens chanceler mon courage;
Quoy! j’irois pour ſauver de miſerables jours	Quoi! j’irais pour sauver de misérables jours
Dont ma douleur bien-tôt auroit tranché le cours,	Dont ma douleur bientôt aurait tranché le cours,
Errer deſeſperé de contrée en contrée,	Errer désespéré de contrée en contrée,
Et portant dans mon cœur vôtre image adorée	Et portant dans mon cœur votre image adorée
Sans ceſſe devoré d’inutiles ſouhaits	Sans cesse dévoré d’inutiles souhaits
Vous chercher en tous lieux, & ne vous voir jamais;	Vous chercher en tous lieux, et ne vous voir jamais;
Quoy j’irois loin de vous languir ſans eſperance:	Quoi j’irais loin de vous languir sans espérance:
Sans trouver un moment d’intervalle à l'abſence;	Sans trouver un moment d’intervalle à l’absence;
Tandis que mon Rival content, favoriſé	Tandis que mon Rival content, favorisé
Joüiroit du bon-heur qu’on m’auroit refuſé?	Jouirait du bonheur qu’on m’aurait refusé?
M’en preſerve le Ciel; qu'icy plûtôt je meure;	M’en préserve le ciel; qu’ici plutôt je meure;
Vivre dans ces horreurs c’eſt mourir à toute heure,	Vivre dans ces horreurs c’est mourir à toute heure,
Vous le connoiſſez trop retenez donc vos pleurs,	Vous le connaissez trop retenez donc vos pleurs,
Epargnons-nous tous deux d’inutiles douleurs,	Épargnons-nous tous deux d’inutiles douleurs,
Laiſſez-moy voir Segeſte, il doit icy ſe rendre,	Laissez-moi voir Ségeste, il doit ici se rendre,
Je vay frapper ſon cœur par l’endroit le plus tendre,	Je vais frapper son cœur par l’endroit le plus tendre,
Je vay l’encourager, rappeller à ſes yeux	Je vais l’encourager, rappeler à ses yeux
Sa parole, ſon ſang, ſes exploits glorieux,	Sa parole, son sang, ses exploits glorieux,
Il ſe rendra peut-eſtre, & me fera juſtice;	Il se rendra peut-être, et me fera justice;
Mais dût-il de mon ſang hâter le ſacrifice;	Mais dut-il de mon sang hâter le sacrifice;
Fidele à mon amour, fidele à mon païs,	Fidèle à mon amour, fidèle à mon pays,
L’un & l’autre par moy ne ſeront point trahis.	L’un et l’autre par moi ne seront pas trahis.
Que Segeſte en fureur s’arme contre ma vie;	Que Ségeste en fureur s’arme contre ma vie;
Je n’aime fortement que vous, & ma Patrie	Je n’aime fortement que vous, et ma Patrie
J’en atteſte les Dieux: le coup me ſera doux	J’en atteste les Dieux: le coup me sera doux
Qui me fera perir & pour elle, & pour vous.	Qui me fera périr et pour elle et pour vous.
Helas! ah quels mal-heurs... mais j’apperçois mon Pere,	Hélas! ah quels malheurs… mais j’aperçois mon Père,
Ah! Prince gardez-vous d’allumer ſa colere,	Ah! Prince gardez-vous d’allumer sa colère,
Sur tout ſouvenez-vous durant vôtre entretien	Surtout souvenez-vous durant votre entretien
Qu'aujourd’uy vôtre ſort décidera du mien,	Qu’aujourd’hui votre sort décidera du mien.
Adieu.	Adieu.
Fais-moy fléchir ce courage barbare,	Fais-moi fléchir ce courage barbare,
O Ciel!	Ô Ciel!
A M’obeïr Gardes qu’on ſe prépare,	À M’obéir Gardes qu'on se prépare,
Executez mon ordre, & ne balancez pas;	Exécuter mon ordre et ne balancez pas;
Cependant laiſſez-moy, ne ſuivez point mes pas.	Cependant laissez-moi, ne suivez point mes pas.
ENfin je vous rejoins aprés ſix mois d’abſence,	ENfin je vous rejoins après six mois d’absence,
Seigneur, le ſort répond à mon impatience,	Seigneur, le sort répond à mon impatience,
Je n’avois pas penſé que juſques à ce jour	Je n’avais pas pensé que jusques à ce jour
Il dût auprés de vous reculer mon retour;	Il dût auprès de vous reculer mon retour;
Mais depuis ces forẽts ou l’Elbe prend ſa ſource,	Mais depuis ces forêts où l’Elbe prend sa source,
Tant d’obſtacles divers ont retardé ma courſe,	Tant d’obstacles divers ont retardé ma course,
Que malgré mes efforts & mon empreſſement	Que malgré mes efforts et mon empressement
Je n’ay pû l’avancer, Seigneur, d’un ſeul moment.	Je n’ai pu l’avancer, Seigneur, d’un seul moment.
Seigneur, de vos deſſeins vous ſeul eſtes le maître,	Seigneur, de vos desseins vous seul êtes le maître,
Et pour vos interêts vous avez crû peut-être	Et pour vos intérêts vous avez cru peut-être
Qu'il falloit negliger mes utiles avis,	Qu’il fallait négliger mes utiles avis,
Mais tout autre que vous les auroit mieux ſuivis,	Mais tout autre que vous les aurait mieux suivis,
Je n’examine point quelle raiſon puiſſante	Je n’examine point quelle raison puissante
Vous a fait refuſer une paix importante;	Vous a fait refuser une paix importante;
Cependant je l’avoüe, aprés vos longs refus	Cependant je l’avoue, après vos longs refus
Segeſte dans ce Camp ne vous attendoit plus.	Ségeste dans ce Camp ne vous attendais plus.
Vous ne m’attendiez plus; O Ciel pouviez-vous croire	Vous ne m’attendiez plus; Ô ciel Pouviez-vous croire
Qu'un ſerment ſolemnel ſortit de ma memoire,	Qu’un serment solennel sortit de ma mémoire,
Que je puiſſe le rompre & vous manquer de foy;	Que je puisse le rompre et vous manquer de foi;
Mais vous, juſtifiez l'état où je vous voy;	Mais vous, justifiez l’état où je vous vois;
Quel vous laiſſay-je helas! quel aujourd'hui vous eſtés;	Quel vous laissai-je hélas! quel aujourd’hui vous êtes;
Ma raiſon ſe confond à voir ce que vous faites,	Ma raison se confond à voir ce que vous faites,
Segeſte, ce Heros que nous admirions tous,	Ségeste, ce Héros que nous admirons tous,
Dont la valeur, le nom, faiſoit tant de jaloux,	Dont la valeur, le nom, faisait tant de jaloux,
Vient de ternir l’éclat de ces lauriers illuſtres	Vient de ternir l’éclat de ces lauriers illustres
Qu’il avoit moiſſonnez pendant plus de ſix luſtres,	Qu’il avait moissonnés pendant plus de six lustres,
Vit-on jamais grands Dieux! un ſemblable retour;	Vit-on jamais grand Dieux! un semblable retour;
Et nos neveux Seigneur le croiront-ils un jour.	Et nos neveux Seigneur le croiront-ils un jour.
De tout ce que j'ay fait j’ay peſé l’importance	De tout ce que j’ai fait j’ai pesé l’importance
Seigneur, & j’ay ſuivy les loix de la prudence,	Seigneur, et j’ai suivi les lois de la prudence,
Ce ſont des changemens où les Princes, les Rois	Ce sont des changements où les princes, les Rois
Se portent par raiſon plûtoſt que par leur choix;	Se portent par raison plutôt que par leur choix;
Ils conſiderent peu quel ſerment les engage,	Ils considèrent peu quel serment les engage,
Ils conſultent leur foy moins que leur avantage,	Ils consultent leur foi moins que leur avantage,
Et reglant leur parole aux caprices du ſort	Et réglant leur parole aux caprices du sort
Fléchiſſent ſous les loix qu’impoſe le plus fort,	Fléchissent sous les lois qu’impose le plus fort,
Ces maximes d’Etat n’ont rien qui deshonore,	Ces maximes d’État n’ont rien qui déshonore,
Et ſi vous l’ignorez, vous eſtes jeune encore,	Et si vous l’ignorez, vous êtes jeune encore,
Vous l’aprendrez, Seigneur, & peut-eſtre qu’un jour	Vous l’apprendrez, Seigneur, et peut-être qu’un jour
Vous vous en ſervirez vous-meſme à voſtre tour.	Vous vous en servirez vous-même à votre tour.
Ah! pour me détourner de ce funeſte exemple,	Ah! pour me détourner de ce funeste exemple,
Il ſuffit qu’aujourd’huy, Seigneur, je vous contemple;	Il suffit qu’aujourd’hui, Seigneur, je vous contemple;
Où ſont tous vos emplois, voſtre Cour, vos grandeurs?	Où sont tous vos emplois, votre Cour, vos grandeurs?
On vous commande icy, vous commandiez ailleurs,	On vous commande ici, vous commandez ailleurs,
Vous faiſiez le deſtin de toutes nos Provinces,	Vous faisiez le destin de toutes nos Province,
Vous ſerviez de modele à nos Chefs, à nos Princes,	Vous serviez de modèle à nos Chefs, à nos Princes,
Vous eſtiez aimé, craint, renommé, ſouverain,	Vous étiez aimé, craint, renommé, souverain,
Vous n’eſtes aujourd’huy qu’un citoyen Romain,	Vous n’êtes aujourd’hui qu’un citoyen Romain,
Et vous ſacrifiez à ce titre ſans gloire	Et vous sacrifiez à ce titre sans gloire
Ces noms toûjours ſuivis d’une longue memoire.	Ces noms toujours suivis d’une longue mémoire.
Et cét abaiſſement doit me combler d’honneur;	Et cet abaissement doit me combler d’honneur;
Tous ces noms éclatans ne flatent point mon cœur,	Tous ces noms éclatants ne flattent point mon cœur,
Ma puiſſance me gêne, & ceſſe de me plaire	Ma puissance me gêne, et cesse de me plaire
Lors que de mes ſujets elle fait la miſere,	Lorsque de mes sujets elle fait la misère,
Et pour leur aſſurer un ſort, des jours heureux	Et pour leur assurer un sort, des jours heureux
S’embraſſe leur deſtin, & ſuis ſujet comme eux;	J’embrasse leur destin, et suis sujet comme eux;
Voila ce qu’on appelle amour de la Patrie,	Voilà ce qu’on appelle amour de la Patrie,
Et non de vos pareils l’indiſcrette furie,	Et non de vos pareils l’indiscrète furie,
Vous ſacrifiez tout au ſoin de voſtre rang,	Vous sacrifiez tout au soin de votre rang,
Des peuples mal-heureux vous prodiguez le ſang,	Des peuples malheureux vous prodiguez le sang,
Et voſtre ambition d’un faux zele animée	Et votre ambition d’une faux zèle animée
Acheté de leur vie un peu de renommée.	Achète de leur vie un peu de renommée.
Quel bon-heur dans la guerre ont trouvé nos Etats?	Quel bonheur dans la guerre ont trouvé nos États?
Dequoy leur ont ſervy nos ſieges, nos combats?	De quoi leur ont servi nos sièges, nos combats?
Ah! j’ay donné cent fois des larmes à nos pertes,	Ah! j’ai donné cent fois des larmes à nos pertes,
Les Temples ruinez, les Provinces deſertes,	Les Temples ruinés, les Provinces désertes,
Les Princes moiſſonnez à la fleur de leurs ans,	Les Princes moissonnés à la fleur de leurs ans,
Les maſſacres cruels des Femmes, des Enfans,	Les massacres cruels des Femmes, des Enfants,
Les campagnes par tout languiſſantes, ſteriles,	Les campagnes partout languissantes, stériles,
La faim, les fers, la mort, le pillage des Villes,	La faim, les fers, la mort, le pillage des Villes,
Ce ſont là les effets par la guerre produits,	Ce sont là les effets par la guerre produits,
Et de voſtre fierté les déplorables fruits;	Et de votre fierté les déplorables fruits;
Les Peuples cependant ne reſpirent qu’à peine,	Les Peuples cependant ne respirent qu’à peine,
Et voſtre amour pour eux eſt ſemblable à la haine,	Et votre amour pour eux est semblable à la haine,
Pour moy je ne veux plus de victoire à ce prix,	Pour moi je ne veux plus de victoire à ce prix,
Je préfere la paix à ces triſtes débris;	Je préfère la paix à ces tristes débris;
La paix rend un Etat floriſſant, riche, illuſtre,	La paix rend un État florissant, riche, illustre,
La victoire avec ſoy ne porte qu’un faux luſtre,	La victoire avec foi ne porte qu’un faux lustre,
Malgré l'éclat trompeur qui flatte les guerriers	Malgré l’éclat trompeur qui flatte les guerriers
Elle les fait gemir ſous leurs propres lauriers;	Elle les fait gémir sous leurs propres lauriers;
Icy le frere en pleurs redemande ſon frere,	Ici le frère en pleurs redemande son frère,
Là le Pere ſon fils, icy le fils ſon Pere,	Là le père son fils, ici le fils son Père,
Et dans le Camp vainqueur il eſt ſouvent douteux	Et dans le Camp vainqueur il est souvent douteux
Lequel des deux partis eſt le plus mal-heureux.	Lequel des deux partis est le plus malheureux.
Oüy, Seigneur, j'avoüeray que ſouvent la victoire	Oui, Seigneur, j’avouerai que souvent la victoire
Nous vend cher ſes faveurs, empoiſonne ſa gloire,	Nous vend cher ses faveurs, empoisonne sa gloire,
Que la Paix a des biens plus ſolides, plus doux.	Que la Paix a des biens plus solides, plus doux.
Je l’aurois recherchée, enfin autant que vous	Je l’aurais recherchée, enfin autant que vous
Avec un ennemy moins fier & moins terrible;	Avec un ennemi moins fier et moins terrible;
Mais la paix avec Rome eſt un joug infaillible,	Mais la paix avec Rome est un joug infaillible,
Et ſous les noms flatteurs d’amis, ou d’alliez,	Et sous les noms flatteurs d’amis, ou d’alliés,
Elle aſſervit les Rois, & les foule à ſes pieds.	Elle asservit les Rois, et les foule à ses pieds.
Du moment qu’avec elle un traitté nous engage,	Du moment qu’avec elle un traité nous engage,
Nos enfans dans ſes murs envoyez en ôtage,	Nos enfants dans ses murs envoyés en otage,
Et dés leurs jeunes ans arrachez de nos bras	Et dès leurs jeunes ans arrachés de vos bras
Contre tous ſes ſoupçons ne la raſſurent pas;	Contre tous ses soupçons ne la rassurent pas;
Sur le moindre projet de quelqu’autre alliance,	Sur le moindre projet de quelqu’autre alliance,
Ne voit-on pas ſur nous tomber ſa défiance;	Ne voit-on pas sur nous tomber sa défiance;
Avant que rien reſoudre il faut prendre ſa voix,	Avant que rien résoudre il faut prévoir sa voix,
Et juſqu’à noſtre Hymen tout dépend de ſon choix,	Et jusqu’à notre Hymen tout dépend de son choix,
Mais c’eſt peu. De nos jours arbitre ſouveraine	Mais c’est peu. De nos jours arbitre souveraine
Lors qu'elle nous proſcrit, noſtre perte eſt certaine,	Lorsqu’elle nous proscrit notre perte est certaine,
Son Barbare Senat ſans foy, ſans amitié,	Son barbare Sénat sans foi, sans amitié,
Jamais pour nos pareils n’a montré de pitié;	Jamais pour nos pareils n’a montré de pitié;
Des Princes qu'elle craint la plus legere offence	Des Princes qu’elle craint la plus légère offense
Attire ſans retour les traits de ſa vangeance,	Attire sans retour les traits de sa vengeance,
Et ſa fauſſe clemence en de grands attentats	Et sa fausse clémence en de grands attentats
Fait gloire d’épargner ceux qu’elle ne craint pas.	Fait gloire d’épargner ceux qu’elle ne craint pas.
Ah! la Paix ſous ſes loix eſt un bon-heur funeſte,	Ah! la Paix sous ses lois est un bonheur funeste,
Elle me fait horreur, le Peuple la deteſte,	Elle me fait horreur, le Peuple la déteste,
Les Germains des tréſors fuyant la vanité	Les Germains des trésors fuyant la vanité
Sont trop riches, Seigneur, avec la liberté,	Sont trop riches, Seigneur, avec la liberté,
Pour ſe la conſerver & tout ſexe, & tout âge,	Pour se la conserver et tout sexe, et tout âge,
De tout temps parmy nous a prouvé ſon courage,	De tous temps parmi nous nous a prouvé son courage,
Les femmes dans les Camps auprés de leurs Epoux	Les femmes dans les Camps auprès de leurs Époux
Mépriſent les dangers, & s'expoſent aux coups,	Méprisent les dangers, et s’exposent aux coups,
Sans foibleſſe, ſans art, ſans parure éclatante,	Sans faiblesse, sans art, sans parure éclatante,
Leur pompe eſt leur vertu, leur Palais une Tente,	Leur pompe est leur vertu, leur Palais une Tente,
Leurs fils dans le travail, dans la guerre formez	Leurs fils dans le travail, dans la guerre formés
Dés le flanc de leur Mere y ſont accoûtumez,	Dès le flanc de leur mère y sont accoutumés,
Ces Enfans nez guerriers au milieu des allarmes	Ces enfants nés guerriers au milieu des alarmes
A peine ouvrẽt les yeux qu’ils demandẽt des Armes,	À peine ouvrent les yeux qu’ils demandent des Armes,
Ils en font tous leurs jeux. Ah! pouvez-vous, Seigneur,	Ils en font tous leurs jeux. Ah! pouvez-vous, Seigneur,
Sous un joug odieux enchaîner leur valeur.	Sous un joug odieux enchaîner leur valeur.
Eh! qu’a-t’il d’odieux, ce joug où je l’enchaîne?	Eh! qu’a-t-il d’odieux, ce joug où je l’enchaîne?
Rome n’a plus pour nous de mépris, ny de haine,	Rome n’a plus pour nous de mépris ni de haine.
Elle nous traite en fils, & ne diſtingue plus	Elle nous traite en fils, et ne distingue plus
Nos peuples & les ſiens unis & confondus,	Nos peuples et les siens unis et confondus,
Elle regle nos mœurs, ſa prudence en ſepare	Elle règle nos mœurs, sa prudence en sépare
Ce qu’elles ont d’affreux, de rude, & de barbare,	Ce qu’elles ont d’affreux, de rude et de barbare,
Elle enſeigne à cherir, à reſpecter les loix,	Elle enseigne à chérir, à respecter les lois,
A faire des vertus le veritable choix,	À faire des vertus le véritable choix,
Elle épanche pour nous ces treſors que la guerre	Elle épanche pour nous ces trésors que la guerre
A portez dans ſon ſein des deux bouts de la terre,	A portés dans son sein des deux bouts de la terre,
Ses bontez envers nous éclatent chaque jour,	Ses bontés envers nous éclatent chaque jour,
Et nous n’en recevons que des marques d’amour.	Et nous n’en recevons que des marques d’amour.
Eh quoy! vous rendez-vous à ces fauſſes tendreſſes;	Eh quoi! vous rendez-vous à ces fausses tendresses;
Voyez, voyez les fers cachez ſous ces careſſes,	Voyez, voyez les fers cachés sous ces caresses,
Pour impoſer le joug au grand cour des Germains	Pour imposer un joug au grand cœur des Germains
Rome change à preſent de route & de deſſeins,	Rome change à présent de route et de desseins,
Tandis qu'elle a voulu les vaincre par les armes	Tandis qu’elle a voulu les vaincre par les armes,
De ſes puiſſans efforts ils n’ont point pris d’allarmes,	De ses puissants efforts il n’ont point pris d’alarmes,
Elle a toûjours trouvé quand on a combattu,	Elle a toujours trouvé quand on a combattu,
Valeur contre valeur, vertu contre vertu,	Valeur contre valeur, vertu contre vertu,
Elle veut aujourd’huy par un chemin contraire	Elle veut aujourd’hui par un chemin contraire
Achever ce qu’encor la force n’a pû faire,	Achever ce qu’encor la force n’a pu faire,
Et cherche le ſecours de ces feintes douceurs	Et cherche le secours de ces feintes douceurs
Qui ne manquẽt jamais d’abuſer les grands cœurs	Qui ne manquent jamais d’abuser les grands cœurs
Mais Seigneur, c’eſt aſſez conteſté l’un & l’autre,	Mais Seigneur, c’est assez conteste l’un et l’autre,
Vous blâmez mon party, je condamne le vôtre,	Vous blâmez mon parti, je condamne le vôtre,
Il eſt temps de finir ce fâcheux entretien	Il est temps de finir ce fâcheux entretien
Qui porteroit trop loin vôtre eſprit & le mien,	Qui porterait trop loin votre esprit et le mien,
Permettez ſeulement qu’un heureux Hymenée	Permettez seulement qu’un heureux Hyménée
D'Iſmenie à mon ſort joigne la deſtinée,	D’Isménie à mon sort joigne la destinée,
Vous me l’avez promiſe, & de nos jeunes ans	Vous me l’avez promise, et de nos jeunes ans
Nous ſommes engagés par de communs ſermens.	Nous sommes engagés par de communs serments.
Ma fille! quoy, Seigneur, y penſez-vous encore:	Ma fille! quoi, Seigneur, y pensez-vous encore:
Se peut-il....	Se peut-il…
Si j’y penſe, ah Seigneur! je l’adore,	Si j’y pense, ah Seigneur! je l’adore,
Jamais de tant d’amour mon cœur ne fut épris.	Jamais de tant d’amour mon cœur ne fut épris.
Elle n’eſt pas pour vous Seigneur, d’aſſés haut prix.	Elle n’est pas pour vous Seigneur, d’assez haut prix.
Songés que cét Hymene bleſſeroit vôtre gloire,	Songez que cet hymen blesserait votre gloire.
Vous épouſer ma fille; ah! pourroit-on le croire;	Vous épousez ma fille; ah! pourrait-on le croire;
Voulez-vous juſques-là profaner vôtre main;	Voulez-vous jusques-là profaner votre main;
Vous qui mépriſés tant un Citoyen Romain,	Vous qui méprisez tant un Citoyen Romain,
Je le ſuis, & de plus je fais gloire de l'être,	Je le suis, et depuis je fais gloire de l’être,
Vous eſtes Souverain, je reconnois un maître,	Vous êtes souverain, je reconnais un maître,
Seigneur, portez ailleurs, vos ſoûpirs, & vos feux,	Seigneur, portez ailleurs vos soupirs et vos feux,
Cent Reynes brigueront vôtre main, & vos vœux.	Cent Reines brigueront votre main et vos vœux.
Seigneur, n’inſultez point au malheur qui m’accable,	Seigneur, n’insultez point au malheur qui m’accable,
Ne deſeſperez point un Prince déplorable,	Ne désespérez point un Prince déplorable.
Qui peut vous obliger à me manquer de foy?	Qui peut vous obliger à me manquer de foi?
Je vous ſers en effet, & fais ce que je doy,	Je vous sers en effet, et fais ce que je dois,
Seigneur, à d’autres nœuds ma fille eſt deſtinée,	Seigneur, à d’autres nœuds ma fille est destinée,
L’Etat où je me vois regle ſon Hymenée,	L’état où je me vois règle son Hyménée,
Enfin, pour ſon Epoux j’ay fait choix d’un Romain,	Enfin, pour son Époux j’ai fait choix d’un Romain,
Et Varus dans ce Camp doit l’épouſer demain.	Et Varus dans ce Camp doit l’épouser demain.
Avant que mon Rival épouſe ce que j’aime	Avant que mon Rival épouse ce que j’aime,
Ce Rival perira, fut-ce Ceſar luy-même.	Ce Rival périra, fut-ce César lui-même.
Nous n’aprehendons point vos funeſtes projets.	Nous n’appréhendons point vos funestes projets.
Que Varus pour le moins en craigne les effets,	Que Varus pour le moins en craigne les effets,
Je ne vous dis plus rien, adieu Seigneur, peut-eſtre	Je ne vous dis plus rien, adieu Seigneur, peut-être
Le temps & le ſuccés vous le feront connoître.	Le temps et le succès vous le feront connaître.
LE ſuccés ne ſera que malheureux pour toy	LE succès ne sera que malheureux pour toi
Tu ne porteras point tes fureurs loin de moy.	Tu ne porteras point tes fureurs loin de moi.
QU’avez-vous fait, Seigneur, & que doit-on attendre?	Qu’avez-vous fait, Seigneur, et que doit-on attendre?
Mais quoy, quel eſt ce bruit que je ne puis comprendre	Mais quoi, quel est ce bruit que je ne puis comprendre
Qui cauſe ce tumulte & ces cris confondus?	Qui cause ce tumulte et ces cris confondus?
Ma garde par mon ordre arreſte Arminius,	Ma garde par mon ordre arrête Arminius,
A notre ſeureté ſa perte eſt neceſſaire,	À notre sûreté sa perte est nécessaire.
Hâtons-nous ou craignons ſa fureur temeraire,	Hâtons-nous et craignons sa fureur téméraire,
Perdons ſans balancer ce mortel ennemy,	Perdons sans balancer ce mortel ennemi,
On ne doit jamais nuire & haïr à demy;	On ne doit jamais nuire ou haïr à demi;
Seigneur, je ſuis inſtruit de toutes ſes penſées,	Seigneur, je suis instruit de toutes ses pensées,
Par des lettres des ſiens à luy-même adreſſées,	Par des lettres des siens à lui-même adressées,
Sinorix a ſurpris celuy qui les portoit,	Sinorix a surpris celui qui les portait,
Elles ſont en mes mains; ce Prince ſe flatoit	Elles sont en mes mains; ce Prince se flattait
D'attaquer nôtre Camp, d’enlever Iſmenie,	D’attaquer notre Camp, d’enlever Isménie,
Aſſurons-nous la paix aux dépens de ſa vie.	Assurons-nous la paix aux dépends de sa vie.
AH traîtres! achevez, percés, percés mon ſein,	AH traîtres! achevez, percez, percez mon sein,
Pourquoy m’arrachez-vous les Armes de la main,	Pourquoi m’arrachez-vous les Armes de la main,
Et n’eſt-ce point aſſez que vous preniez ma vie	Et n’est-ce point assez que vous preniez ma vie
Sans m'expoſer encor à tant d’ignominie?	Sans m’exposer encore à tant d’ignominie?
Te voilà. Tu n’as plus ny parole ny foy,	Te voilà. Tu n’as plus ni parole ni foi,
Segeſte, par ton ordre on attente ſur moy,	Ségeste, par ton ordre on attente sur moi,
Les droits les plus ſacrez n’ont donc rien qui t’arreſte,	Les droits les plus sacrés n’ont donc rien qui t’arrête,
Et tu veux aux Romains faire un don de ma teſte;	Et tu veux aux Romains faire un don de ma tête;
Digne employ d’un Heros qui durant quarante ans,	Digne emploi d’un Héros qui durant quarante ans,
A remply l’Univers de ſes faits éclatans?	A rempli l’Univers de ses faits éclatants?
Mais toy qui viens jouïr de toute ma diſgrace,	Mais toi qui viens jouir de toute ma disgrâce,
Toy dont le front déja du trépas me menace,	Toi dont le front déjà du trépas me menace,
Magnanime, Varus, penſes-tu m’étonner;	Magnanime, Varus, penses-tu m’étonner;
J’avois juré ta mort, tu peux me la donner,	J’avais juré ta mort, tu peux me la donner,
J’entendray ſans fremir l'Arreſt le plus ſevere,	J’entendrai sans frémir l’Arrêt le plus sévère,
Je crains plus ta pitié que toute ta colere.	Je crains plus ta pitié que toute ta colère.
Non non, je ne viens point jouïr de ta douleur,	Non non, je ne viens point jouir de ta douleur,
Je reſpecte ton rang, ton nom, & ton malheur,	Je respecte ton rang, ton nom et ton malheur,
Je fais plus, de tes jours arbitre volontaire,	Je fais plus, de tes jours arbitre volontaire,
Je veux que de ton ſort le Senat délibere,	Je veux que de ton sort le Sénat délibère,
Luy ſeul te jugera, cependant ne crois pas	Lui seul te jugera, cependant ne crois pas
Que la pitié me touche & retienne mon bras,	Que la pitié me touche et retienne mon bras,
Ce que je fais pour toy je le fais pour moy-même,	Ce que je fais pour toi je le fais pour moi-même,
Iſmenie à ta foy, tu l’adores, je l’aime,	Isménie a ta foi, tu l’adores, je l’aime,
Comme chef des Romains je te dois condamner,	Comme chef des Romains je te dois condamner,
Mais comme ton Rival je te veux épargner,	Mais comme ton Rival je te veux épargner,
Pour aſſurer ma gloire & confondre l'envie	Pour assurer ma gloire et confondre l’envie
Qui pourroit m'accuſer d’en vouloir à ta vie.	Qui pourrait m’accuser d’en vouloir à ta vie.
Détrompe-toy, Varus, & ſois moins genereux,	Détrompe-toi, Varus, et sois moins généreux,
Précipité ma mort ſi tu veux eſtre heureux,	Précipite ma mort si tu veux être heureux,
D’un Rival tel que moy la vie eſt importune,	D’un Rival tel que moi la vie est importune,
Et l’on peut entre nous voir changer la fortune,	Et l’on peut entre nous voir changer la fortune,
L’exemple en eſt commun; mais ſois ſeure qu'à mon tour,	L’exemple en est commun; mais sois sûr qu’à mon tour.
Je balanceray moins à te priver du jour.	Je balancerai moins à te priver du jour.
Si de mon ſort jamais les Dieux te rendant maître,	Si de mon sort jamais les Dieux te rendent maître,
A tes yeux ſans ſecours me forcent de paroître;	À tes yeux sans secours me forcent de paraître;
Tu pourras ou me perdre ou me ſauver: & moy	Tu pourras ou me perdre ou me sauver: et moi
Sans prévoir l’avenir je fais ce que je doy.	Sans prévoir l’avenir je fais ce que je dois.
Je ne ſçaurois ſouffrir, Seigneur, qu’il vous outrage,	Je ne saurais souffrir, Seigneur, qu’il vous outrage,
Qu'on l’oſte.	Qu’on l’ôte.
De Segeſte eſt-ce là le langage,	De Ségeste est-ce là le langage,
Regarde en quels malheurs tu tes précipité,	Regarde en quels malheurs tu t’es précipité,
Voy de nous deux, enfin qui doit eſtre imité,	Vois de nous deux, enfin qui doit être imité,
Tu reſpectes Varus, tu le crains, je le brave,	Tu respectes Varus, tu le crains, je le brave,
Je ne parle qu’en Roy, tu parles en eſclave,	Je ne parle qu’en Roi, tu parles en esclave,
Et captif, deſarmé je ſuis plus ſouverain	Et captif désarmé je suis plus souverain
Que tu ne l’as eſté les Armes à la main.	Que tu ne l’a été les armes à la main.
Laiſſons un libre cours à ſa douleur mortelle,	Laissons un libre cours à sa douleur mortelle,
Seigneur, un ſoin preſſant en d’autres lieux m’appelle,	Seigneur, un soin pressant en d’autres lieux m’appelle,
Qu'on le garde.	Qu’on le garde.
Sunnon, appliquez-y vos ſoins,	Sunnon, appliquez-y vos soins,
Qu'il ait à tous momens vos regards pour témoins,	Qu’il ait à tous moments vos regards pour témoins.
Sur tout ſouvenez-vous qu’il y va de la teſte.	Surtout souvenez-vous qu’il y va de la tête.
Où faut-il me conduire? allons quoy qu’on m'apprête,	Où faut-il me conduire? allons quoiqu’on m’apprête,
Je défie à la fois le ſort & les Romains,	Je défie à la fois le sort et les Romains.
Juſtes Dieux! vous ſçavez les malheurs que je crains.	Justes Dieux! vous savez les malheurs que je crains.
APPRENS-moy donc, Barſine, où l'on garde mon frere,	APPRENDS-moi donc, Barsine, où l’on garde mon frère,
Que j’aille luy prouver une amitié ſincere,	Que j’aille lui prouver une amitié sincère,
Et m’acquitter vers luy du plus juſte devoir.......	Et m’acquitter vers lui du plus juste devoir…
Vous ſera-t’il permis, Madame, de le voir?	Vous sera-t-il permis, Madame, de le voir?
Pour vous plaire, Sunnon oſera-t’il en fraindre	Pour vous plaire, Sunnon osera-t-il enfreindre
L’ordre exprés....	L’ordre exprès…
De ma part Sunnon n’a rien à craindre,	De ma part Sunnon n'a rien à craindre,
Etrangere en ce Camp, ſans ſecours, ſans ſoldats,	Étrangère en ce Camp, sans secours sans soldats,
Je ne puis que pleurer, voilà mes attentats,	Je ne puis que pleurer, voilà mes attentats,
Loin de pouvoir deffendre un Prince qu’on opprime,	Loin de pouvoir défendre un Prince qu’on opprime,
Je cours offrir à Rome une double victime;	Je cours offrir à Rome une double victime;
Suivre le ſort d’un frere, adoucir ſon ennuy,	Suivre le sort d’un frère, adoucir son ennui,
Le plaindre, le ſervir, & mourir avec luy.	Le plaindre, le servir, et mourir avec lui.
O Ciel! auriez-vous pris un deſſein ſi funeſte?	Ô ciel! auriez-vous pris un dessein si funeste?
En puis-je former d’autre; & quel eſpoir me reſte?	En puis-je former d’autre; et quel espoir me reste?
Du ſein de nos Etats on m’ameine en ces lieux	Du sein de nos États on m’amène en ces lieux
Sous l’appas, ſous la foy d’un Hymen glorieux,	Sous l’appas, sous la foi d’un Hymen glorieux,
Je me flatte qu’icy dés long-temps attenduë	Je me flatte qu’ici dès longtemps attendue
La joye en tous les cœurs doit regner à ma veuë,	La joie en tous les cœurs doit régner à ma vue,
Que j’y dois trouver même une pompeuſe Cour,	Que j’y dois trouver même une pompeuse Cour,
Qu'ay-je trouvé? je vois que dés le premier jour	Qu’ai-je trouvé? je vois que dès le premier jour
Segeſte me traittant en mortelle ennemie	Ségeste me traitant en mortelle ennemie
Par le dernier mépris me couvre d’infamie,	Par le dernier mépris me couvre d’infamie,
Pour un trône promis me prepare des fers,	Pour un trône promis me prépare des fers,
Et jouït de ma peine aux yeux de l’Univers;	Et jouir de ma peine aux yeux de l’Univers;
Mais helas! ce n’eſt point ce qui me deſeſpere,	Mais hélas! ce n’est point ce qui me désespère,
Je ſens moins mes mal-heurs que les perils d’un frere,	Je sens moins mes malheurs que les périls d’un frère,
Et de quel frere encor! pour loüer ſes exploits	Et de quel frère encore! pour louer ses exploits
La Renommée à peine a-t'elle aſſez de voix?	La Renommée à peine a-t-elle assez de voix?
Luy ſeul à des Germains fait revivre la gloire,	Lui seul a des Germains fait revivre la gloire,
Et ſous leurs Etendarts ramené la victoire,	Et sous leurs Étendards ramené la victoire,
On le livre aux Romains, ſans doute il va perir,	On le livre aux Romains, sans doute il va périr,
Dieux! n’eſt-il point de bras prompts à le ſecourir	Dieux! n’est-il pas de bras prompts à le secourir
Laiſſerez vous tomber cette tête proſcrite?	Laisserez-vous tomber cette tête proscrite?
Vous Soldats tant de fois triomphans à ſa ſuite?	Vous Soldats tant de fois triomphants à sa suite?
Et vous Peuples du joug, ſauvez par ſa valeur,	Et vous Peuples du joug, sauvez par sa faveur,
Ne deffendrez-vous point vôtre heureux deffenſeur?	Ne défendrez-vous point votre heureux défendeur?
Oüy, Madame, eſperez qu’un ſecours favorable....	Oui, Madame, espérez qu’un recours favorable…
Eh! qui voudroit ſervir ce Prince déplorable:	Eh! qui voudrait servir ce Prince déplorable:
Qui voudroit de ſes maux avoir quelque pitié!	Qui voudrait de ses maux avoir quelque pitié!
Quand ceux qui luy juroient une étroite amitié,	Quand ceux qui lui juraient une étroite amitié,
Quand ceux que l’amour même engage à ſa deffenſe,	Quand ceux que l’amour même engage à sa défense,
Semblent paſſer pour luy juſqu’à l’indifference,	Semblent passer pour lui jusqu’à l’indifférence,
Sigiſmond, Iſmenie, ont oublié tous deux	Sigismond, Isménie, on oublié tous deux
Qu'ils aimoient autrefois ce Prince malheureux,	Qu’ils aimaient autrefois ce Prince malheureux,
Leur voit-on rien tenter pour aſſurer ſa vie?	Leur voit-on rien tenter pour assurer sa vie?
Ah! de leur ſouvenir je ſuis auſſi bannie,	Ah! de leur souvenir je suis aussi bannie,
Prennent-ils quelque ſoin de flater ma douleur?	Prennent-ils quelque soin de flatter ma douleur?
L’infortune du frere eſt commune à la ſœur,	L’infortune du frère est commune à la sœur,
Helas! dans tous les cœurs quel changement je trouve!	Hélas! dans tous les cœurs quel changement je trouve!
Par quel deſtin fatal Dieux faut-il qu'il éprouve	Par quel destin fatal Dieux faut-il qu’il éprouve
Que nos cruels malheurs glacent dans un ſeul jour	Que nos cruels malheurs glacent dans un seul jour
L’amitié la plus forte, & le plus tendre amour?	L’amitié la plus forte, et le plus tendre amour?
Cét injuſte ſoupçon offenſe l’un & l’autre,	Cet injuste soupçon offense l’un et l’autre,
Madame, leur douleur eſt égale à la vôtre,	Madame, leur douleur est égale à la vôtre,
Les larmes d'Iſmenie en ce même moment	Les larmes d’Isménie en ce même moment
A ſon Pere irrité parlent pour ſon Amant;	À son Père irrité parlent pour son Amant;
Sigiſmond a juré de ſauver vôtre frere....	Sigismond a juré de sauver votre frère…
Mais il vient, apprenez ſi ſon cœur eſt ſincere.	Mais il vient, apprenez si son cœur est sincère.
QUel eſt vôtre deſſein? venez-vous dans ces lieux,	QUel est votre dessein? venez-vous dans ces lieux,
Madame pour cacher vos plaintes à mes yeux?	Madame pour cacher vos plaintes à mes yeux?
Je n’oſe me flatter que ma ſeule preſence	Je n’ose me flatter que ma seule présence
Puiſſe de vos ennuis calmer la violence,	Puisse de vos ennuis calmer la violence,
Si pourtant vôtre amour eſtoit égal au mien.	Si pourtant votre amour était égal au mien.
Ah! Seigneur, finiſſez cét étrange entretien,	Ah! Seigneur, finissez cet étrange entretien,
Quel temps choiſiſſez-vous? La triſte Polixene	Quel temps choisissez-vous? La triste Polixène
N’a le cœur penetré que de crainte & de haine,	N’a le cœur pénétré que de crainte et de haine,
Ces divers mouvemens l’agitent tour à tour,	Ces divers mouvements l’agitent tour à tour,
Il n’eſt plus dans ce cœur de place pour l’amour.	Il n’est plus dans ce cœur de place pour l’amour.
Que dites-vous, ô Ciel!	Que dites-vous, ô ciel!
Ce que je ne puis taire,	Ce que je ne puis taire,
Je deteſte Varus, je tremble pour mon frere.	Je déteste Varus, je tremble pour mon frère.
Je vois l’un ſouverain, l’autre perſecuté,	Je vois l’un souverain, l’autre persécuté,
Jugez de ma douleur dans cette extremité?	Jugez de ma douleur dans cette extrémité?
Si je dois m’occuper d’une inutile flâme?	Si je dois m’occuper d’une inutile flamme?
Mais quand l’amour encor regneroit dans mon ame;	Mais quand l’amour encor règnerait dans mon âme;
Dequoy me ſerviroit ce vain amuſement:	De quoi me servirait ce vain amusement:
Seigneur, doit-on aimer lors qu’on n’a plus d’amant?	Seigneur, doit-on aimer lors qu’on n’a plus d’amant?
De ce fatal diſcours que faut-il que je penſe?	De ce fatal discours que faut-il que je pense?
Me ſoupçonneriez-vous.... Mon eſprit en balance,	Me soupçonneriez-vous… Mon esprit en balance,
Ne ſçauroit....	Ne saurait…
Non, Seigneur, je ne vous connois plus,	Non, Seigneur, je ne vous connais plus,
Je n’ay jamais aimé l’Eſclave de Varus.	Je n’ai jamais aimé l’Esclave de Varus.
Juſte Ciel! vôtre cœur me peut-il méconnoître?	Juste ciel! votre cœur ne peut-il méconnaître?
Vous m'y forcez, Seigneur, quand vous ſouffrez un Maître,	Vous m’y forcez, Seigneur, quand vous souffrez un Maître,
Oüy lors que je vous vois, en vain je veux chercher	Oui lorsque je vous vois, en vain je veux chercher
Ce Prince qui m’aimoit & qui m’eſtoit ſi cher,	Ce Prince qui m’aimait et qui m’était si cher,
L’amour m'aſſure en vain que vous eſtes le même,	L’amour m’assure en vain que vous êtes le même,
Ah! j'en voy malgré luy la difference extrême,	Ah! j’en vois malgré lui la différence extrême,
Je trouve encor en vous cét air grand, glorieux,	Je trouve encor en vous cet air grand, glorieux,
Cette grace, ces traits qui charmerent mes yeux;	Cette grâce, ces traits qui charmèrent mes yeux;
Mais je n’y trouve plus cette ardeur heroïque	Mais je n’y trouve plus cette ardeur héroïque
Qui ſoûtenoit jadis la fierté Germanique,	Qui soutenait jadis la fierté Germanique,
Ce courage élevé, cette noble grandeur,	Ce courage élevé, cette noble grandeur,
Et tant d’autres vertus qui charmerent mon cœur.	Et tant d’autres vertus qui charmèrent mon cœur.
Ah! vous deviez me rendre un peu plus de juſtice	Ah! vous deviez me rendre un peu plus de justice
Sans avoir attendu que je vous éclairciſſe	Sans avoir attendu que je vous éclaircisse
De tout....	De tout…
Helas! Seigneur, pendant ce vain diſcours	Hélas! Seigneur, pendant ce vain discours
De mon frere peut-eſtre on va trancher les jours,	De mon frère peut-être on va trancher les jours,
Peut-eſtre la fureur d’un Rival qui l’abhorre....	Peut-être la fureur d’un Rival qui l’abhorre…
Calmez vôtre douleur, ne craignez rien encore,	Calmez votre douleur, ne craignez rien encore,
Madame, & permettez que je vous faſſe voir	Madame, et permettez que je vous fasse voir
Si d’un fidele Amant j'ay remply le devoir,	Si d’un fidèle Amant j’ai rempli le devoir,
Si je balance, enfin, entre vous & mon Pere,	Si je balance, enfin, entre vous et mon Père,
Mais j’en laiſſe le ſoin au Prince vôtre frere,	Mais j’en laisse le soin au Prince votre frère,
Il parlera, Madame, & vous convaincra mieux.	Il parlera, Madame, et vous convaincra mieux.
CIel que vois-je! eſt-ce vous? en croiray-je mes yeux;	CIel que vois-je! est-ce vous? en croirai-je mes yeux;
Seigneur, & quel ſecours? quelle main pitoyable,	Seigneur, et quel secours? Quelle main pitoyable,
Finit en vous ſauvant le tourment qui m'accable,	Finit en vous sauvant le tourment qui m’accable,
A qui dois-je mon frere, & qui me l’a rendu?	À qui dois-je mon frère, et qui me l’a rendu?
Vous m'en voyez moy-même étonné, confondu,	Vous m’en voyez moi-même étonné, confondu,
Gardé prés de ces lieux tout plein de mes diſgraces,	Gardé près de ces lieux tout plein de mes disgrâces,
De mes fiers ennemis rappellant les menaces,	De mes fiers ennemis rappelant les menaces,
Préparé par avance aux cruautez du ſort,	Préparé par avance aux cruautés du sort,
J’attendois à toute heure une ſanglante mort;	J’attendais à tout heure une sanglante mort;
Lorſque Sunnon entrant j’ay lû ſur ſon viſage,	Lorsque Sunnon entrant j’ai lu sur son visage
De quelque grand deſſein l’infaillible préſage;	De quelque grand dessein l’infaillible présage;
Hâtons-nous, m’a-t’il dit, Seigneur, & ſuivez-moy,	Hâtons-nous, m’a-t-il dit, Seigneur, et suivez-moi,
Du ſalut de vos jours fiez vous à ma foy,	Du salut de vos jours fiez-vous à ma foi,
Je le ſuis. Nous trouvons une route ſecrette	Je le suis. Nous trouvons une route secrète
Qui juſques dans ces lieux guide nôtre retraitte;	Qui jusque dans ces lieux guide notre retraite;
De la nuit qui ſurvient l’heureuſe obſcurité	De la nuit qui survient l’heureuse obscurité
A ſi bien ſecondé nôtre temerité,	A si bien secondé notre témérité,
Que je vous vois, enfin, le reſte je l’ignore....	Que je vous vois, enfin, le reste je l’ignore…
J’ay tout ozé pour vous, Seigneur, je dois encore	J’ai tout osé pour vous, Seigneur, je dois encore
Remettre entre vos mains l’inſtrument glorieux	Remettre entre vos mains l’instrument glorieux
Des exploits tant de fois achevez à nos yeux,	Des exploits tant de fois achevés à nos yeux,
Ce n'eſt pas tout. Du Camp ſortez en diligence,	Ce n’est pas tout. Du Camp sortez en diligence,
Prenez en luy, Seigneur, une entiere aſſurance,	Prenez-en lui, Seigneur, une entière assurance,
Il eſt inſtruit de l’ordre, & connu des Soldats;	Il est instruit de l’ordre, et connu des Soldats;
Allez, ne craignez rien, & bien-tôt ſur ſes pas	Allez, ne craignez rien, et bientôt sur ses pas
Vous gagnerez les bois, & joindrez vôtre Armée.	Vous gagnerez les bois, et joindrez votre Armée.
De quel zele pour moy vôtre ame eſt enflâmée;	De quel zèle pour moi vôtre âme est enflammée;
Puis-je jamais payer des ſoins ſi genereux?	Puis-je jamais payez des soins si généreux?
Le Ciel en ce moment a remply tous mes vœux	Le Ciel en ce moment a rempli tous mes vœux
Prince, puiſque c’eſt vous qui me rendez mon frere.	Prince, puisque c’est vous qui me rendez mon frère.
Partez, Se gneur, fuyez l'implacable colere	Partez, Seigneur, fuyez l’implacable colère
De Segeſte aveuglé, des Romains furieux....	De Ségeste aveuglé, des Romains furieux…
Il n'eſt pas temps encor de ſortir de ces lieux;	Il n’est pas temps encor de sortir de ces lieux;
Les Soldats dans le Camp errans à l’avanture	Les Soldats dans le Camp errants à l’aventure
Rendent en cét inſtant vôtre fuite moins ſeure,	Rendent en cet instant votre fuite moins sûre,
Attendons, qu’oubliant leurs penibles travaux	Attendons, qu’oubliant leurs pénibles travaux
Dans les bras du ſommeil ils cherchent le repos;	Dans les bras du sommeil ils cherchent le repos;
Et que la nuit, Seigneur, un peu plus avancée....	Et que la nuit, Seigneur, un peu plus avancée…
Ouy, par vôtre conſeil je change de penſée;	Oui, par votre conseil je change de pensée;
Et je vais avec ſoin obſerver le moment	Et je vais avec soin observer le moment
Où vous pourrez, Seigneur, vous ſauver ſeurement;	Où vous pourrez, Seigneur, vous sauver sûrement;
Moy-même dans ces lieux je viendray vous reprendre.	Moi-même dans ces lieux je viendrai vous surprendre.
Vous, auprés de mon Pere, il eſt temps de vous rendre,	Vous auprès de mon père, il est temps de vous rendre,
Madame, par vos pleurs vous ſçaurez l'abuſer.	Madame, par vos pleurs vous saurez l’abuser.
J’y cours; vous pour leur fuite, allez tout difpoſer:	J’y cours; vous pour leur fuite, allez tout disposer:
Adieu, Seigneur, le Ciel ſecondant mon envie	Adieu, Seigneur, le ciel secondant mon envie
Puiſſe-t’il par nos ſoins aſſurer vôtre vie.	Puisse-t-il par nos soins assurer votre vie.
VOus qui pour mon ſalut travaillez avec eux,	Vous qui pour mon salut travaillez avec eux,
Qui plaignez le deſtin d’un Prince mal-heureux;	Qui plaignez le destin d’un Prince malheureux;
Amy, de qui le zele à ma perte s'oppoſe,	Ami, de qui le zèle à ma perte s’oppose,
J’admire vos bontez, & j’en cherche la cauſe,	J’admire vos bontés, et j’en cherche la cause,
Quel charme à me ſervir vous a rendu ſi prompt	Quel charme à me servir vous a rendu si prompt
Devois-je moins, Seigneur, au Prince Sigiſmond?	Devais-je moins, Seigneur, au Prince Sigismond?
C’eſt luy qui relevant ma naiſſance commune	C’est lui qui relevant ma naissance commune
Juſqu’au rang que je tiens a porté ma fortune,	Jusqu’au rang que je tiens a porté ma fortune,
Qui pour vous aſſurer mes ſoins, & mon ſecours,	Que pour vous assurer mes soins, et mon secours,
M’a juré que ſon ſort s’attachoit à vos jours.	M’a juré que mon sort s'attachait à vos jours.
Déja mon cœur pour vous craignoit un coup funeſte,	Déjà mon cœur pour vous craignait un coup funeste,
J’eſtois preſque ébranlé; le Prince a fait le reſte,	J’étais presque ébranlé; le Prince a fait le reste,
Et quels que ſoient les noms qu’on me peut impoſer,	Et quels que soient les noms qu’on me peut imposer,
Vos vertus, vos exploits, me ſçauront excuſer,	Vos vertus, vos exploits, me sauront excuser,
Suivez, Seigneur, ſuivez l'ardeur qui vous anime,	Suivez, Seigneur, suivez l’ardeur qui vous anime,
Dans le ſang des Romains courez laver mon crime;	Dans le sang des Romains courez laver mon crime;
Des Peuples aſſervis, courez briſer les fers,	Des Peuples asservis, courez briser les fers,
Vangez-les des mépris, des maux qu’ils ont ſoufferts,	Vengez-les des mépris, des maux qu’ils ont soufferts,
Forcez tous les Germains, enfin, de reconnoître	Forcez tous les Germains, enfin, de reconnaître
Que ſi Sunnon pour vous devient perfide & traître	Que si Sunnon pour vous devient perfide et traître
Sa trahiſon ſauvant ſon païs abbatu	Sa trahison sauvant son pays abattu
Merite leur eſtime, & le nom de vertu.	Mérite leur estime, et le nom de vertu.
Oüy, laiſſez-moy le ſoin d’une juſte vangeance,	Oui, laissez-moi le soin d’une juste vengeance,
Mais, Seigneur, ſi le Ciel trahit nôtre eſperance,	Mais, Seigneur, si le Ciel trahit notre espérance,
Que ſert de vous flatter? je vois de toutes parts	Que sert de vous flatter? je vois de toutes parts
Mille perils divers s’offrir à mes regards,	Mille périls divers s’offrir à mes regards,
La fuite de ce Camp paroiſt ſi difficile....	La fuite de ce Camp paraît si difficile…
N’importe, je mourray ſatisfait & tranquille,	N’importe, je mourrai satisfait et tranquille,
Si je puis expirer les armes à la main,	Si je puis expirer les armes à la main,
Et ſi mes derniers coups verſent du ſang Romain.	Et si mes derniers coups versent du sang Romain.
VOus eftes libre, enfin, Seigneur, & Polixene	VOus êtes libre, enfin, Seigneur, et Polixène
M’apprenant vôtre ſort vient d’adoucir ma peine,	M’apprenant votre sort vient d’adoucir ma peine,
Dieux! de quels traits mon cœur s’eſt-il ſenty percer?	Dieux! de quels traits mon cœur s’est-il senti percer?
Non, nul autre que moy ne ſçauroit le penſer,	Non, nul autre que moi ne saurait le penser,
A peine je reſpire, abatuë, interdite....	À peine je respire, abattue, interdite…
Mais grace au Ciel je voy tout preſt pour vôtre fuite,	Mai grâce au Ciel je vois tout prêt pour votre fuite,
Vous vivrez.... Mais helas! plus d’Hymen, plus d’eſpoir,	Vous vivrez… Mais hélas! plus d’hymen plus d’espoir,
Pour jamais aujourd'huy je ceſſe de vous voir,	Pour jamais aujourd’hui je cesse de vous voir,
Et le ſort à nos vœux devenu trop contraire....	Et le sort à nos vœux devenu trop contraire…
Non non, je fléchiray le ſort & vôtre Pere,	Non non, je fléchirai le sort et votre Père,
Je vay, puiſqu’il le faut, m’éloigner de vos yeux,	Je vais, puisqu’il le faut, m’éloigner de vos yeux,
Mais bien-tôt en vainqueur je reverray ces lieux,	Mais bientôt en vainqueur je reverrai ces lieux,
La juſtice, l’amour, mon cœur, tout m’en aſſure,	La justice, l’amour, mon cœur, tout m’en assure,
Le ſang de mon Rival lavera mon injure,	Le sang de mon Rival lavera mon injure,
Varus & les Romains dans ce Camp égorgez,	Varus et les Romains dans ce Camp égorgés,
Serviront de victime à mes feux outragez,	Serviront de victime à mes feux outragés,
Mon bras....	Mon bras…
Où vous emporte une aveugle colere?	Où vous emporte une aveugle colère?
Voulez-vous dans leur chûte envelopper mon Pere?	Voulez-vous dans leur chute envelopper mon Père?
Quel eſt vôtre deſſein? ah Ciel! prétendez-vous	Quel est votre dessein? ah Ciel! prétendez-vous
Dans un Camp qu’il deffend venir porter vos coups?	Dans un Camp qu’il défend venir porter vos coups?
Vous verray-je au combat animez l’un & l'autre,	Vous verrai-je au combat animés l’un et l’autre,
Peut-être de ſa main.... peut-être de la vôtre....	Peut-être de sa main… peut-être de la vôtre…
Je fremis... C’eſt aſſez que nous l’oſions trahir,	Je frémis… C’est assez que nous l’osions trahir,
Voulez-vous me forcer encore à vous haïr?	Voulez-vous me forcer encore à vous haïr?
Epargnez-le, Seigneur, & reſpectez ſa vie.	Épargnez-le, Seigneur, et respectez sa vie.
Le ſoin de ſon ſalut fait ma plus chere envie,	Le soin de son salut fait ma plus chère envie,
Quels que ſoient les affronts qu’il m’a fait aujourd’huy,	Quels que soient les affronts qu’il m’a fait aujourd’hui,
S’il ſe trouve au combat je veilleray ſur luy,	S’il se trouve au combat je veillerai sur lui,
Moins jaloux mille fois d’emporter la victoire,	Moins jaloux mille fois d’emporter la victoire,
Que de ſauver ſes jours aux dépens de ma gloire.	Que de sauver ses jours aux dépends de ma gloire.
Non, Seigneur, tous vos ſoins ne me raſſurent pas;	Non, Seigneur, tous vos soins ne me rassurent pas;
Pourrez-vous retenir la fureur des ſoldats?	Pourrez-vous retenir la fureur des soldats?
Je défens...	Je défends…
Revoquez une loy ſi barbare,	Révoquez une loi si barbare,
Ou redoutez les maux que Rome nous prépare,	Ou redoutez les maux que Rome nous prépare,
Souffrez...	Souffrez…
Non c’en eſt fait, je n’y puis conſentir,	Non c’en est fait, je n’y puis consentir,
N’en parlons plus.	N’en parlons plus.
Et moy je ne veux plus partir,	Et moi je ne veux plus partir,
Je rentre dans les fers de vôtre injuſte Pere,	Je rentre dans les fers de votre injuste Père,
J'abandonne ma teſte à toute ſa colere;	J’abandonne ma tête à toute sa colère;
Ce Prince, les Romains alterés de mon ſang,	Ce Prince, les Romains altérés de mon sang,
De la derniere goute épuiſeront mon flanc,	De la dernière goutte épuiseront mon flanc,
Vous le ſçavez? déja ma perte eſt reſoluë,	Vous le savez? Déjà ma perte est résolue,
Et du coup qui m’attend vous n’eſtes point émeuë?	Et du coup qui m’attend vous n’êtes point émue?
Ingrate, vous craignez pour un Pere inhumain,	Ingrate, vous craignez pour un Père inhumain,
D’un combat éloigné le peril incertain,	D’un combat éloigné le péril incertain,
Et vous ne craignez point pour un Amant fidele	Et vous ne craignez point pour un Amant fidèle
Les horreurs d’une mort & prochaine & cruelle.	Les horreurs d’une mort et prochaine et cruelle.
Triſte effet de mes ſoins! je ſuis preſt à perir,	Triste effet de mes soins! je suis prêt à périr,
Et vous me deffendez de m’oſer ſecourir;	Et vous me défendez de m’oser secourir;
Mais que dis-je? grands Dieux! quel eſpoir eſt le vôtre?	Mais que dis-je? grand Dieux! quel espoir est le vôtre?
Voulez-vous vous jetter entre les bras d’un autre?	Voulez-vous vous jeter entre les bras d’un autre?
Vous donner à Varus? & que de ſon bonheur	Vous donner à Varus? et que de son bonheur
Pour vous plaire je ſois tranquille ſpectateur?	Pour vous plaire je sois tranquille spectateur?
Non, non, n’eſperez pas que mon obeïſſance	Non, non, n’espérez pas que mon obéissance
Juſques à cét effort porte ma complaiſance,	Jusqu'à cet effort porte ma complaisance,
Vôtre fauſſe pitié m’éloigne de ces lieux,	Votre fausse pitié m’éloigne de ces lieux,
Et moy je veux du moins ne mourir qu’à vos yeux,	Et moi je veux du moins ne mourir qu’à vos yeux,
J’y cours.	J'y cours.
Quelle fureur, quelle affreuſe menace?	Quelle fureur, quelle affreuse menace?
Arreſtez.... tout mon ſang dans mes veines ſe glace,	Arrêtez… tout mon sang dans mes veines se glace,
Amitié, ſang, amour, je cede à vôtre effort,	Amitié, sang, amour, je cède à votre effort,
Vous déchirez mon cœur qui ſera le plus fort?	Vous déchirez mon cœur qui sera le plus fort?
Qui.... Je ſens que l’amour plus fort que la nature	Qui… Je sens que l’amour plus fort que la nature
Du ſang qui le combat ſurmonte le murmure,	Du sang qui le combat surmonte le murmure,
Je me rens, & je laiſſe agir vôtre valeur,	Je me rends, et je laisse agir votre valeur,
Entre mon Pere & vous j’ay partagé mon cœur,	Entre mon Père et vous j’ai partagé mon cœur,
Mais un juſte tranſport le fait pancher, l’entraîne	Mais un juste transport le fait pencher, l’entraîne
Du coſté de celuy dont la perte eſt prochaine,	Du côté de celui dont la perte est prochaine,
Et quand je prens party, Seigneur, entre vous deux,	Et quand je prends parti, Seigneur, entre vous deux,
C’eſt pour le plus à plaindre, & le plus malheureux.	C’est pour le plus à plaindre, et le plus malheureux.
AH! Madame....	AH! Madame…
Seigneur fuyez en diligence,	Seigneur fuyez en diligence,
La nuit dans tout le Camp fait regner le ſilence,	La nuit dans tout le Camp fait régner le silence,
Allons, marchés, Sunnon, & ne differons pas,	Allons, marchez, Sunnon, et ne différons pas.
Adieu Madame.	Adieu Madame.
Allez, Seigneur, haſtés vos pas,	Allez, Seigneur, hâtez vos pas,
Revenez, triomphez, mais ſauvez-moy mon pere.	Revenez, triomphez, mais sauvez-moi mon père.
IL part, que fera-t’il? que faut-il que j'eſpere?	Il part, que fera-t-il? que faut-il que j’espère?
Triomphant des Romains & d’un Rival vainqueur	Triomphant des Romains et d’un Rival vainqueur
Reviendra-t’il encor plus digne de mon cœur?	Reviendra-t-il encore plus digne de mon cœur?
Le verray-je couvert d’une nouvelle gloire,	Le verrai-je couvert d’une nouvelle gloire,
Brillant de cét éclat que donne la victoire,	Brillant de cet éclat que donne la victoire,
Plein d’amour, à mes pieds venir prendre mes loix?	Plein d’amour, à mes pieds venir prendre mes lois?
Mais ſi je l’avois veu pour la deniere fois?	Mais si je l’avais vu pour la dernière fois?
Si du Ciel irrité la colere obſtinée	Si du Ciel irrité la colère obstinée
Par la fin de ſes jours marquoit cette journée?	Par la fin de ses jours marquait cette journée?
Helas! s’il periſſoit en combatant pour moy?	Hélas! s’il périssait en combattant pour moi?
Que d’horreurs! tout icy redouble mon effroy;	Que d’horreurs! tout ici redouble mon effroi;
Peut-eſtre ſa victoire également funeſte	Peut-être sa victoire également funeste
En épargnant Varus fera tomber Segeſte;	En épargnant Varus fera tomber Ségeste;
Non non, raſſurons-nous. Mon amant aujourd’huy	Non non, rassurons-nous. Mon amant aujourd’hui
N’en veut qu’à ſon Rival, & ne cherche que luy,	N’en veut qu’à son Rival, et ne cherche que lui,
Il en triomphera ſans accabler mon Pere:	Il en triomphera sans accabler mon Père:
Pardonne ce ſouhait à tes deſirs contraire,	Pardonne ce souhait à tes désirs contraire,
Segeſte, je t’honore, & les devoirs du ſang	Ségeste, je t’honore, et les devoirs du sang
Dans mon cœur agité tiennent le premier rang,	Dans mon cœur agité tiennent le premier rang,
Mais je fremis des nœuds où ton choix me deſtine,	Mais je frémis des nœuds où ton choix me destine,
Et l’état menacé d’une entiere ruine	Et l’État menacé d’une entière ruine
Fait revolter mon cœur contre un joug odieux;	Fait révolter mon cœur contre un joug odieux;
Segeſte avec Varus, quelle union? grands Dieux!	Ségeste avec Varus, quelle union? grand Dieux!
Vous qui les uniſſez, & qui voyez ma peine	Vous qui les unissez, et qui croyez ma peine
Separez ces objets & d’amour, & de haine,	Séparez ces objets et d’amour, et de haine,
Que je puiſſe aymer l’un avec fidelité;	Que je puisse aimer l’un avec fidélité;
Et voir immoler l’autre avec tranquilité;	Et voir immoler l’autre avec tranquillité;
Mais on vient, c’eſt Barſine, helas que me veutelle?	Mais on vient, c’est Barsine, hélas que me veut-elle?
MAdame, c’en eſt fait, la fortune cruelle	MAdame, c’en est fait, la fortune cruelle
Retient Arminius dans ce Camp odieux.	Retient Arminius dans ce Camp odieux.
O Ciel! qu’entens-je?	Ô Ciel! qu’entends-je?
A peine il ſortoit de ces lieux,	À peine il sortait de ces lieux,
Qu’il a trouvé d’abord pour obſtacle à ſa fuite	Qu’il a trouvé d’abord pour obstacle à sa fuite
Que Varus fait du Camp une exacte viſite,	Que Varus fait du Camp une exacte visite,
Il va de garde en garde, il court de tous coſtez	Il va de garde en garde, il court de tous côtés
Par ſon ordre en cent lieux des ſoldats ſont poſtez,	Par son ordre en cent lieux des soldats sont postés,
Qui prefts à ſignaler leur zele & leur courage	Qui prêts à signaler leur zèle et leur courage
Deffendent de ce Camp le plus étroit paſſage;	Défendent de ce Camp le plus étroit passage;
Sigiſmond éperdu, Sunnon épouvanté,	Sigismond éperdu, Sunnon épouvanté,
Ne ſçachant que reſoudre en cette extremité,	Ne sachant que résoudre en cette extrémité,
Ont conduit voſtre Amant dans la Tente prochaine,	Ont conduit votre Amant dans la Tente prochaine,
Mais enfin, déſormais leur entrepriſe eſt vaine,	Mais enfin, désormais leur entreprise est vaine.
J’ay veu leur deſeſpoir; ils ne ſe flattent plus	J’ai vu leur désespoir; ils ne se flattent plus
De pouvoir hors du Camp conduire Arminius,	De pouvoir hors du Camp conduire Arminius,
La fuite cette nuit leur paroît impoſſible.	Le fuite cette nuit leur paraît impossible.
Ainſi de ce Heros la perte eſt infaillible,	Ainsi de ce Héros la perte est infaillible,
A peine un ſeul inſtant, un peu d’eſpoir me luit,	À peine un seul instant, un peu d’espoir me luit.
Que ma crainte redouble au moment qui le ſuit,	Que ma crainte redouble au moment qui le suit,
Me faudra-t’il toûjours trembler pour ce que j’aime?	Me faudra-t-il toujours trembler pour ce que j’aime?
Grands Dieux! ah que plûtoſt je periſſe moy-même,	Grands Dieux! ah que plutôt je périsse moi-même,
Ne ménageons plus rien, l’amour au deſeſpoir	Ne ménageons plus rien, l’amour au désespoir
Se fait de ſes tranſports un ſouverain devoir;	Se fait de ses transports un souverain devoir;
Allons trouver ce Prince, allons dans mes allarmes,	Allons trouver ce Prince, allons dans mes alarmes,
Dans les pleurs que je verſe il trouvera des charmes.	Dans les pleurs que je verse il trouvera des charmes.
Et je ſentiray moins mes mortelles douleurs	Et je sentirai moins mes mortelles douleurs
Si je puis partager ſon ſort & ſes malheurs.	Si je puis partager son sort et ses malheurs.
JE ne ſçay que reſoudre, & comment me conduire,	Je ne sais que résoudre, et comment me conduire,
Des ordres de Ceſar j’aurois voulu m’inſtruire,	Des ordres de César j’aurais voulu m’instruire,
Tullus que dés long-temps j'ay dépêché vers luy,	Tullus que dès longtemps j’ai dépêché vers lui,
De Rome auprés de moy doit ſe rendre aujourd’huy,	De Rome auprès de moi doit se rendre aujourd’hui,
Qu'un moment paroît long à mon impatience,	Qu’un moment paraît long à mon impatience,
Mais on vient, & je crois: ouy c’eſt luy qui s’avance.	Mais on vient, et je crois: oui, c’est lui qui s’avance.
EH bien Tullus, Eh bien! qu’eſt-ce qu’on me preſcrit!	Eh bien, Tullus, Eh bien? qu’est ce qu’on me prescrit!
Qu'ay-je à faire?	Qu’ai-je à faire?
Seigneur, l’Empereur vous écrit,	Seigneur, l'Empereur vous écrit,
Des ordres de Ceſar inſtruiſez-vous vous-même,	Des ordres de César instruisez-vous vous-même,
Liſez & connoiſſez ſa volonté ſuprême.	Lisez et connaissez sa volonté suprême.
Je ſuis content des ſoins que vous prenez	Je suis content des soins que vous prenez
Pour ranger les Germains ſous mon obeïſſance,	Pour ranger les Germains sous mon obéissance,
Continuez Varus, & vous reſouvenez	Continuez Varus, et vous ressouvenez
Que ce qu’on fait pour moy n'eſt pas ſans recompenſe,	Que ce qu’on fait pour moi n’est pas sans récompense,
Je n’ay qu’un ordre à vous donner,	Je n’ai qu’un ordre à vous donner,
Qu'Arminius par vous ſoit pourſuivy ſans ceſſe,	Qu’Arminius par vous soit poursuivi sans cesse,
Employez pour le perdre, & la force, & l’adreſſe,	Employez pour le perdre, et la force, et l’adresse,
Je vous deffens de l’épargner.	Je vous défends de l’épargner.
O Ciel!	Ô ciel!
Qu’a-donc pour vous cét ordre de funeſte?	Qu’a-donc pour vous cet ordre de funeste?
Plaignez-vous l’ennemy que l’Empereur deteſte?	Plaignez-vous l’ennemi que l’Empereur déteste?
Je fonde ſur ſa mort le bon-heur de mes jours,	Je fonde sur sa mort le bonheur de mes jours,
Et je n’oſe des ſiens faire trancher le cours,	Et je n’ose des siens faire trancher le cours,
Arminius eſt cher à l'objet que j'adore,	Arminius est cher à l’objet que j’adore,
J’en ſuis hay, faut-il que je me charge encore	J’en suis haï, faut-il que je me charge encore,
De l’invincible horreur que la mort d’un Amant	De l’invincible horreur que la mort d’un Amant
Luy donneroit pour moy juſqu’au dernier moment?	Lui donnerait pour moi jusqu’au dernier moment?
De quel front oſerois-je aborder Iſmenie	De quel front oserai-je aborder Isménie
Du ſang d'Arminius ma main encor rougie?	Du sang d’Arminius ma main encore rougie?
Teint d’un ſang chery voudroit-elle épouſer	Teinte d’un sang chéri voudrait-elle épouser
Celuy qu’innocent meſme elle oſe refuſer?	Celui qu’innocent même elle ose refuser?
Ah! ſans trahir Auguſte, & la cauſe publique,	Ah! sans trahir Auguste, et la cause publique,
Accordons ma tendreſſe avec ma politique,	Accordons ma tendresse avec ma politique,
En aſſurant icy les loix de l’Empereur,	En assurant ici les lois de l’Empereur,
Aſſurons, s’il ſe peut, le repos de mon cœur,	Assurons, s’il se peut, le repos de mon cœur,
Que par la main d’un autre Arminius periſſe,	Que par la main d’un autre Arminius périsse,
Qu'Iſmenie en pleurant ce ſanglant ſacrifice,	Qu’Isménie en pleurant ce sanglant sacrifice,
Ne me reproche point la ſource de ſes pleurs,	Ne me reproche point la source se ses pleurs,
Et porte ſon courroux & ſa vangeance ailleurs.	Et porte son courroux et sa vengeance ailleurs.
Eh! qui l’immolera ſi vous luy faites grace?	Eh! qui l’immolera si vous lui faites grâce?
Qui punira, Seigneur, ſa criminelle audace?	Qui punira, Seigneur, sa criminelle audace?
Segeſte, avec plaiſir prendra ce triſte employ,	Ségeste, avec plaisir prendra ce triste emploi,
Arminius luy fait plus d’ombrage qu’à moy,	Arminius lui fait plus d’ombrage qu’à moi,
Ce jeune Chef par tout ſuivy de la victoire	Ce jeune Chef partout suivi de la victoire
Des exploits de Segeſte a ſurpaſſé la gloire;	Des exploits de Ségeste a surpassé la gloire;
Les peuples, les ſoldats charmez de ſa valeur	Les peuples, les soldats charmés de sa valeur
L’ont honoré du nom de leur liberateur,	L’ont honoré du nom de leur libérateur,
Tous couroient le chercher d’une ardeur empreſſée,	Tous courraient le chercher d’une ardeur empressée,
Et Segeſte décheu de ſa grandeur paſſée	Et Ségeste déchu de sa grandeur passée
S’eſt rangé parmy nous pour s’épargner l'ennuy	S’est rangé parmi nous pour s’épargner l’ennui
De le voir plus illuſtre & plus aimé que luy.	De le voir plus illustre et plus aimé que lui.
Mais le voicy.	Mais le voici.
SEigneur, ſur de juſtes allarmes	Seigneur, sur de justes alarmes
Tout le Camp ſe prepare & chacun prend les armes,	Tout le Camp se prépare et chacun prend les armes,
On vient de m’avertir que ſur la fin du jour	On vient de m’avertir que sur la fin du jour
Nos ennemis ſortoient des foreſts d’alentour,	Non ennemis sortaient des forêts alentour,
Qu'ils s’avançoient vers nous: Ils ont apris peut-eſtre	Qu’ils s'avançaient vers nous: Ils ont appris peut-être
Les extrêmes perils, la priſon de leur maître,	Les extrêmes périls, la prison de leur maître,
Ils craignent en ces lieux de voir trancher ſes jours,	Ils craignent en ces lieux de voir trancher ses jours,
Et pleins d’amour pour luy volent à ſon ſecours,	Et pleins d’amour pour lui volent à son secours,
Je ne le cele point, Arminius me gêne,	Je ne cèle point, Arminius me gêne,
Que pouvons-nous reſoudre?	Que pouvons-nous résoudre?
Allez, qu’on me l’ameine,	Allez, qu'on me l'amène,
Vous Tullus, vers nos Chefs précipitez vos pas	Vous Tullus, vers nos Chefs précipitez vos pas
Que chacun au combat diſpoſe ſes ſoldats,	Que chacun au combat dispose ses soldats,
Je vous ſuivray de prés. Si l’ennemy s’avance	Je vous suivrai de près. Si l’ennemi avance
Vous reviendrez de tout m’inſtruire en diligence.	Vous reviendrez de tout m’instruire en diligence.
QU’avez-vous reſolu, Seigneur? vous flatez-vous	Qu’avez-vous résolu, Seigneur? vous flattez-vous
De vaincre Arminius, de l'attacher à nous?	De vaincre Arminius, de l’attacher à nous?
Je ne ſçay, mais je vais du moins luy faire entendre	Je ne sais, mais je vais du moins lui faire entendre
Le deſtin qu’en ces lieux ſa fierté doit attendre,	Le destin qu’en ces lieux sa fierté doit attendre,
Je vais luy preſenter les ſupplices tout prêts,	Je vais lui présenter les supplices tout prêts,
Peut-eſtre qu’à ſes yeux paroiſſant de plus prés,	Peut-être qu’à leur yeux paraissant de plus près,
Leur funeſte appareil malgré toute ſa haine	Leur funeste appareil malgré toute sa haine
Donnera quelque crainte à ſon ame hautaine.	Donnera quelque crainte à son âme hautaine.
Ah! ne l’eſperez pas, ce farouche ennemy	Ah! ne l’espérez pas, ce farouche ennemi
A mépriſer la mort n’eſt que trop affermy,	À mépriser la mort n’est que trop affermi,
Vous-même l’avez veu dans la guerre paſſée....	Vous-même l’avez vu dans la guerre passée…
Seigneur, les temps divers font changer de penſée,	Seigneur, les temps divers font changer de pensée,
Le plus grand cœur s'effraye aux apreſts du trépas,	Le plus grand cœur s’effraie aux apprêts du trépas,
Tel l’a bravé cent fois au milieu des combats,	Tel l’a bravé cent fois au milieu des combats,
Et veu d’un front ſerain la mort preſque infaillible,	Et vu d’une front certain la mort presqu’infaillible,
Qui n’a jamais conceu tout ce qu’elle a d’horrible,	Qui n’a jamais conçu tout ce qu’elle a d’horrible,
Un eſprit enflamé d’une noble chaleur,	Un esprit enflammé d’une noble chaleur,
Pouſſé par la vangeance, ou flatté par l’honneur,	Poussé par la vengeance, ou flatté par l’honneur,
Occupe des moyens d’emporter la victoire	Occupé des moyens d’emporter la victoire
Ne laiſſe alors les yeux ouverts que pour la gloire,	Ne laisse alors les yeux ouverts que pour le gloire,
Et fait que le guerrier jaloux de l’acquerir	Et fait que le guerrier jaloux de l’acquérir
Vole aprés les dangers & s'expoſe à mourir;	Vole après les dangers et s’expose à mourir;
Mais ce même guerrier dans un état tranquille,	Mais ce même guerrier dans un état tranquille,
Menacé d’une mort à ſa gloire inutile,	Menacé d’une mort à sa gloire inutile,
D’une mort odieuſe, & qu’il ne cherche pas,	D’une mort odieuse, et qu’il ne cherche pas,
N’eſt plus tel qu’il eſtoit au milieu des combats,	N’est plus tel qu’il était au milieu des combats,
Il fait voir ſa foibleſſe, il fremit, il murmure,	Il fait voir sa faiblesse, il frémit, il murmure,
L’eſprit moins prevenu laiſſe agir la nature,	L’esprit moins prévenu laisse agir la nature,
Et le trépas alors luy devient un objet	Et le trépas alors lui devient un objet
Plus redoutable encor qu’il ne l’eſt en effet.	Plus redoutable encor qu’il ne l’est en effet.
Non, non, Arminius à tout ce qu’on prépare	Non, non, Arminius à tout ce qu’on prépare
Oppoſera, Seigneur, ſa conſtance barbare;	Opposera, Seigneur, sa constance barbare;
Mais s’il ne ſe rend point, ceſſez de ménager	Mais s’il ne se rend point, cessez de ménager
Un ennemy toûjours prompt à vous outrager,	Un ennemi toujours prompt à vous outrager,
Et repouſſant d’un coup tous ceux qu’il nous aprête,	Et repoussant d’un coup tous ceux qu’il nous apprête,
A ſes troupes, Seigneur, faites porter ſa teſte,	À ses troupes, Seigneur, faites porter sa tête,
Alors tout fléchira. Rien ne peut réſiſter.	Alors tout fléchira. Rien ne peut résister.
Qu'attendez-vous? faut-il encore conſulter?	Qu’attendez-vous? faut-il encore consulter?
Non, ne differons plus une vangeance juſte,	Non, ne différons plus une vengeance juste,
Allons, executons les volontez d’Auguſte,	Allons, exécutons les volontés d’Auguste,
Hâtons-nous d’immoler un Rival odieux,	Hâtons-nous d’immoler un Rival odieux,
Et laiſſons l’avenir entre les mains des Dieux.	Et laissons l’avenir entre les mains des Dieux.
Prononcés donc, Seigneur, l'Arreſt de ſon ſuplice,	Prononcez donc, Seigneur, l’Arrêt de son supplice,
De ſon ſang à Ceſar offrez le ſacrifice,	De son sang à César offrez le sacrifice,
Commandez. Un ſeul mot: mais ſçachons....	Commandez. Un seul mot: mais sachons…
AH! Seigneur,	Ah! Seigneur.
Eh bien! Arminius?	Eh bien! Arminius?
Aprenez un malheur	Apprenez un malheur
Dont je fremis encore & qui va vous ſurprendre,	Dont je frémis encore et qui va vous surprendre,
Sunnon vous a trahy.	Sunnon vous a trahi.
Dieux!	Dieux!
Que viens-je d'entendre?	Que viens-je d'entendre?
On ne le trouve plus. Dans l’ombre de la nuit	On ne le trouve plus. Dans l’ombre de la nuit
Avec Arminius il s’eſt coulé ſans bruit,	Avec Arminius il s’est coulé sans bruit,
Tous ceux qu’il commandoit interdits & timides,	Tout ceux qu’il commandait interdits et timides,
Acuſer par ſes ſoins ignorant.....	Accuser pas ses soins ignorant…
Les perfides!	Les perfides!
Tous m’ont manqué de foy, je vay les punir tous,	Tous m’ont manqué de foi, je vais les punir tous,
A peine tout leur ſang ſuffit à mon courroux,	À peine tout leur sang suffit à mon courroux,
Mille morts.....	Mille morts…
NOn, Seigneur, connoiſſez le coupable,	NOn, Seigneur, connaissez le coupable,
Ne portez point ailleurs ce courroux redoutable,	Ne portez point ailleurs ce courroux redoutable,
Dans le ſang innocent ne trempez point vos mains,	Dans le sang innocent ne trempez point vos mains,
Perdez-moy, j’ay tout fait. J’ay trompé vos deſſeins,	Perdez-moi, j’ai tout fait. J’ai trompé vos desseins,
J'ay fait partir Sunnon, je l’ay preſſé....	J’ai fait partir Sunnon, je l’ai pressé…
Toy traître!	Toi traître!
Tu trahis les Romains & ton pere & ton maître?	Tu trahis les Romains et ton père et ton maître?
Tu ſers un ennemy par nos ſoins abbatu?	Tu sers un ennemi par nos soins abattu?
Qui te le fait ſervir contre nous....	Qui te le fait servir contre nous…
Sa vertu.	Sa vertu.
Sa valeur, ſes exploits qu’en tous lieux on renomme,	Sa valeur, ses exploits qu’en tous lieux on renomme,
L’amour de ma Patrie, & ma haine pour Rome,	L’amour de ma Patrie, et ma haine de Rome,
Le ſoin de voſtre honneur, mon amitié pour luy,	La soin de votre honneur, mon amitié pour lui,
Tout m’a ſollicité de luy ſervir d’appuy.	Tout m’a sollicité de lui servir d’appui.
Eh quoy! pouvois-je voir ce Prince magnanime	Eh quoi! pouvais-je voir ce Prince magnanime
Des Romains, de Varus, devenir la victime?	Des Romains, de Varus, devenir la victime?
Et vos mains ſe foüiller de ſon ſang précieux	Et vos mains se fouiller se son sang précieux
Conſacré par les loix, par ſon rang, par les Dieux;	Consacré par les lois, par son rang, par les Dieux;
Pouvois-je voir, Seigneur, la truſte Germanie	Pouvais-je voir, Seigneur, la triste Germanie
Perdre ſon deffenſeur contre la tyrannie;	Perdre son défenseur contre la tyrannie;
Et Polixene en proye à ſes vives douleurs	Et Polixène en proie à ses vives douleurs
Me demander ſon frere, & m'accabler de pleurs;	Me demander son frère, et m’accabler de pleurs;
J'ay remply mon devoir, Seigneur, faites le voſtre,	J’ai rempli mon devoir, Seigneur, faites le vôtre,
Je ſauve une victime, & vous en livre une autre,	Je sauve une victime, et vous en livre une autre,
Si par ce que j'ay fait vous eſtes outragé,	Si par ce que j’ai fait vous êtes outragé,
Il ne tient plus qu'à vous d'eſtre bien-toſt vangé,	Il ne tient plus qu’à vous d’être bientôt vengé,
Verſez, verſez du ſang: mais changez de victime,	Versez, versez du sang: mais changez de victime,
Répandez tout le mien ſans ſcrupule, & ſans crime,	Répandez tout le mien sans scrupule, et sans crime,
Si j'avois craint la peine, & l'horreur du trépas,	Si j’avais craint la peine, et l’horreur du trépas,
Du Prince Arminius j'aurois ſuivy les pas,	Du Prince Arminius j’aurais suivi les pas,
Mais je n'ay pas voulu que vos coups redoutables	Mais je n’ai pas voulu que vos coups redoutables
Tombaſſent ſur des cœurs qui ne ſont point coupables,	Tombassent sur des cœurs qui ne sont point coupables,
Au gré de voſtre haine ordonnez de mon ſort,	Au gré de votre haine ordonnez de mon sort,
Je ne m'en plaindray pas; trop heureux ſi ma >mort	Je ne m’en plaindrai pas; trop heureux si ma mort
D'un reproche honteux ſauvant voſtre memoire	D’un reproche honteux sauvant votre mémoire
Aux dépens de ma vie aſſure voſtre gloire.	Aux dépends de ma vie assure votre gloire.
Ouy! lâche tu mourras puiſque tu me trahis.	Oui! lâche tu mourras puisque tu me trahis.
Ingrat, quelle fureur agite vos eſprits?	Ingrat, quelle fureur agite vos esprits?
Ouy puiſez-vous l'excés de cette haine injuſte?	Où puisez-vous l’excès de cette haine injuste?
Vous, de tant de biensfaits honoré par Auguſte	Vous, de tant de bienfaits honoré par Auguste?
Comblé par le Senat de graces & d'honneur....	Comblé par le Sénat de grâces et d’honneur…
Ne me reprochez point vos indignes faveurs,	Ne me reprochez point vos indignes faveurs,
Lors qu'à m'en accabler voſtre Senat s'aplique,	Lorsqu’à m’en accabler votre Sénat s’applique,
Dans ſes fauſſes bontez je voy ſa politique,	Dans ses fausses bontés je vois sa politique,
Et ces fiers ennemis devenus complaiſans	Et ces fiers ennemis devenus complaisants
Me font plus leurs coups redouter leurs preſens;	Me font plus leurs coups redouter leurs présents;
Eh! qu'ay-je affaire, ô Dieux de la grandeur Romaine?	Eh! qu’ai-je affaire, ô Dieux de la grandeur Romaine?
Que me ſert-elle, helas! ſi je perds Polixene?	Que me sert-elle, hélas! si je perds Polixène?
Ouy, Ceſar, ſi par toy je m'en voyois priver,	Oui, César, si par toi je m’en voyais priver,
Quand ſa perte à ton rang me devroit élever,	Quand sa perte à ton rang me devrait élever,
Dans mon cœur indigne de cette recompenſe	Dans mon cœur indigné de cette récompense
La haine tiendroit lieu de la reconnoiſſance.	La haine tiendrait lieu de reconnaissance.
Eh quoy! tous tes preſens, ta liberalité	Eh quoi! tous tes présents, ta libéralité
Me pourroient-ils jamais payer ma liberté?	Me pourraient-ils jamais payer ma liberté?
J'aurois des fers dorez; mais je ſerois eſclave.	J’aurais des fers dorés; mais je serais esclave.
Je ne puis rien ſouffrir que me gêne, ou m brave,	Je ne puis rien souffrir qui me gêne, ou me brave,
Et ne connois pour maiſtre en terre, & dans les Cieux,	Et ne connais pour maître en terre, et dans les Cieux,
Que la vertu, l'honneur, la juſtice, & les Dieux.	Que la vertu, l’honneur, la justice et les Dieux.
Pourquoy veniez-vous donc ame ingratte, & perfide,	Pourquoi veniez-vous donc âme ingrate et perfide,
Suivre depuis deux mois noſtre Aigle qui vous guide,	Suivre depuis deux mois notre Aigle qui vous guide,
Quel charme, quel deſſein vous conduit parmy nous!	Quel charme, quel dessein vous conduit parmi nous!
Le glorieux deſir de m'inſtruire avec vous,	Le glorieux désir de m’instruire avec vous,
D'apprendre de plus prés ce grand Art de la guerre,	D’apprendre de plus près ce grand Art de la guerre,
Qui vous a fait dompter preſque toute la terre;	Qui vous a fait dompter presque toute la terre;
D'en joindre la pratique à ce que nous ſçavons,	D’en joindre la pratique à ce que nous savons,
Et de vous vaincre un jour par vos propres leçons.	Et de vous vaincre un jour par vos propres leçons.
Juſte Ciel! puis-je encor retenir ma colere?	Juste Ciel! puis-je encor retenir ma colère?
Sçaurois-je aſſez punir ce diſcours temeraire?	Saurais-je assez punir ce discours téméraire?
Rendez graces au ſang dont vous eſtes ſorty.	Rendez grâces au sang dont vous êtes sorti.
Il n'eſt plus de mon ſang s'il quitte mon party;	Il n’est plus de mon sang s’il quitte mon parti;
Fait Citoyen Romain j'en ay pris les maximes;	Fait Citoyen Romain j’en ai pris les maximes;
Mon fils n'eſt plus mon fils, traiſtre, couvert de crimes,	Mon fils n’est plus mon fils, traître, couvert de crimes,
Brutus & Manlius m'ont tracé le chemin,	Brutus et Manlius m’ont tracé le chemin,
Je le ſuivray, Seigneur, & de ma propre main	Je le suivrai, Seigneur, et de ma propre main
Immolant ſans pitié ce fils lâche & rebelle,	Immolant sans pitié ce fils lâche et rebelle,
Je ſçauray me couvrir d'une gloire immortelle,	Je saurais me couvrir d’une gloire immortelle,
Vanger l'honneur de Rome à mes yeux profané,	Venger l’honneur de Rome à mes yeux profané,
Et meriter le nom que vous m'avez donné.	Et mériter le nom que vous m’avez donné.
Quoy Seigneur....	Quoi, Seigneur…
Puniſſons ma coupable famille,	Punissons ma coupable famille,
Dans ce fatal moment je haïs juſqu'à ma fille;	Dans ce fatal moment je hais jusqu’à ma fille;
Sans doute elle eſt complice, & du moins de ſes vœux,	Sans doute elle est complice, et du moins de ses vœux,
Elle a favoriſé ſon Amant mal-heureux,	Elle a favorisé son Amant malheureux,
Je veux que l'Univers étonné du ſupplice....	Je veux que l’Univers étonné du supplice…
AReſte, Pere aveugle, & voy ton injuſtice,	ARrête, Père aveugle, et vois ton injustice,
Epargne tes Enfans, & ton fier courroux,	Épargne tes Enfants, et ton fier courroux,
Sur Polixene ſeule épuiſe tous les coups,	Sur Polixène seule épuise tous les coups,
L'amour dans Sigiſmond a vaincu la nature,	L’amour dans Sigismond a vaincu la nature,
Et ſi tu veux punir l'autheur de ton injure,	Et si tu veux punir l’auteur de ton injure,
C'eſt moy: voy dans mes yeux le ſouverain pouvoir	C’est moi: vois dans mes yeux le souverain pouvoir
Par qui ton fils forcé s'oppoſe à ton eſpoir,	Par qui ton fils forcé s’oppose à ton espoir,
Ne delibere plus, me voila toute prête,	Ne délibère plus, me voilà toute prête,
Je m'offre à ta fureur. Mais qu'eſt-ce qui t'arreſte?	Je m’offre à ta fureur. Mais qu’est ce qui t’arrête?
A me donner la mort, faut-il t'encourager?	À me donner la mort, faut-il t’encourager?
N'oſes-tu te baigner dans un ſang étranger;	N’oses-tu te baigner dans un sang étranger;
Toy, qui voulois verſer celuy de ta famille?	Toi, qui voulais verser celui de ta famille?
Ou peut-eſtre crains-tu de punir une fille?	Ou peut-être crains-tu de punir une fille?
Mais ceſſe d'épargner la ſœur d'Arminius,	Mais cesse d’épargner la sœur d’Arminius,
Segeſte, Souviens-t'en, Toy penſes-y, Varus,	Ségeste, Souviens-t-en, Toi penses-y, Varus,
J'ay mêmes ſentimens, même cœur que mon frere,	J’ai mêmes sentiments, même cœur que mon frère,
Je le feray contre vous plus qu'il n'a voulu faire,	Je le ferai contre vous plus qu’il n’a voulu faire,
Si je ne puis verſer du ſang dans les combats,	Si je ne puis verser du sang dans les combats,
Je puis par mes diſcours animer les ſoldats,	Je puis pas mes discours animer les soldats,
Et ſuivant les tranſports de l'ardeur qui m'entraîne,	Et suivant les transports de l’ardeur qui m’entraîne,
Contre Rome en tous lieux faire éclater ma haine,	Contre Rome en tous lieux faire éclater ma haine,
L'inſpirer à cent Rois abuſez ou ſoûmis,	L’inspirer à cent Rois abusés ou soumis,
Et vous faire par tout de nouveaux ennemis.	Et vous faire partout de nouveaux ennemis.
Helas! que faites-vous, & voulez-vous, Madame,	Hélas! que faites-vous, et voulez-vous, Madame,
Ebranler mon courage, intimider mon ame?	Ébranler mon courage, intimider mon âme?
Je m'offrois à la mort ſans trouble, ſans douleur,	Je m’offrais à la mort sans trouble, sans douleur,
Ah! venez-vous....	Ah! venez-vous…
Je viens partager ton malheur	Je viens partager ton malheur
Puiſqu'un ſaint nœud n'a pû lier nos deſtinées,	Puisqu’un saint nœud n’a pu lier nos destinées,
Que par la mort au moins elles ſoient enchaînées,	Que par la mort au moins elles soient enchaînées,
Que tu ne vives pas un inſtant aprés moy,	Que tu ne vives pas un instant après moi,
Que je ne pouſſe pas un ſoûpir aprés toy.	Que je ne pousse pas un soupir après toi.
Quel diſcours! quel deſſein! enfin, que puis-je faire?	Quel discours! quel dessein! enfin, que puis-je faire?
Faut-il....	Faut-il…
Voſtre preſence au Camp eſt neceſſaire,	Votre présence au Camp est nécessaire,
On entend dans les airs mille cris confondus	On entend dans les airs mille cris confondus
Qui pouſſent juſqu'icy le nom d'Arminius,	Qui poussent jusqu’ici le nom d’Arminius,
Il vient fondre ſur nous, & malgré la nuit ſombre,	Il vient fondre sur nous, et malgré la nuit sombre,
De ſes troupes, Seigneur, on découvre le nombre.	De ses troupes, Seigneur, on découvre le nombre.
Nos Chefs & nos ſoldats au combat préparez	Nos Chefs et nos soldats au combat préparés
N'attendent que l'employ que vous leur donnerez,	N’attendent que l’emploi que vous leur donnerez,
Tous à l'envy...	Tous à l’envi…
Marchons, venez punir l'audace	Marchons, venez punir l'audace
De ce jeune orgueilleux qui court à ſa diſgrace.	De ce jeune orgueilleux qui court à sa disgrâce.
Je vous ſuis Sinorix gardez ce criminel,	Je vous suis. Sinorix gardez ce criminel,
Ce rebelle chargé du courroux paternel,	Ce rebelle chargé du courroux paternel,
Me puniſſent les Dieux que ma fureur atteſte,	Me punissent les Dieux que ma fureur atteste,
Si je l'épargne aprés ſa trahiſon funeſte.	Si je l’épargne après sa trahison funeste.
NE ſçaurons-nous jamais quel ſera nôtre ſort?	NE saurons-nous jamais quel sera notre sort?
Cét état incertain eſt pire que la mort,	Cet état incertain est pire que la mort,
Helas! chacun de nous tremblant pour ce qu'il aime,	Hélas! chacun de nous tremblant pour ce qu’il aime,
A peine en ce moment ſe ſouvient de luy-même;	À peine en ce moment se souvient de lui-même;
De ce fatal combat que je crains le ſuccés?	De ce fatal combat que je crains le succès?
J'y vois de toutes parts de ſiniſtres effets,	J’y vois de toutes parts de sinistres effets,
Où mon Pere expirant, où mon amy ſans vie,	Ou mon Père expirant, ou mon ami sans vie,
Et peut-eſtre ſa mort de la vôtre ſuivie;	Et peut-être sa mort de la vôtre suivie;
Que ſupplice? grands Dieux! où me vois-je reduit?	Quel supplice? grands Dieux! où me vois-je réduit?
O courroux! ô rigueur du Ciel qui nous pourſuivit;	Ô courroux! ô rigueur du Ciel qui nous poursuit;
Que de ſoûpirs perdus! que d'inutiles plaintes;	Que de soupirs perdus! que d’inutiles plaintes;
Toûjours des ſoins nouveaux? & de nouvelles craintes:	Toujours des soins nouveaux? et de nouvelles craintes:
Eſt-ce là le bonheur que j'avois attendu?	Est-ce là le bonheur que j’avais attendu?
Mais Barſine revient.	Mais Barsine revient.
Parle, n'as-tu rien veu,	Parle, n'as-tu rien vu,
Ne nous déguiſe rien.	Ne nous déguise rien.
Je ne puis vous apprendre,	Je ne puis vous apprendre,
Que ce qu'un bruit confus vient de me faire entendre,	Que ce qu’un bruit confus vient de me faire entendre,
J'eſtois prés de ces lieux où j'ay de toutes parts,	J’étais près de ces lieux où j’ai de toutes parts,
Promené vainement mes curieux regards,	Promené vainement mes curieux regards,
Je n'ay pû rien connoiſtre, & ma timide veuë	Je n’ai pu rien connaître, et ma timide vue
Dans mille objets affreux s'eſt d'abord confonduë,	Dans mille objets affreux s’est d’abord confondue,
Les clameurs des ſoldats mourans, ou renverſez,	Les clameurs des soldats mourants, ou renversés,
Les cris des combatans, les plaintes des bleſſez,	Les cris des combattants, les plaintes des blessés,
Le carnage, le ſang, l'horreur, le bruit des armes,	Le carnage, le sang, l’horreur, le bruit des armes,
Ont étonné mon cœur, & fait couler mes larmes,	Ont étonné mon cœur, et fait couler mes larmes,
Je n'ay pû ſoûtenir ce ſpectacle ſanglant,	Je n’ai pu soutenir ce spectacle sanglant,
J'ay fremy, j'ay couru vers ces lieux en tremblant,	J’ai frémi, j’ai couru vers ces lieux en tremblant,
Où des ſoldats Romains la joye & le langage	Où des soldats Romains la joie et le langage
M'ont apris que Varus avoit tout l'avantage,	M’ont appris que Varus avait tout l’avantage,
Et que l'injuſte ſort ſecondant ſes deſſeins,	Et que l’injuste sort secondant ses desseins,
Se déclaroit, Madame, en faveur des Romains.	Se déclarait, Madame, en faveur des Romains.
Ne nous flatons donc plus, nôtre perte eſt certaine,	Ne nous flattons donc plus, notre perte est certaine,
Vôtre Pere & Varus vont aſſouvir leur haine.	Votre père et Varus vont assouvir leur haine.
Helas Madame!	Hélas Madame!
Eh quoy! Prince vous ſoûpirez;	Eh quoi! Prince vous soupirez;
Juſte Ciel, eſt-ce ainſi que vous me raſſurez;	Juste Ciel, est-ce ainsi que vous me rassurez;
Penſez-vous que frapé du peril qui nous preſſe	Pensez-vous que frappé du péril qui nous presse
Mon cœur en ce moment ſoit exempt de foibleſſe;	Mon cœur en ce moment soit exempt de faiblesse;
Je la cache à vos yeux pour ne pas redoubler	Je la cache à vos yeux pour ne pas redoubler
Des tourmens aſſez grands pour vous faire trembler,	Des tourments assez grands pour vous faire trembler,
Je vous cache la mienne, ah! cachez-moy la vôtre,	Je vous cache la mienne, ah! cachez-moi la vôtre,
Raſſurons-nous plûtoſt, aidons-nous l'un & l'autre?	Rassurons-nous plutôt, aidons-nous l’un et l’autre?
Je ſens qu'il eſt cruel d'eſtre privé du jour,	Je sens qu’il est cruel d’être privé du jour,
Lors qu'on fait ſon bonheur d'un mutuel amour,	Lorsqu’on fait son bonheur d’un mutuel amour,
Toutefois dans la mort que le Ciel nous envoye,	Toutefois dans la mort que le Ciel nous envoie,
Nos cœurs doivent trouver quelque ſujet de joye,	Nos cœurs doivent trouver quelque sujet de joie,
Nous mourrons ſatisfaits, vous de moy, & moy de vous,	Nous mourrons satisfaits, vous de moi, et moi de vous,
Nous n'avons ny ſoupçons, ny mouvemens jaloux,	Nous n’avons ni soupçons, ni mouvements jaloux,
Cher Prince, nôtre ſort eſt plus doux qu'il ne ſemble,	Cher Prince, notre sort est plus doux qu’il ne semble,
Nous mourrons l'un pour l'autre, & nous mourrons enſemble.	Nous mourrons l’un pour l’autre, et nous mourrons ensemble.
Oüy, dans vôtre malheur vous eſtes trop heureux,	Oui, dans votre malheur vous êtes trop heureux,
Un ſemblable deſtin attire tous mes vœux;	Un semblable destin attire tous mes vœux;
Mais moy de mon Amant abſente, ſeparée,	Mais moi de mon Amant absente, séparée,
Des Maux que vous ſouffrez comme vous déchirée,	Des Maux que vous souffrez comme vous déchirée,
Je ne ſçaurois helas! pour flatter mon ennuy	Je ne saurais hélas! pour flatter mon ennui
Le voir, ny luy parler, ny mourir avec luy,	Le voir, ni lui parler, ni mourir avec lui,
Eh quoy! que chez les morts je m'apreſte à le ſuivre?	Et quoi que chez les morts je m’apprête à le suivre?
J'auray le déplaiſir d'avoir pû luy ſurvivre,	J’aurai le déplaisir d’avoir pu lui survivre,
O Dieux! en cét inſtant peut-eſtre que Varus	Ô dieux! en cet instant peut-être que Varus
Pere d'un trait fatal le cœur d'Arminius?	Perce d’un trait fatal le cœur d’Arminius?
Peut-eſtre de ſoldats une troupe barbare	Peut-être de soldats une troupe barbare
Foule ſa teſte auguſte, ou du corps la ſepare,	Foule sa tête auguste, ou du corps la sépare,
Et portant ſur un Dard ce treſor précieux,	Et portant sur un Dard ce trésor précieux,
En fait à tout le Camp un trophée odieux?	En fait à tout le Camp un trophée odieux?
Juſte Ciel quel objet! mais j'aperçois mon Pere,	Juste Ciel quel objet! mais j’aperçois mon Père,
Et je vois dans ſes yeux éclater ſa colere,	Et je vois dans ses yeux éclater sa colère,
C'en eſt fait, n'attendons qu'un trépas rigoureux.	C’en est fait, n’attendons qu’un trépas rigoureux.
Traiſtres, les Dieux cruels on exaucé vos vœux;	Traîtres, les Dieux cruels ont exaucé vos vœux;
Du ſang de mes Soldats, & des Troupes Romaines	Du sang de mes Soldats et des Troupes Romaines
Le fier Arminius vient de couvrir vos plaines,	Le fier Arminius vient de couvrir vos plaines,
Mais de ce grand ſuccés vous ne joüirez pas,	Mais de ce grand succès vous ne jouirez pas,
Et loin que ſon triomphe ait pour luy des appas,	Et loin que son triomphe ait pour lui des appas,
Luy-même il pleurera, du moins j'oſe le croire,	Lui-même il pleurera, du moins j’ose le croire,
L'avantage fatal de ſa triſte victoire,	L’avantage fatal de sa triste victoire,
Puis qu'il perd aujourd'huy pour nous avoir défaits,	Puisqu’il perd aujourd’hui pour nous avoir défaits,
Le plaiſir & l'eſpoir de vous revoir jamais;	Le plaisir et l’espoir de vous revoir jamais;
Varus encor ſuivy des reſtes de l'Armée	Varus encor suivi des restes de l’Armée
Soûtient d'Arminius la valeur enflammée,	Soutient d’Arminius la valeur enflammée,
Il l'arreſte, & je viens pour vous enlever tous	Il l’arrête, et je viens pour vous enlever tous
Aux vœux d'un Ennemy qui ne cherche que vous;	Aux vœux d’un Ennemi qui ne cherche que vous;
Venez, venez à Rome, où Varus vous envoye,	Venez, venez à Rome, où Varus vous envoie,
Je vais vous y mener, & je ſens quelque joye	Je vais vous y mener, et je sens quelque joie
A penſer que le Chef de nos heureux Vainqueurs	À penser que le Chef de nos heureux Vainqueurs
Honorera bien-toſt ma fuite de ſes pleurs:	Honorera bientôt ma fuite de ses pleurs:
Gardes qu'on les conduiſe; allons, c'eſt trop attendre	Gardes qu’on les conduise; allons, c’est trop attendre
Marchons.	Marchons.
IL n'eſt plus temps, & ſongez à vous rendre,	IL n'est plus temps, et songez à vous rendre,
Seigneur, tous mes Soldats ſont diſperſez ou morts,	Seigneur, tous mes Soldats sont dispersés ou morts,
Arminius me ſuit tout cede à ſes efforts,	Aminius me suit, tout cède à ses efforts,
Et Varus animé d'un genereux courage	Et Varus animé d’une généreux courage
Vient de meſler ſon ſang au reſte du carnage.	Vient de mêler son sang au reste du carnage.
Il eſt mort!	Il est mort!
Oüy, Seigneur, en Heros, en Romain,	Oui, Seigneur, en Héros, en Romain,
En bravant l'injuſtice, & les coups du deſtin;	En bravant l’injustice, et les coups du destin;
Aprés avoir trois fois par des faits incroyables	Après avoir trois fois par des faits incroyables
Soûtenu des Germains les aſſauts redoutables,	Soutenu des Germains les assauts redoutables,
De ruiſſeaux de leur ſang inondé les ſillons,	De ruisseaux de leur sang inondé les sillons,
Et preſque renverſé leur épais bataillons,	Et presque renversé leurs épais bataillons,
Il voit de toutes parts ſes troupes fugitives,	Il voit de toutes parts ses troupes fugitives,
Et ne peut raſſembler ſes Legions craintives	Et ne peut rassembler les légions craintives
Alors demeuré ſeul encore il ſe deffend,	Alors demeuré seul, encore il se défend,
Et fait ſentir la crainte aux Vainqueurs qu'il attend;	Et fait sentir la crainte aux vainqueurs qu’il attend;
Ils n’oſent l'aborder, ſa fierté les étonne,	Il n’osent l’aborder, sa fierté les étonne,
Toutefois à grands flots leur troupe l'environne,	Toutefois à grands flots leur troupe l’environne,
Et honteux de ſe voir par luy ſeul arreſtez,	Et honteux de se voir par lui seul arrêtés,
Luy pouſſent à l’envi cent coups precipitez;	Lui poussent à l’envi cent coups précipités;
Son ſang coule auſſi-toſt, il le void, & rappelle	Son sang coule aussitôt, il le voit, et rappelle
De ſa force épuiſée une force nouvelle,	De sa force épuisée une force nouvelle,
C’eſt aſſez, a-t'il dit, ah! ne permettons pas	C’est assez, a-t-il dot, ah! ne permettons pas
Que mes jours ſoient tranchez par d'indignes Soldats,	Que mes jours soient tranchés par d’indignes Soldats.
Sur tout, épargnons-nous la rage & l’infamie	Surtout épargnons-nous la rage et l’infamie
De devoir au Vainqueur le reſte de ma vie:	De devoir au Vainqueur le reste de ma vie:
Il ſe frappe à ces mots; mortellement bleſſé	Il se frappe à ces mots; mortellement blessé
Sur un monceau de corps il tombe renverſé,	Sur un monceau de corps il tombe renversé,
Et ce coup à jamais conſacrant ſa memoire,	Et ce coup à jamais consacrant sa mémoire
Dans ſa défaite même il ſe couvre de gloire.	Dans sa défaite même il se couvre de gloire.
Ah Varus! que je plains, que j'admire ton ſort!	Ah Varus! que je plains, que j’admire ton sort!
Je brûle de te ſuivre, & d’imiter ta mort;	Je brûle de te suivre, et d’imiter ta mort;
Je jure ainſi que toy de fuir l'ignominie	Je jure ainsi que toi de fuir l’ignominie
De tenir du Vainqueur une importune vie,	De tenir du Vainqueur une importune vie,
Mais avant qu’achever le deſſein que je prens,	Mais avant qu’achever le dessein que je prends,
Faiſons ſacrifice à tes manes errans,	Faisons un sacrifice à tes mânes errants,
Que ces perfides cœurs que le deſtin me livre	Que ces perfides cœurs que le destin me livre
Dans la nuit du tombeau ſoient forcez de te ſuivre,	Dans la nuit du tombeau soient forcés de te suivre,
Que ſans égard enfin du ſexe ny du rang	Que sans égard enfin du sexe ni du rang
De tous trois à mes yeux on répande le ſang,	De tous trois à mes yeux on répande le sang,
Que j'y meſle le mien, qu’Arminius ne trouve	Que j’y mêle le mien, qu’Arminius ne trouve
Que les ſanglans effets des fureurs que j'éprouve,	Que les sanglants effets des fureurs que j’éprouve,
Qu'il ne rencontre icy pour fruit de ſes Exploits,	Qu’il ne rencontre ici pour fruit de ses Exploits,
Que ſon amy, ſa ſœur, ſa Maîtreſſe aux abois,	Que son ami, sa sœur, sa Maîtresse aux abois,
Et pour vanger les maux où ſon bonheur m'expoſe,	Et pour venger les maux où son bonheur m’expose,
Qu'il plaigne mon trépas par les horreurs qu'il cauſe,	Qu’il plaigne mon trépas par les horreurs qu’il cause,
Frappez Gardes.... mais Dieux, le voicy ce Vainqueur,	Frappez Gardes… mais Dieux, le voici ce Vainqueur,
Ah! que mon bras du moins ſeconde ma fureur?	Ah! que mon bras du moins seconde ma fureur?
Que je meure .....	Que je meure…
Ah Seigneur quel deſſein? quelle envie?	Ah Seigneur quel dessein? quelle envie?
Arreſtez....	Arrêtez…
Quoy cruels vous ménagez ma vie?	Quoi cruels vous ménagez ma vie?
Vous m'oſez deſarmer; & vous voulez enfin	Vous m’osez demander; et vous voulez enfin
qu'Arminius ſoit ſeul Maiſtre de mon destin?	Qu’Arminius soit seul Maître de mon destin?
EH bien, Arminius, par un revers funeſte,	EH bien, Arminus, par un revers funeste,
La Fortune en tes mains met le ſort de Segeſte!	La Fortune en tes mains met le sort de Ségeste!
Tu ſçais de quelle ardeur j'ay pourſuivy tes jours!	Tu sais de quelle ardeur j’ai poursuivi tes jours!
Tu me vois maintenant ſans eſpoir, ſans ſecours,	Tu me vois maintenant sans espoir, sans secours,
Vange-toy ſans ſcrupule, & prens une victime	Venge-toi sans scrupule, et prends une victime
Dont la perte eſt utile & la mort legitime.	Dont la perte est utile et la mort légitime.
Frappe, perce ce cœur qui n'attend que tes coups.	Frappe, perce ce cœur qui n’attend que tes coups.
Ceſſez de m’animer, & d’aigrir mon courroux,	Cessez de m’animer, et d’aigrir mon courroux,
Vos derniers attentats, vos cruelles injures	Vos derniers attentats, vos cruelles injures
Ont laiſſé dans mon cœur d’aſſez vives bleſſures,	Ont laissé dans mon cœur d’assez vives blessures,
Pour me porter ſans peine à vous donner la mort,	Pour me porter sans peine à vous donner la mort,
Et je ne doute point, ſi la rigueur du ſort	Et je ne doute point, si la rigueur de sort
Vous euſt par ma défaite abandonné ma vie,	Vous eut par ma défaite abandonnée ma vie,
Que déja vos fureurs ne me l'euſſent ravie;	Que déjà vos fureurs ne me l’eussent ravie;
Que n'avez-vous point fait aujourd'hy contre moy?	Que n’avez-vous point fait aujourd’hui contre moi?
Ce n'eſtoit pas aſſez de me manquer de foy?	Ce n’était pas assez de me manquer de foi?
Sans égard pour les droits que ma naiſſance donne,	Sans égard pour les droits que ma naissance donne,
Vous avez attenté juſques ſur ma perſonne,	Vous avez attenté jusque sur ma personne,
Et de vos fers honteux oſant charger mes mains	Et de vos fers honteux osant charger mes mains
Fait de mon eſclavage un triomphe aux Romains,	Fait de mon esclavage un triomphe aux Romains,
L'Univers étonné du bruit de mon offenſe	L’Univers étonné du bruit de mon offense
Ne le ſera pas moins d'apprendre ma vangeance.	Ne le sera pas moins d’apprendre ma vengeance.
D'un mot je puis vous perdre, & je ſuis offenſé;	D’un mot je puis vous perdre, et je suis offensé;
N'y penſons plus, Seigneur, oublions le paſſé,	N’y pensons plus, Seigneur, oublions le passé,
C'eſt moy qui vous en prie. Enfin de ma victoire	C’est moi qui vous en prie. Enfin de ma victoire
Je ne veux d'autre prix, je ne veux d'autre gloire,	Je ne veux d’autre prix, je ne veux d’autre gloire,
Que le charmant eſpoir d'eſtre de vos amis,	Que le charmant espoir d’être de vos amis,
Et le parfait bonheur de me voir vôtre fils;	Et le parfait bonheur de me voir votre fils;
Craignez moins de Ceſar la puiſſance funeſte,	Craignez moins de César la puissance funeste,
Combattons ſeulement, je vous répons du reſte,	Combattons seulement, je vous réponds du reste,
En vain vous avez crû que fidele aux Romains	En vain vous avez cru que fidèle aux Romains
La victoire par tout ſeconde leurs deſſeins,	La victoire partout seconde leurs desseins,
Que contre leurs efforts rien ne nous peut deffendre.	Que contre leurs efforts rien ne nous peut défendre.
Pour les vaincre il ſuffit de l'oſer entreprendre,	Pour les vaincre il suffit de l’oser entreprendre,
Vous venez de les voir expirer ſous mes coups,	Vous venez de les voir expirer sous mes coups,
Et ces Romains enfin ſont hommes comme nous.	Et ces Romains enfin sont hommes comme nous.
Mais dûſſions-nous perir, Seigneur, pour la patrie,	Mais dussions-nous périr, Seigneur, pour la patrie,
Mourons libres du moins, s'il faut perdre la vie,	Mourons libre du moins, s’il faut perdre la vie,
Un malheur éclatant eſt toûjours glorieux.	Un malheur éclatant est toujours glorieux.
Soûtenons nôtre gloire, & laiſſons faire aux Dieux.	Soutenons notre gloire, et laissons faire aux Dieux.
Vaincu, deſeſperé, que pourrois-je répondre?	Vaincu, désespéré, que pourrais-je répondre?
Prince, tous vos diſcours ne font que me confondre,	Prince, tous vos discours ne font que me confondre,
Je ne m'attendois pas à ces ſoins genereux,	Je ne m’attendais pas à ces soins généreux,
Et ſi vous vous vangiez je ſerois plus heureux;	Et si vous vous vengiez je serais plus heureux;
Joüiſſez à loiſir des fruits de la victoire,	Jouissez à loisir des fruits de la victoire,
Mais ne me forcez point d'en voir toute la gloire,	Mais ne me forcez pas d’en voir toute la gloire,
Quand vous me découvrez vos nobles ſentimens,	Quand vous me découvrez vos nobles sentiments,
Ma honte & ma douleur croiſſent à tous momens,	Ma honte et ma douleur croissent à tous moments,
Epargnez ma foibleſſe, & loin de vôtre veuë,	Épargnez ma faiblesse, et loin de votre vue,
Laiſſez-moy devorer le chagrin qui me tuë.	Laissez-moi dévorer le chagrin qui me tue.
Suivez-le, Sinorix, & veillez ſur ſes jours,	Suivre-le, Sinorix, et veillez sur ses jours,
Madame....	Madame…
Non Seigneur, je vole à ſon ſecours,	Non Seigneur, je vole à son secours,
Permettez....	Permettez…
JE vous ſuis, venez, allons Madame,	JE vous suis, venez, allons Madame,
Remettre par nos ſoins le calme dans ſon ame,	Remettre par nos soins le calme dans son âme,
Malgré ſon deſeſpoir, malgré tout ſon courroux,	Malgré son désespoir, malgré tout son courroux,
Le temps & nos reſpects le fléchiront pour nous,	Le temps et nos respects le fléchiront pour nous,
Je m’eſtois engagé de vanger mon outrage,	Je m’étais engagé de venger mon outrage,
De m’ouvrir juſqu’à vous un glorieux paſſage.	De m’ouvrir jusqu’à vous un glorieux passage.
Varus eſt mort, enfin les Romains ſont défaits;	Varus est mort, enfin les Romains sont défaits;
Graces aux Dieux, l'effet répond à mes ſouhaits,	Grâces aux Dieux, l’effet répond à mes souhaits,
De mes liberateurs rcconnoiſſons le zele,	De mes libérateurs reconnaissons le zèle,
Et contacrons à Rome une haine immortelle.	Et consacrons à Rome une haine immortelle.
