SCavantes Sœurs, arbitres de la Scene,	Savantes Sœurs, arbitres de la Scène,
Quel accident funeſte a fait ceſſer vos Ieux?	Quel accident funeste a fait cesser vos Jeux?
Ie ne voy plus icy vôtre appareil pompeux,	Je ne vois plus ici votre appareil pompeux,
Et je ne reconnais qu’à peine,	Et je ne reconnais qu’a peine,
Thalie, & Melpomene;	Thalie et Melpomène;
Et vous dont les charmans Concerts,	Et vous dont les charmants Concerts,
En ces lieux autrefois, raiſonnoient dans les Airs;	En ces lieux autrefois, raisonnaient dans les Airs;
Quel trouble, ou quelle indifference	Quel trouble, ou quelle indifférence
Cauſe aujourd’huy vôtre ſilence?	Cause aujourd’hui votre silence?
Ignorez-vous, que le plus grand des Rois	Ignorez vous, que le plus grand des Rois
Etendant chaque jour ſes conquêtes	Étendant chaque jour ses conquêtes
Et ſignalant ſon bras, par de nouveaux Exploits	Et signalant son bras, par de nouveaux Exploits
A négligé nos plus ſuperbes Fêtes?	A négligé nos plus superbes Fêtes?
Depuis ce fatal moment,	Depuis ce fatal moment,
Nos Spectacles privez de leur magnificence,	Nos Spectacles privés de leur magnificence,
Ne ſçauroient plus avoir l'éclat & l’agrément	Ne sauraient plus avoir l’éclat et l’agrément
Qu’ils ne devoient qu'à ſa preſence.	Qu’ils ne devaient qu’à sa présence.
La triſteſſe regne en ces lieux,	La tristesse règne en ces lieux,
Nous rougiſſons de ne pouvoir luy plaire;	Nous rougissons de ne pouvoir lui plaire;
Hélas! ne ſçaurions-nous rien faire	Hélas! Ne saurions-nous rien faire
Digne de paroître à ſes yeux?	Digne de paraître à ses yeux?
Hélas! ne ſcaurions-nous rien faire	Hélas! ne saurions-nous rien faire
Digne de paroître à ſes yeux?	Digne de paraître à ses yeux?
Terminez, vos regrets, que vôtre douleur ceſſe,	Terminez vos regrets, que votre douleur cesse,
Dans vôtre ſort Jupiter s’intereſſe,	Dans votre sort Jupiter s’intéresse,
Et veut icy revoir, dés ce même moment	Et veut ici revoir, dès ce même moment
Un ſpectacle charmant,	Un spectacle charmant,
Qu'un changement favorable	Ou’un changement favorable
Redonne à ces triſtes lieux	Redonne à ces tristes lieux
Tout ce qu'ils ont eû d'aimable:	Tout ce qu’ils ont eu d’aimable:
C'eſt l'Ordre irrevocable	C’est l’Ordre irrévocable
Du Souverain des Dieux.	Du Souverain des Dieux.
Vous, ſecourables Genies,	Vous, secourables Génies,
Si neceſſaires à nos Jeux,	Si nécessaires à nos Jeux,
Hâtez-vous, ſecondez nos vœux;	Hâtez-vous, secondez nos vœux;
Venez, & prêtez-nous vos graces infinies.	Venez, et prêtez-nous vos grâces infinies.
Animez d'une ardeur nouvelle,	Animez d’une ardeur nouvelle,
Venez remplir nos deſirs,	Venez remplir nos désirs,
Et faites que nos plaiſirs	Et faites que nos plaisirs
Doivent leur charme à vôtre Zéle.	Doivent leur charme à votre Zèle.
AnimeZ d’une ardeur nouvelle	Animez d’une ardeur nouvelle
Nous venons remplir vos deſirs,	Nous venons remplir vos désirs,
Nous nous flatons que vos plaiſirs	Nous nous flattons que vos plaisirs
Devront leur charme a nôtre Zéle.	Devront leur charme à notre Zèle.
Vous qui ſçavez ſi bien, par une heureuſe adreſſe	Vous qui savez si bien, par une heureuse adresse
Calmer les noirs chagrins, bannir les ſoins fâcheux,	Calmer les noirs chagrins, bannir les soins fâcheux,
Favoriſez mes Sœurs, & mêlez dans leurs Jeux quelques traits de vôtre allegreſſe.	Favorisez mes Sœurs, et mêlez dans leurs Jeux quelques traits de votre allégresse.
Que nos Ieux vont avoir de charmes!	Que nos Jeux vont avoir de charmes!
Tous nos chants vont inſpirer l’Amour.	Tous nos chants vont inciter l’Amour.
VeneZ tous, rendeZ-luy les armes,	Venez tous, rendez-lui les armes,
Il eſt doux dans cét heureux ſejour.	Il est doux dans cet heureux séjour.
Que nos Ieux vont avoir de charmes!	Que nos Jeux vont avoir de charmes!
Tous nos chants vont inſpirer l’Amour.	Tous nos chants vont inspirer l’Amour.
Ce n’eſt plus le temps des allarmes,	Ce n’est plus le temps des alarmes,
Les Plaiſirs ſont enfin de retour.	Les Plaisirs sont enfin de retour.
Que nos Ieux vont avoir de charmes!	Que nos Jeux vont avoir de charmes!
Tous nos chants vont inſpirer l’Amour.	Tous nos chants vont inspirer l’Amour.
Iupiter va paroître,	Jupiter va paraître,
RedoubleZ vos efforts pour plaire à vôtre Maître.	Redoublez vos efforts pour plaire à votre Maître.
Iupiter va paroiſtre,	Jupiter va paraître,
Redoublons nos efforts pour plaire a nôtre Maiſtre.	Redoublons nos efforts pour plaire à notre Maître.
Il ne manque aux apprêts de la Fête nouvelle,	Il ne manque aux apprêts de la Fête nouvelle,
Que Mercure a fait préparer,	Que Mercure a fait préparer,
Que le choix du Heros qu’on y doit celebrer,	Que le choix du Héros qu’on y doit célébrer,
Le ſoin de le choiſir auprés de vous m’appelle.	Le soin de le choisir auprès de vous m’appelle.
Renouvellez dans vos Ieux	Renouvelez dans vos Jeux
Le ſouvenir de l’invincible Achile,	Le souvenir de l’invincible Achille,
Et rappelleZ dans une Cour tranquile,	Et rappelez dans une Cour tranquille,
L'Hiſtoire & les Combats de ce Guerrier fameux.	L’Histoire et les combats de ce Guerrier fameux.
Renouvellons dans nos Ieux	Renouvelons dans vos Jeux
Le ſouvenir de l’invincible Achile,	Le souvenir de l’invincible Achille,
Et rappellons dans une Cour tranquile,	Et rappelons dans une Cour tranquille,
L'Hiſtoire & les Combats de ce Guerrier fameux.	L’Histoire et les Combats de ce Guerrier fameux.
ConſacreZ tous vos Ieux au plus grand Roy du monde,	Consacrez tous vos Jeux au plus grand Roi du monde,
Former ſur luy tous les Portraits	Formez sur lui tous les Portraits
De vos Heros les plus parfaits,	De vos Héros les plus parfaits,
Sa valeur, ſa bonté, ſa ſageſſe profonde,	Sa valeur, sa bonté, sa sagesse profonde,
Vous prêteront d'inimitables traits.	Vous prêteront d’inimitables traits.
Conſacrons tous nos Ieux au plus grand Roy du monde,	Consacrons tous nos Jeux au plus grand Roi du monde,
Sa valeur, ſa bonté, ſa ſageſſe profonde	Sa valeur, sa bonté, sa sagesse profonde
Nous prêteront d’inimitables traits,	Nous prêterons d’inimitables traits,
Conſacrons tous nos Ieux au plus grand Roy du monde.	Consacrons tous nos Jeux au plus grand Roi du monde.
On, je ne ſçaurois plus me taire,	Non, je ne saurais plus me taire,
Je vous dois un conſeil ſincere;	Je vous dois un conseil sincère;
Ne rougiſſez-vous point d'un indigne repos?	Ne rougissez-vous point d’un indigne repos?
Quand les Grecs agitez, de mortelles allarmes,	Quand les Grecs agités de mortelles alarmes,
Implorent à genoux le ſecours de vos armes,	Implorent à genoux le secours de vos armes,
Contre Hector, aprés vous, le plus grand des Heros.	Contre Hector, après vous, le plus grand des Héros.
Tantôt ce guerrier terrible,	Tantôt ce guerrier terrible,
Des Grecs épouventeZ, embraſe les Vaiſſeaux;	Des Grecs épouvantés, embrase les Vaisseaux;
Tantôt ſon bras invincible,	Tantôt son bras invincible,
Fait rougir de leur ſang, & la terre & les eaux,	Fait rougir de leur sang et la terre et les eaux,
Il court de victoire en victoire,	Il court de victoire en victoire,
Chaque jour, le bruit de ſa gloire,	Chaque jour, le bruit de sa gloire,
Va remplir l'Vnivers & vole juſqu’a vous:	Va remplir l’Univers et vole jusqu’à vous:
Des honneurs qu'il obtient, n'eſtes vous point jaloux?	Des honneurs qu’il obtient, n’êtes vous point jaloux?
Je vois avec plaiſir les pertes de la Grece,	Je vois avec plaisir les pertes de la Grèce,
La valeur d’Hector m’a vangé,	La valeur d’Hector m’a vengé,
Le fier Agamemnon connoîtra ſa foibleſſe,	Le fier Agamemnon connaîtra sa faiblesse,
Et ſe repentira de m’avoir outragé.	Et se repentira de m’avoir outragé.
Dequoy ſert à ce Roy coupable	De quoi sert à ce Roi coupable
D’avoir osé vous ravir Briſeis?	D’avoir osé vous ravir Briséis?
Son attentat reçoit un digne prix,	Son attentat reçoit un digne prix,
Et pour luy Briſeis paroiſt inexorable,	Et pour lui Briséis paraît inexorable,
Quand un rival puiſſant vient troubler nos amours,	Quand un rival puissant vient troubler nos amours,
Si l’objet de nos vœux luy reſiſte toujours,	Si l’objet de nos vœux lui résiste toujours,
Eſt-il de plus douce vangeance	Est-il de plus douce vengeance
Que de voir ce rival aimer ſans eſperance?	Que de voir ce rival aimer sans espérance?
Connoy mieux les raiſons de mon juſte courroux,	Connais mieux les raisons de mon juste courroux,
Ce n'eſt point ſeulement par un depit jaloux,	Ce n’est point seulement par un dépit jaloux,
Que je refuſe aux Grecs un ſecours neceſſaire,	Que je refuse aux Grecs un secours nécessaire,
Ils ont marqué trop de mépris pour moy,	Ils ont marqué trop de mépris pour moi,
Ils mont laiſſé ſubir la violente Loy	Ils m’ont laissé subir la violente Loi
De leur Chef temeraire.	De leur Chef téméraire.
Non, jamais leurs malheurs ne ſcauroient m'émouvoir,	Non, jamais leurs malheurs ne sauraient m’émouvoir,
Leurs Vaiſſeaux embraſeZ, leurs Troupes fugitives,	Leurs Vaisseaux embrasés, leurs troupes fugitives,
Leur Camp détruit, tous leurs Rois ſans pouvoir,	Leur Camp détruit, tout leurs Rois sans pouvoir,
Leurs corps épars ſur ces ſanglantes rives	Leurs corps épars sur ces sanglantes rives
Seroient encor des objets impuiſſans,	Seraient encor des objets impuissants,
Pour ſuſpendre un moment la fureur que je ſens.	Pour suspendre un moment la fureur que je sens.
Eh bien! d'un œil content regardez nos allarmes;	Eh bien! d’un œil content regardez nos alarmes;
Mais quand vous nous mépriſez tous,	Mais quand vous nous méprisez tous,
Du moins accordeZ-moy ces armes	Du moins accordez-moi ces armes
Que Vulcain prepara pour vous;	Que Vulcain prépara pour vous;
J’iray combatre Hector, & me combler de gloire,	J’irai combattre Hector, et me combler de gloire,
Je remporteray la victoire,	Je remporterai la victoire,
Ou j'expireray ſous ſes coups.	Ou j’expirerai sous ces coups.
Qu oſes-tu propoſer? Dieux! que viens-je d’entẽdre?	Qu’oses-tu proposer? Dieux! Que viens-je d’entendre?
Je commence à trembler pour la premiere fois,	Je commence à trembler pour la première fois,
Quand je ſonge au combat que tu veux entreprendre.	Quand je songe au combat que tu veux entreprendre.
Au nom d’une amitié qui fut toujours ſi tendre,	Au nom d’une amitié qui fut toujours si tendre,
Permettez-moy d'imiter vos exploits.	Permettez-moi d’imiter vos exploits.
Je connois les perils où mon deſſein m’engage,	Je connais les périls où mon dessein m’engage,
Tout ſemble m'annoncer les fers ou le trépas;	Tout semble m’annoncer les fers ou le trépas;
Mais ſi j'en croy mon courage,	Mais si j’en crois mon courage,
Ce ſuperbe ennemy ne triomphera pas.	Ce superbe ennemi ne triomphera pas.
D'une vaine terreur je n'ay plus l'ame atteinte,	D’une vaine terreur je n’ai plus l’âme atteinte,
Va combattre; le Ciel prendra ſoin de ton ſort,	Va combattre; le Ciel prendra soin de ton sort,
Puiſque ton cœur eſt ſans crainte,	Puisque ton cœur est sans crainte,
Ton bras ne ſera que trop fort.	Ton bras ne sera que trop fort.
Ie cours aſſûrer ma memoire,	Je cours assurer ma mémoire,
l'ay tous les ſentimens & les ſoins des Heros;	J’ai tous les sentiments et les soins des Héros;
Non, les jours les plus doux paſſez dans le repos	Non, les jours les plus doux passés dans le repos
Ne valent pas un jour marqué par la victoire.	Ne valent pas un jour marqué par la victoire.
PAtrocle va combatre? & j'ay pu conſentir	Patrocle va combattre? Et j’ai pu consentir
Qu'il courût aux dangers qui menaſſent ſa vie?	Qu’il courût aux dangers qui menacent sa vie?
Ah! je devois l'empêcher de partir,	Ah! je devais l’empêcher de partir,
Hélas de quels regrets ſa mort ſerait ſuivie?	Hélas de quels regrets sa mort serait suivie?
Si le fort irrité pour accabler mon cœur	Si le sort irrité pour accabler mon cœur
Le faiſoit expirer ſous le fer d’un vainqueur.	Le faisait expirer sous le fer d’un vainqueur.
Prevenez juſtes Dieux, mon deſeſpoir funeſte!	Prévenez justes Dieux, mon désespoir funeste!
Cét amy genereux, eſt le ſeul qui me reſte,	Cet ami généreux, est le seul qui me reste,
Conſervez, ſes jours par pitié!	Conservez ses jours par pitié!
On m'a privé de l'objet que j'adore,	On m’a privé de l’objet que j’adore,
Ce ſeroit trop d’horreur de me priver encore	Ce serait trop d’horreur de me priver encore
De l’objet de mon amitié.	De l’objet de mon amitié.
NE répondreZ-vous point aux deſirs de la Grece?	Ne répondrez-vous point aux désirs de la Grèce?
Il faut qu’en ſa faveur vôtre colere ceſſe,	Il faut qu’en sa faveur votre colère cesse,
Elle ne peut ſans vous triompher des Troyens;	Elle ne peut sans vous triompher des Troyens;
En vain nous aſſiegeons leur Ville,	En vain nous assiégeons leur Ville,
Nos Dieux ſont moins forts que les ſiens,	Nos Dieux sont moins forts que les siens,
Sa priſe eſt reſervée à la valeur d’Achile.	Sa prise est réservée à la valeur d’Achille.
De quel employ vous chargez-vous?	De quel emploi vous chargez-vous?
N’eſperez-pas de fléchir mon courroux,	N’espérez pas de fléchir mon courroux,
Diomede, je veux achever ma vangeance:	Diomède je veux achever ma vengeance:
Vos Rois & vos Peuples ingrats,	Vos Rois et vos Peuples ingrats,
Auroient encor pour moy la même indifference,	Auraient encor pour moi la même indifférence,
S’ils n'avoient beſoin de mon bras.	S’ils n’avaient besoin de mon bras.
Quoy? leur prompt repentir ne peut vous ſatisfaire?	Quoi? Leur prompt repentir ne peut vous satisfaire?
Ils ont pris trop de ſoin d’attirer ma colere.	Ils ont pris trop de soin d’attirer ma colère.
Mais pouvez-vous aimer un ſi triſte ſejour,	Mais, pouvez-vous aimer un si triste séjour,
Et languir en ces lieux dans une vie obſcure?	Et languir en ces lieux dans une vie obscure?
Vous? à qui les Deſtins promettoient chaque jour	Vous? à qui les Destins promettaient chaque jour
Quelque glorieuſe avanture.	Quelque glorieuse aventure.
Malgré mes cruels déplaiſirs,	Malgré mes cruels déplaisirs,
La Déeſſe de Cythere	Le Déesse de Cythère
En faveur de Thetis ma mere	En faveur de Thétis ma mère
Interrompt mes regrets, & ſuſpend mes ſoûpirs;	Interrompt mes regrets, et suspend mes soupirs;
Cette charmante Déeſſe	Cette charmante Déesse
Vient en ces lieux tous les jours,	Vient en ces lieux tous les jours,
Ie vois avec elle ſans ceſſe	Je vois avec elle sans cesse
Les graces, les plaiſirs, les jeux & les amours;	Les grâces, les plaisirs, les jeux et les amours;
Leur preſence eſt d'un grand ſecours	Leur présence est d’un grand secours
Contre la plus ſombre triſteſſe.	Contre la plus sombre tristesse.
C'eſt pour ſervir nos ennemis	C’est pour servir nos ennemis
Qu'on prend ces ſoins mortels à vôtre gloire,	Qn’on prend ces soins mortels à votre gloire,
Songez que de vous ſeul dépend nôtre victoire,	Songez que de vous seul dépend notre victoire,
Et que tout notre ſort en vos mains eſt remis.	Et que tout notre sort en vos mains est remis.
Faut-il que vôtre cœur ſe livre	Faut-il que votre cœur se livre
A l'amour des vains plaiſirs?	À l’amour de vains plaisir?
Quelque douceur que l'on goûte à les ſuivre,	Quelque douceur que l’on goûte à les suivre,
Un Heros doit former de plus nobles deſirs.	Un Héros doit former de plus nobles désirs.
La Déeſſe paroiſt; & déja ſa preſence	La Déesse paraît et déjà sa présence
Donne à ces lieux mille beautez,	Donne à ces lieux mille beautés,
I'admire ſes bienfaits, j’admire ſa puiſſance,	J’admire ses bienfaits, j’admire sa puissance,
Trop heureux de jouïr, ſur ces bords écartez	Trop heureux de jouir, sur les bords écartés
des plaiſirs innocens qui me ſont preſentez,	Des plaisirs innocents qui me sont présentés,
J'abandonne les Cieux, je deſcends ſur la Terre,	J’abandonne les Cieux, je descends sur la Terre,
Pour finir de tes maux le déplorable cours,	Pour finir de tes maux le déplorable cours,
En vain l’injuſte ſort t’a déclaré la guerre,	En vain l’injuste sort t’a déclaré la guerre,
Eſpere tout de mon ſecours.	Espère tout de mon secours.
Vous, Divinitez aimables,	Vous, Divinités aimables,
Du plus grand des Heros charmez le triſte cœur,	Du plus grand des Héros charmez le triste cœur,
Et faites ſuccéder à ſa vive douleur	Et faites succéder à sa vive douleur
Les plaiſirs les plus agreables.	Les plaisirs les plus agréables.
GRand Heros, le Ciel vous eſt propice,	GRand Héros, le Ciel vous est propice,
Vos vertus ſe font rendre juſtice,	Vos vertus se font rendre justice,
Tout conſpire aujourd’huy	Tout conspire aujourd’hui
A finir vôtre ennuy.	À finir votre ennui.
Si l'Amour a cauſé vos allarmes,	Si l’Amour a causé vos alarmes,
Ses faveurs en auront plus de charmes;	Ses faveurs en auront plus de charmes;
Préparez vôtre cœur	Préparez votre cœur
Au plus parfait bonheur.	Au plus parfait bonheur.
Quel mortel oſa jamais prétendre	Quel mortel osa jamais prétendre
Les ſoins qu'icy nous venons vous rendre?	Les soins qu’ici nous venons vous rendre?
Qui veut les mériter	Qui veut le mériter
N’a qu’à vous imiter.	N’a qu’à vous imiter.
C'eſt pour vous que Venus nous appelle,	C’est pour vous que Vénus nous appelle,
Profitez de nôtre ardeur fidelle,	Profitez de notre ardeur fidèle,
Vous aurez en ces lieux	Vous aurez en ces lieux
Tous les plaiſirs des Dieux.	Tous les plaisirs des Dieux.
C'eſt en vain que la haine & l'envie	C’est en vain que la haine et l’envie
Sont d'accord pour troubler vôtre vie,	Sont d’accord pour troubler votre vie,
Par nôtre heureux ſecours	Par notre heureux secours
Vous en triompherez, toûjours.	Vous en triompherez toujours.
Puiſſiez-vous par nos ſoins favorables	Puissiez-vous par nos soins favorables
Me paſſer que des jours agreables!	Ne passer que des jours agréables!
Eſt-il rien de ſi doux	Est-il rien de si doux
Que de vivre avec nous?	Que de vivre avec nous?
O Déplorable coup du ſort!	Ô déplorable coup du sort!
O malheur!	Ô malheur!
Ie frémis, parle?	Je frémis, parle?
Patrocle eſt mort.	Patrocle est mort.
Ciel! quelle affreuſe nouvelle!	Ciel! Quelle affreuse nouvelle!
Laiſſez-moy, fuyez de ces lieux,	Laissez-moi, fuyez de ces lieux,
Vos appas, vos Concerts, & tous les ſoins des Dieux	Vos appas, vos Concerts, et tous les soins des Dieux
Ne ſçauroient plus calmer ma triſteſſe mortelle.	Ne sauraient plus calmer ma tristesse mortelle.
COurons vanger cét amy que je pers,	COurons venger cet ami que je perds,
Que de ſang & de morts tous ces champs ſoient couverts!	Que de sang et de morts tous ces champs soient couverts!
Que ſon fir vainqueur periſſe!	Que son fier vainqueur périsse!
Ie dois a l'amitié ce juſte Sacrifice.	Je dois à l’amitié ce juste Sacrifice.
Manes de ce Guerrier dont je pleure le ſort,	Manes de ce Guerrier dont je pleure le sort,
Ie vous promets une prompte vangeance,	Je vous promet une prompte vengeance,
I'en atteſte des Dieux la ſuprême puiſſance,	J’en atteste des Dieux la suprême puissance,
Je cours chercher Hector, je cours hâter ſa mort,	Je cours chercher Hector, je cours hâter sa mort,
Dans l'eternelle nuit ſon ombre va vous ſuivre,	Dans l’éternelle nuit son ombre va vous suivre,
Ou moy-même aujourd’huy je ceſſeray de vivre.	Ou moi-même aujourd’hui je cesserai de vivre.
PUis qu Achile combat, y nous allons triompher	Puisqu’Achille combat, nous allons triompher
Nôtre victoire eſt certaine,	Notre victoire est certaine,
Ceſſez, de le haïr, hâtez-vous d'étouffer	Cessez de le haïr, hâtez-vous d’étouffer
Le malheureux Amour qui cauſe vôtre haine.	Le malheureux Amour qui cause votre haine.
Vous devez rendre à ce Heros	Vous devez rendre à ce Héros
Le charmant objet de ſa flame.	Le charmant objet de sa flamme.
Ah, s'il faut à ce prix aſſûrer ſon repos,	Ah, S’il faut à ce prix assurer son repos,
Dieux! qu'il en coûtera de tourmens à mon ame!	Dieux! qu’il en coûtera de tourments à mon âme!
Si vous pouviez fléchir la cruelle beauté,	Si vous pouviez fléchir la cruelle beauté,
Dont vôtre cœur eſt enchanté,	Dont votre cœur est enchanté,
I'excuſerois une injuſtice	J’excuserais une injustice
Qui finiroit vôtre ſort rigoureux:	Qui finirait votre sort rigoureux:
Mais je dois condamner un funeſte caprice	Mais je dois condamner un funeste caprice
Qui vous rend tout enſemble injuſte & malheureux.	Qui vous rend tout ensemble injuste et malheureux.
Il eſt vray que j'attaque un cœur inexorable,	Il est vrai que j’attaque un cœur inexorable,
Ie ne puis fléchir ſa rigueur;	Je ne puis fléchir sa rigueur;
Mais contez-vous pour rien la flateuſe douceur	Mais, comptez-vous pour rien la flatteuse douceur
De rendre un rival miſerable?	De rendre un rival misérable?
Le malheur d'un rival flate-t'il vôtre ennuy,	Le malheur d’un rival flatte-t-il votre ennui,
Quand vous eſtes encor plus malheureux que luy?	Quand vous êtes encor plus malheureux que lui?
Rappellez, vôtre courage,	Rappelez votre courage,
Que la raiſon vous dégage	Que la raison vous dégage
De vos fatales Amours.	De vos fatales Amours.
Que peut de la raiſon le triſte & vain ſecours	Que peut de la raison le triste et vain secours
Contre les traits vainqueurs d'une beauté cruelle?	Contre les traits vainqueurs d’une beauté cruelle?
Quand l'Amour à nos yeux viẽt l'offrir tous les jours	Quand l’Amour à nos yeux vient l’offrir tous les jours
Avec quelque grace nouvelle.	Avec quelque grâce nouvelle.
Ranimons toutefois mon courage abatu,	Ranimons toutefois mon courage abattu,
C'eſt nourrir trop long-temps une vaine tendreſſe,	C’est nourrir trop longtemps une vaine tendresse,
Surmontons ma foibleſſe	Surmontons ma faiblesse
Par un dernier effort digne de ma vertu.	Par un dernier effort digne de ma vertu.
Achile eſt triomphant, je le vois qui s'avance	Achille est triomphant, je le vois qui s’avance
Suivy de nos Soldats, charmez de ſa valeur.	Suivi de nos Soldats, charmés de sa valeur.
Eloignons-nous, évitons ſa preſence,	Éloignons-nous, évitons sa présence,
Ie ne ſçaurois encor répondre de mon cœur.	Je ne saurais encore répondre de mon cœur.
GUerrier terrible,	GUerrier terrible,
Soyez toûjours invincible,	Soyez toujours invincible,
Que vos Exploits	Que vos Exploits
Faſſent trembler tous les Rois.	Fassent trembler tous les Rois.
Ciel équitable,	Ciel équitable,
Sois luy toûjours favorable,	Sois lui toujours favorable,
Que ſon bonheur	Que son bonheur
Soit égal à ſa valeur.	Soit égal à sa valeur.
Guerrier terrible &c.	Guerrier terrible etc.
Quelle allegreſſe!	Quelle allégresse!
Quel triomphe pour la Grece!	Quel triomphe pour la Grèce!
Ses ennemis	Ses ennemis
Luy ſeront bien-tôt ſoûmis.	Lui seront bientôt soumis.
Guerrier terrible	Guerrier terrible
Soyez toûjours invincible,	Soyez toujours invincible,
Que vos Exploits	Que vos Exploits
Faſſent trembler tous les Rois,	Fassent trembler tous les Rois,
Venez tous a l'envy ſeconder nôtre ardeur,	Venez tous, à l’envie secondez notre ardeur,
Honnorez vôtre heureux Defenſeur,	Honorez votre heureux Défenseur,
Celebrez ſa victoire,	Célébrez sa victoire,
Chantez ſa valeur & ſa gloire,	Chantez sa valeur et sa gloire,
Que tous nos Rois	Que tous nos Rois
Charmez de ſez Exploits	Charmés de ses Exploits
Soient fournis à ſes loix.	Soient soumis à ses lois.
Suivons, ſuivons ſans ceſſe	Suivons, suivons sans cesse
Ce Heros, ce fameux vainqueur;	Ce Héros, ce fameux vainqueur;
C’eſt à ſon bras, que la Gréce	C’est à son bras, que la Grèce
Doit ſa force & ſon bonheur.	Doit sa force et son bonheur.
Chantons la valeur & la gloire	Chantons la valeur et la gloire
Du Heros qui nous a ſauvez,	Du héros qui nous a sauvés,
Qu il jouiſſe, apres ſa victoire	Qu’il jouisse, après sa victoire
Des honneurs éclatans à luy ſeul reſervez;	Des honneurs éclatants à lui seul réservés;
Chantons la valeur & la gloire	Chantons la valeur et la gloire
Du Heros qui nous a ſauveZ.	Du Héros qui nous a sauvés.
De ſes heureux travaux cheriſſons la mémoire,	De ses heureux travaux chérissons la mémoire,
Conſacrons-luy des jours qu’il nous a conſervez.	Consacrons-lui des jours qu’il nous a conservés.
Chantons la valeur & la gloire	Chantons la valeur et la gloire
Du Heros qui nous a ſauvez.	Du Héros qui nous a sauvés.
Allez, que chacun coure où ſon devoir l’appelle,	Allez, que chacun court où son devoir l’appelle,
Vos ſoins pour moy feroient trop de jaloux,	Vos soins pour moi feraient trop de jaloux,
Et de mes ennemis la vangeance cruelle	Et de mes ennemis la vengeance cruelle
Ne pouvant m'accabler retomberoit ſur vous.	Ne pouvant m’accabler retomberait sur vous.
VEneZ marchez ſans défiance,	VEnez marchez sans défiance,
Les Grecs vous ont donné leur foy,	Les Grecs vous ont donné leur foi,
Achile eſt genereux, craignez moins ſa preſence,	Achille est généreux, craignez moins sa présence,
Et qu’une juſte eſperance	Et qu’une juste espérance
Succéde à vôtre effroy.	Succède à votre effroi.
REſtes infortunez du plus beau ſang du monde,	REstes infortunés du plus beau sang du monde,
Polixene, ma fille, & vous veuve d’Hector,	Polixène, ma fille, et vous veuve d’Hector,
Mêlez vos pleurs aux miens, & s’il ſe peut encor,	Mêlez vos pleurs aux miens, et s’il se peut encor,
Que tout redouble icy nôtre douleur profonde.	Que tout redouble ici notre douleur profonde.
Puiſſions-nous attendrir le cœur	Puissions-nous attendrir le cœur
De ce ſuperbe vainqueur!	De ce superbe vainqueur!
VOus voyeZ, Guerrier indomptable,	VOus voyez, Guerrier indomptable,
Un Roy qui fut long-temps le plus puiſſant des Rois;	Un Roi qui fut longtemps le plus puissant des Rois;
C'eſt ce même Priam, qui tenoit ſous ſes loix	C’est ce même Priam, qui tenait sous ses lois
Des Troyens renommeZ, l’Empire redoutable;	Des Troyens renommés, l’Empire redoutable;
C'eſt luy que le dernier de vos fameux Exploits,	C’est lui que le dernier de vos fameux Exploits,
Vient de rendre plus miſerable,	Vient de rendre plus misérable,
Qu'il ne fut heureux autrefois.	Qu'il ne fut heureux autrefois.
Le ſort ne peut changer l'auguſte caractere,	Le sort ne peut changer l’auguste caractère,
Dont les Dieux vous ont revêtu,	Dont les Dieux vous ont revêtu,
Je le reſpecte en vous, je plains vôtre vertu,	Je le respecte en vous, je plains votre vertu,
Je ſens expirer ma colere,	Je sens expirer ma colère,
le ceſſe de haïr mes plus grands ennemis,	Je cesse de haïr mes plus grands ennemis,
Sitôt que je les vois ou vaincus ou ſoûmis.	Sitôt que je les vois ou vaincus ou soumis.
I'ay perdu mon époux dans un combat funeſte,	J’ai perdu mon époux dans un combat funeste,
Vôtre valeur me l’a ravy;	Votre valeur me l’a ravi;
Mon amour, cheZ les morts, l’auroit déja ſuivy,	Mon amour, chez les morts, l’aurait déjà suivi,
Sans les ſoins que je dois au ſeul fils qui me reſte,	Sans les soins que je dois au seul fils qui me reste,
Vous le ſçavez, Dieux que j’atteſte,	Vous le savez, Dieux que j’atteste,
Au ſort de cét enfant, mon ſort eſt aſſervy;	Au sort de cet enfant, mon sort est asservi;
Ie l’ay perdu cét époux que j’adore,	Je l’ai perdu cet époux que j’adore,
Et pour comble d'horreur, je ſçay qu'il eſt encore	Et pour comble d’horreur, je sais qu’il est encore
Indignement privé, par des ordres cruels	Indignement privé, par des ordres cruels
D’un droit que le trépas donne à tous les mortels:	D’un droit que le trépas donne à tous les mortels:
Souffrez, que je le rende aux murs qui l’ont vû naitre,	Souffrez que je le rende aux murs qui l’ont vu naître,
Qu’un ſuperbe Tombeau faſſe du moins connoître	Qu’un superbe Tombeau fasse du moins connaître
La ſplendeur de ſon ſang, ſon ſort & mon amour:	La splendeur de son sang, son sort, et mon amour:
Ce Tombeau ſervira de Temple à vôtre gloire,	Ce Tombeau servira de Temple à votre gloire,
Puis que tout l’avenir y verra quelque jour	Puisque tout l’avenir y verra quelque jour
L’hiſtoire de nos maux & de vôtre victoire.	L’histoire de nos maux et de votre victoire.
Quels regrets! quels triſtes accens!	Quels regrets! quels tristes accents!
Dieux! que ſa douleur eſt tendre!	Dieux! que sa douleur est tendre!
Que ſes ſoûpirs ſont puiſſans!	Que ses soupirs sont puissants!
Que je ſouffre à les entendre!	Que je souffre à les entendre!
Par vos ſacreZ Ayeux, par le nom de Thetis,	Par vos sacrés Aïeux, par le nom de Thétis,
Laiſſez-moy recüeillir les cendres de mon fils.	Laissez-moi recueillir les cendres de mon fils.
Pour m'accorder la grace que i'eſpere	Pour m’accorder la grâce que j’espère
Souvenez-vous de vôtre Pere,	Souvenez-vous de votre père,
Et ſongeZ quel Amour il eut toûjours pour vous:	Et songez quel Amour il eût toujours pour vous:
Je ſentois pour mon fils une égale tendreſſe;	Je sentais pour mon fils une égale tendresse;
Ah! jugez par l’excés de cét Amour ſi doux	Ah! jugez par l’excès de cet Amour si doux
Quel doit être aujourd'huy l'excés de ma triſteſſe.	Quel doit être aujourd’hui l’excès de ma tristesse.
Que pourois-je eſperer du ſecours de mes pleurs,	Que pourrais-je espérer du secours de mes pleurs,
Si mon Pere & ma Sœur vous trouvent infléxible!	Si mon Père et ma Sœur vous trouvent inflexible!
Si vous mépriſeZ leurs douleurs,	Si vous méprisez leurs douleurs,
A mes plaintes, hélas! ſereZ-vous plus ſenſible?	À mes plaintes, hélas! serez-vous plus sensible?
Sorty du ſang des Dieux imitez leur bonté,	Sorti du sang des Dieux imitez leur bonté,
A nos ſoûpirs rendez-vous favorable,	À nos soupirs rendez-vous favorable,
N'augmentez-point l'excés de nôtre adverſité	N’augmentez point l’excès de notre adversité
Par un refus impitoyable.	Par un refus impitoyable.
Que peut-on refuſer au pouvoir de vos yeux?	Que peut-on refuser au pouvoir de vos yeux?
Vous pouvez tout en ces lieux.	Vous pouvez tout en ces lieux.
Raſſûrez-vous, calmez la douleur qui vous preſſe,	Rassurez-vous, calmez la douleur qui vous presse,
Emportez dans vos murs ce Heros glorieux,	Emportez dans vos murs ce Héros glorieux,
Ne craignez-point les efforts de la Grece,	Ne craignez point les efforts de la Grèce,
I'arrêteray ſes deſſeins furieux:	J’arrêterai ses desseins furieux:
Suivez l'ardeur qui vous anime,	Suivez l’ardeur qui vous anime,
Rien ne vous troublera dans ce ſoin legitime:	Rien ne vous troublera dans ce soin légitime:
Je ne vais ſonger déſormais	Je ne vais songer désormais
Qu'à vous donner une éternelle paix.	Qu’à vous donner une éternelle paix.
C'En eſt fait, cher Arcas, j'adore Polixene,	C’En est fait, cher Arcas, j’adore Polixène,
Quoy qu'il en coûte enfin, je veux la poſſeder;	Quoiqu’il en coûte enfin, je veux la posséder;
C'eſt toy que j'ay choiſi pour l’aller demander,	C’est toi que j’ai choisi pour l’aller demander,
Cours à Troye, il eſt temps de ſoulager ma peine.	Cours à Troie, il est temps de soulager ma peine.
Son pere à vôtre Amour voudra-t'il l'accorder?	Son père, à votre Amour, voudra-t-il l’accorder?
Il ſera trop heureux de me donner ſa fille	Il sera trop heureux de me donner sa fille
Et de me voir devenir ſon époux;	Et de me voir devenir son époux;
L’amitié que ce nœud ſera naître entre nous	L’amitié que ce nœud fera naître entre nous
Soutiendra deſormais ſon Thrône & ſa famille.	Soutiendra désormais son Trône et sa famille.
luſte Ciel! des Troyens vous deveneZ l’appuy?	Juste Ciel! Des Troyens vous devenez l’appui?
Loin de les accabler vous vouleZ les défendre?	Loin de les accabler, vous voulez les défendre?
Contre un Peuple abatu, que pourois-je entreprendre	Contre un Peuple abattu, que pourrais-je entreprendre
Aprés ce que mon bras vient de faire aujourd’huy?	Après ce que mon bras vient de faire aujourd’hui?
Hector ſeul meritoit la gloire	Hector seul méritait la gloire
De mourir par mes coups,	De mourir par mes coups,
Le reſte des Troyens aprés cette victoire	Le reste des Troyens après cette victoire
Eſt indigne de mon courroux.	Est indigne de mon courroux.
QUand aprés un cruel tourment	QUand après un cruel tourment
L’hymen ſuccéde	L’hymen succède
Aux tendres deſirs d'un Amant,	Aux tendre désirs d’un Amant,
Que le trouble qui precéde	Que le trouble qui précède
Ce bien-heureux moment	Ce bien heureux moment
Eſt doux & charmant!	Est doux et charmant!
Mais on vient en ces Lieux, ma ſurpriſe eſt extrême;	Mais, on vient en ces lieux, ma surprise est extrême;
C'eſt Agamemnon luy-même.	C’est Agamemnon lui-même.
JE ne ſçaurois plus long-temps	JE ne saurais plus longtemps
Conſerver contre vous mes chagrins & ma haine,	Conserver contre vous mes chagrins et ma haine,
Aprés vos Exploits éclatans,	Après vos Exploits éclatants,
Un mouvement plus doux prés de vous me ramene:	Un mouvement plus doux près de vous me ramène:
Avec les jours d'Hector nos perils ſont paſſeZ.	Avec les jours d’Hector nos périls sont passés,
Troye a perdu le bras qui pouvoit la défendre.	Troie a perdu la bras qui pouvait la défendre.
I'ay fait mon devoir, c'eſt aſſeZ,	J’ai fait mon devoir, c’est assez,
Vous n'aveZ point de graces à me rendre:	Vous n’avez point de grâces à mes rendre:
le n'ay point crû ſervir ceux qui mont outragé,	Je n’ai point crû servir ceux qui m’ont outragé,
Et c'eſt Patrocle ſeul que mon bras a vangé.	Et c’est Patrocle seul que mon bras a vengé.
Vôtre colere dure encore,	Votre colère dure encore,
Elle éclate dans vos diſcours;	Elle éclate dans vos discours;
Il faut pour en finir le cours	Il faut, pour en finir le cours
Vous rendre la beauté qui vous aime toûjours,	Vous rendre la beauté qui vous aime toujours,
Et que vôtre cœur adore.	Et que votre cœur adore.
Venez, charmant objet, revoyez vôtre amant.	Venez, charmant objet, revoyez votre amant.
AH Ciel! ma raiſon céde à mon étonnement.	Ah Ciel! Ma raison cède à mon étonnement.
Mes reſpects, mes ſoupirs, les marques de flâme	Mes respects, mes soupirs, les marques de flamme
N'ont fait qu'allumer ſon courroux;	N’ont fait qu’allumer son courroux;
Ses conſtantes rigueurs m’ont appris que ſon ame	Ses constantes rigueurs m’ont appris que son âme
Ne peut brûler que pour vous.	Ne peut brûler que pour vous.
IouïſſeZ du bonheur que l'amour vous preſente,	Jouissez du bonheur que l’amour vous présente,
Que vôtre ardeur s’augmente	Que votre ardeur s’augmente
De moment en moment!	De moment en moment!
Que c'eſt un plaiſir charmant	Que c’est un plaisir charmant
Aprés une abſence cruelle	Après une absence cruelle
De retrouver ſa Maîtreſſe fidele!	De retrouver sa maîtresse fidèle!
QUel triſte acceüil, Dieux! qu'eſt-ce que je voy?	QUel triste accueil, Dieux! Qu’est-ce que je vois?
Suis-je encor Briſeis? N'êtes-vous plus Achile?	Suis-je encor Briseis? N’êtes-vous plus Achille?
Pouvez-vous me revoir, & demeurer tranquile?	Pouvez vous me revoir, et demeurer tranquille?
Qu’eſt devenu l'Amour dont vous BrûlieZ pour moy?	Qu’est devenu l’Amour dont vous Brûliez pour moi?
Vous ne répondez-point?....	Vous ne répondez point?…
Helas!	Hélas!
Que me veut dire	Que me veut dire
Ce regard, ce ſoupir échapé malgré vous?	Ce regard, ce soupir échappé malgré vous?
Ah! que mon deſtin ſera doux	Ah! que mon destin sera doux,
Si c'eſt encor pour moy que vôtre cœur ſoupire!	Si c’est encor pour moi que votre cœur soupire!
O Ciel! que je ſuis malheureux!	Ô Ciel! Que je suis malheureux!
Dans quel temps venez-vous m'accabler de vo larmes?	Dans quel temps venez-vous m’accabler de vos larmes?
Que ne ſuis-je à mon gré le maître de mes vœux!	Que ne suis-je, à mon gré, le maître de mes vœux!
Ie finirois bien-tôt vos mortelles allarmes.	Je finirais bientôt vos mortelles alarmes.
Mais un charme fatal....	Mais un charme fatal…
Perfide, c'eſt aſſez.	Perfide, c'est assez.
Ie voy toute mon infortune,	Je vois toute mon infortune,
Un autre Amour te rend ma tendreſſe importune,	Un autre Amour te rend ma tendresse importune,
Ie te fatigue enfin par mes ſoins empreſſez:	Je te fatigue enfin par mes soins empressés:
Le bruit de cette amour nouvelle	Le bruit de cette amour nouvelle
Eſtoit venu juſques a moy,	Était venu jusques à moi,
Mais je n'ay pû le croire & ſoupçonner ta foy.	Mais je n’ai pu le croire, et soupçonner ta foi.
I'ay crû ton cœur trop grand pour n'être pas fidele.	J’ai cru ton cœur trop grand, pour n’être pas fidèle.
C'en eſt donc fai? Ie ne dois plus penſer	C’en est donc fait? Je ne dois plus penser
A l'hymen qui faiſoit toute mon eſperance,	À l’hymen qui faisait toute mon espérance,
A ce ſuprême honneur il me faut renoncer,	À ce suprême honneur il me faut renoncer,
D'un Amour ſi parfait, funeſte recompenſe!	D’un Amour si parfait, funeste récompense!
Dieux! quelle eſt ma douleur? Ie céde à ſon effort,	Dieux! Quelle est ma douleur? Je cède à son effort,
Cruel, peux-tu la voir avec indifference?	Cruel, peux-tu la voir avec indifférence?
Et ne ſçais-tu pas que ma mort	Et ne sais-tu pas que ma mort
Suivra de prés ton inconſtance?	Suivra de près ton inconstance?
Ie ne puis entendre	Je ne puis entendre
Une plainte ſi tendre.	Une plainte si tendre
Je ſouffre autant que vous les Dieux m'en ſont témoins,	Je souffre autant que vous les Dieux m’en sont témoins,
Faut-il vous immoler ma vie?	Faut-il vous immoler ma vie?
Ordonnez, ce ſera le plus doux de mes ſoins	Ordonnez, ce sera le plus doux de mes soins
De ſatisfaire à vôtre envie:	De satisfaire à votre envie:
Mais calmez vos transports & ne m'affligez plus	Mais, calmez vos transports, et ne m’affligez plus
Par des reproches ſuperflus.	Par des reproches superflus.
Vous connoiſſez mon cœur incapable de feindre,	Vous connaissez mon cœur incapable de feindre,
Je ſuis moins criminel que je ne ſuis à plaindre,	Je suis moins criminel que je ne suis à plaindre,
Du ſort & de l'Amour l'indispenſable loy	Du sort et de l’Amour l’indispensable loi
M'entraîne ailleurs malgré moy.	M’entraîne ailleurs malgré moi.
QUel Amant m'eſt ravy? ſa valeur, ſa nobleſſe	QUel Amant m’est ravi? Sa valeur, sa noblesse
L’élevent au deſſus du reſte des mortels,	L’élèvent au dessus du reste des mortels,
La victoire le ſuit ſans ceſſe,	La victoire le suit sans cesse,
Et ſes moindres vertus meritent des Autels;	Et ses moindres vertus méritent des Autels;
Dans le haut rang où ſon deſtin l'appelle	Dans le haut rang où son destin l’appelle
Il eût eſté parfait, s'il eût eſté fidelle.	Il eut été parfait, s’il eut été fidèle.
Mais n'eſt-il pas quelque moyen	Mais n’est-il pas quelque moyen
De détourner l'Hymen où ſon cœur ſe prepare?	De détourner l’Hymen où son cœur se prépare?
Ah! faiſons que Junon contre luy ſe declare,	Ah! faisons que Junon contre lui se déclare,
Elle haït tout le ſang Troyen,	Elle hait tout le sang Troyen,
Et ne ſouffrira pas que cét Hymen funeſte	Et ne souffrira pas que cet hymen funeste
Sauve un peuple qu'elle deteſte.	Sauve un peuple qu’elle déteste.
Puiſſante Reyne des cieux!	Puissante Reine des cieux!
Eſcoûtez-moy, daignez jetter les yeux	Écoutez moi, daignez jeter les yeux
Sur le malheur qui me menaſſe,	Sur le malheur qui me menace,
Prevenez ma honte & ma mort,	Prévenez ma honte et ma mort,
En prennant pitié de mon ſort.	En prenant pitié de mon sort.
Des perfides Troyens vous confondrez l’audace,	Des perfides Troyens vous contrez l’audace,
Mes vœux ſont exaucez, Junon deſcend des cieux,	Mes vœux sont exaucés, Junon descend des cieux,
Et pour me ſecourir s'approche de ces lieux.	Et pour me secourir s’approche de ces lieux.
CAlme tes deplaiſirs, ne verſe plus de larmes,	CAlme tes déplaisirs, ne verse plus de larmes,
L’Hymen qui cauſe tes allarmes	L’Hymen qui cause tes alarmes
Ne ſera jamais achevé.	Ne sera jamais achevé.
En vain Priam croit ſon païs ſauvé,	En vain Priam croit son pays sauvé,
Son Throne doit tomber, & de toute ſa gloire	Son Trône doit tomber, et de toute sa gloire
Il ne reſtera rien qu’une triſte memoire.	Il ne restera rien qu’une triste mémoire.
Ie vais évoquer des Enfers	Je vais évoquer des Enfers
La Hayne, la Fureur, la Diſcorde & l’Envie,	La Haine, la Fureur, la Discorde et l’Envie,
Leur preſence ſuivie	Leur présence sera suivie
De cent prodiges divers.	De cent prodiges divers.
Sortez de la nuit infernale	Sortez de la nuit infernale
Noires divinitez, vos antres ſont ouvers.	Noires divinités, vos antres sont ouverts.
L’horreur de leur Sejour, ſe répand dans les Airs!	L’horreur de leur séjour, se répand dans les Airs!
Volez, portez par tout vôtre rage fatale,	Volez, portez par tout votre rage fatale,
Verſez dans tous les Cœurs vôtre mortel poiſon,	Versez dans tous les Cœurs votre mortel poison,
ChaſſeZ la Paix de cette terre,	Chassez la paix de cette terre,
Et faites y regner la Guerre,	Et faites y régner la Guerre,
La Vangeance, & la Trahiſon.	La Vengeance et la Trahison.
VerſeZ dans tous les Cœurs voſtre mortel poiſon.	Versez dans tous les Cœurs votre mortel poison.
Pourſuivez voſtre carriere	Poursuivez votre carrière
Soleil, & rendeZ-nous vôtre clarté premiere	Soleil, et rendez-nous votre clarté première.
Favorable Déeſſe	Favorable Déesse
I'attens le ſuccés de vos ſoins.	J’attends le succès de vos soins.
Avant la fin du jour tes yeux ſeront témoins	Avant la fin du jour tes yeux seront témoins
De l'effet de ma promeſſe.	De l’effet de ma promesse.
JUnon pour moy vient de ſe declarer,	JUnon pour moi vient de se déclarer,
Elle a fait à mes yeux éclater ſa puiſſance,	Elle a fait, à mes yeux, éclater sa puissance,
Ie doy tout eſperer	Je dois tout espérer
De ſa divine aſſiſtance.	Se sa divine assistance.
Mais quel bruit harmonieux	Mais quel bruit harmonieux
Se fait entendre dans ces lieux!	Se fait entendre dans ces lieux!
Ah! je voy les Bergers que l'horreur de la Guerre	Ah? je vois les bergers que l’horreur de la Guerre
Avoit chaſſez de cette terre,	Avait chassé de cette terre,
La treve les r'appelle à leur premier Sejour,	La trêve les rappelle à leur premier Séjour,
Et déja leurs chanſons annoncent leur retour.	Et déjà leurs chansons annoncent leur retour.
Que leurs chants irritent la peine	Que leurs chants irritent la peine
Et la douleur que je ſens!	Et la douleur que je sens!
Fuyons, je ne puis voir leurs plaiſirs innocens	Fuyons, je ne puis voir leurs plaisirs innocents
Puis-qu'ils ſont dûs à Polixene.	Puisqu’ils sont dûs à Polixène.
APrés tant de trouble & de larmes	APrès tant de trouble et de larmes
Un doux repos ſuccéde à nos allarmes,	Un doux repos succède à nos alarmes,
Beniſſons à jamais	Bénissons à jamais
Le genereux Vainqueur qui nous donne la paix.	Le généreux Vainqueur, qui nous donne la paix.
Cét heureux jour doit nous charmer,	Cet heureux jour doit nous charmer,
Dans ces champs mille fleurs vont renaître,	Dans ces champs mille fleurs vont renaître,
Recommençons d'aymer	Recommençons d’aimer
En les voyant paroître.	En les voyant paraître.
Cherchons avec empreſſement	Cherchons avec empressement
Ces retraites, ces lieux paiſibles	Ces retraites, ces lieux paisibles
Que le Ciel a fait ſeulement	Que le Ciel a fait seulement
Pour le plaiſir des cœurs ſenſibles.	Pour le plaisir des cœurs sensibles.
Tristes bocages	Tristes bocages
Reprenez, vos feüillages,	Reprenez vos feuillages,
Servez-nous toûjours	Servez nous toujours
D'aZile à nos Amours.	D’asile à nos Amours.
Triſtes bocages, &c.	Tristes bocages, etc.
Paix adorable	Paix adorable,
SoyeZ toujours durable,	Soyez toujours durable,
Sans vous helas!	Sans vous, hélas!
Ces lieux n'ont point d’appas.	Ces lieux n’ont point d’appas.
Paix adorable, &c.	Paix adorable, etc.
Aprés tant de trouble & de larmes	Après tant de troubles et de larmes
Un doux repos ſuccéde à nos allarmes,	Un doux repos succède à nos alarmes,
Beniſſons à jamais	Bénissons à jamais
Le genereux Vainqueur qui nous donne la Paix.	Le généreux Vainqueur qui nous donne la Paix.
ENfin je me voy ſeule, & je puis ſans contrainte	Enfin je me vois seule, et je puis sans contrainte
Faire éclater les divers mouvemens	Faire éclater les divers mouvements
Dont mon ame eſt atteinte,	Dont mon âme est atteinte,
Et connoître du moins quels ſont mes ſentimens.	Et connaître du moins quels sont mes sentiments.
Depuis l'inſtant fatal où l’invincible Achile	Depuis l’instant fatal où l’invincible Achille
A daigné par ſes ſoins ſoulager nôtre ennuy,	A daigné par ses soins soulager notre ennui,
Ie ſuis cent fois moins tranquile,	Je suis cent fois moins tranquille,
Et je ſonge toûjours à luy.	Et je songe toujours à lui.
Seroit-ce qu'en effet une indigne foibleſſe	Serait-ce qu’en effet une indigne faiblesse
Me previendroit en ſa faveur?	Me préviendrait en sa faveur?
Non, non, je me ſouviens ſans ceſſe	Non, non, je me souviens sans cesse
Des maux que ma causé ſa funeſte valeur,	Des maux que m’a causé sa funeste valeur,
Et le vainqueur d’Hector, le vangeur de la Grece	Et le vainqueur d’Hector, le vengeur de la Grèce
Ne peut avoir aucun droit ſur mon cœur.	Ne peut avoir aucun droit sur mon cœur.
C'en eſt fait je triomphe, & dés ce moment même	C’en est fait je triomphe, et dès ce moment même
Ie ne veux plus m'en ſouvenir.	Je ne veux plus m’en souvenir.
Puiſſe, grands Dieux, vôtre pouvoir ſuprême	Puisse, grand Dieux, votre pouvoir suprême
Me condamner & me punir!	Me condamner et me punir!
Si jamais.... Ciel! que fais-je? & quel tranſport m'inſpire?	Si jamais… Ciel! Que fais-je? Et quel transport m’inspire?
Malheureuſe, qu'allois-je dire?	Malheureuse, qu’allais-je dire?
Dois-je faire un ſerment pour ne le pas tenir?	Dois-je faire un serment pour ne le pas tenir?
Ie ſouffre trop dans les cruels combats,	Je souffre trop dans les cruels combats,
Qu'il m'en coûte pour me défendre!	Qu’il m’en coûte pour me défendre!
Et je trouve mille appas	Et je trouve mille appas
A me rendre.	À me rendre.
Mais puis-je avouer ſans honte,	Mais puis-je avouer sans honte,
Que l'Amour me ſurmonte?	Que l’Amour me surmonte?
N'écouteray-je plus ny raiſon ny devoir?	N’écouterai-je plus ni raison ni devoir?
Contre ce Dieu leur force eſt impuiſſante;	Contre ce Dieu leur force est impuissante;
Eſt-il un cœur qui s'exempte	Est il un cœur qui s’exempte
De reconnoître ſon pouvoir?	De reconnaître son pouvoir?
Ie luy céde aujourd'huy. Tous mes efforts ſont vains.	Je lui cède aujourd’hui. Tous mes efforts sont vains.
Je ne puis reſiſter à l’ardeur qui m'enflame;	Je ne puis résister à l’ardeur qui m’enflamme;
Mais du moins, ſi l’Amour diſpoſe de mon ame,	Mais du moins, si l’Amour dispose de mon âme,
C'eſt en faveur du plus grand des humains.	C’est en faveur du plus grand des humains.
AH! ma ſœur, ſçauez-vous qu’Achile	Ah! ma sœur, savez-vous qu’Achille
Se flate qu'un hymen tranquile	Se flatte qu’un hymen tranquille
Avant la fin du jour doit vous unir tous deux?	Avant la fin du jour doit vous unir tous deux?
Souffrirez-vous que ce nœud s'accompliſſe?	Souffrirez-vous que ce nœud s’accomplisse?
Et pouvez-vous ſans injuſtice	Et pouvez-vous sans injustice
De ce fier ennemy favoriſer les vœux?	De ce fier ennemi favoriser les vœux?
Auriez-vous oublié que ſa valeur barbare	Auriez-vous oublié que sa valeur barbare
D'un frere tant aymé pour jamais vous ſepare?	D’un frère tant aimé pour jamais vous sépare?
D'un frere la terreur & l’amour des mortels:	D’un frère la terreur, et l’amour des mortels:
Cette ſanglante mort, cette affreuſe victoire	Cette sanglante mort, cette affreuse victoire
Toûjours preſente à ma memoire	Toujours présente à ma mémoire
A condamné mes yeux à des pleurs éternels.	A condamné mes yeux à des pleurs éternels.
Eſt-ce de moy que mon ſort doit dépendre?	Est-ce de moi que mon sort doit dépendre?
Priam ſeul en peut diſpoſer.	Priam seul en peut disposer.
Par ce détour croyez-vous m’abuſer?	Par ce détour croyez-vous m’abuser?
Non, non, je commence à comprendre	Non, non, je commence à comprendre
Quels ſont vos ſentimens ſecrets,	Quels sont vos sentiments secrets,
Vos yeux timides & diſtraits	Vos yeux timides et distraits
Ne me les font que trop entendre.	Ne me les font que trop entendre.
Que voulez-vous me dire? & que ſoupçonneZ-vous?	Que voulez-vous me dire? et que soupçonnez-vous?
Que loin de ſeconder ma haine	Que loin de seconder ma haine
Vous verrez ſans peine	Vous verrez sans peine
Ce funeſte ennemy devenir vôtre époux.	Ce funeste ennemi devenir votre époux.
Vous voulez jouïr de la gloire	Vous voulez jouir de la gloire
De triompher de ſa fierté,	De triompher de sa fierté,
C'eſt une agreable victoire	C’est une agréable victoire
Pour vôtre vanité.	Pour votre vanité.
Quand je voy ce Heros digne de mon eſtime.	Quand je vois ce héros digne de mon estime.
Sentir pour moy l'Amour le plus parfait,	Sentir pour moi l’Amour le plus parfait,
Eſt-ce un grand crime	Est-ce un grand crime
De m’en applaudir en ſecret?	De m’en applaudir en secret?
Aprés un tel aveu je n’ay plus rien à craindre,	Après un tel aveu je n’ai plus rien à craindre,
C'eſt le dernier malheur que je puis redouter.	C’est le dernier malheur que je puis redouter.
Helas! que me ſert de me plaindre?	Hélas! Que me sert de me plaindre?
Perſonne ne veut m'écouter.	Personne ne veut m’écouter.
Cher époux dont l'illuſtre vie	Cher époux, dont l’illustre vie
Fut ſi digne d’envie,	Fut si digne d’envie,
Tout ton ſang te trahit pour plaire à ton Vainqueur,	Tout ton sang te trahit pour plaire à ton Vainqueur,
Ie pleure en vain ta mort, triſte effet de ſes armes,	Je pleure en vain ta mort, triste effet de tes armes,
Ie voy mépriſer mes larmes	Je vois mépriser mes larmes
Et par ton pere & par ta ſœur:	Et par ton père, et par ta sœur:
Mais leur exemple au moins ne peut rien ſur mon ame,	Mais, leur exemple au moins ne peut rien sur mon âme,
Je ſens encor la même flame	Je sens encor la même flamme
Et la même douleur.	Et la même douleur.
Le ſeul eſpoir dont mon cœur eſt flaté,	Le seul espoir dont mon cœur est flatté,
C'eſt qu'en donnant toûjours des pleurs a ta memoire,	C’est qu’en donnant toujours des pleurs à ta mémoire,
Ie rendray ma fidelité	Je rendrai ma fidélité
Auſſi fameuſe que ta gloire.	Aussi fameuse que ta gloire.
QUel reproche fatal! je rougis de l’entendre,	Quel reproche fatal! Je rougis de l’entendre,
Il me fait ſouvenir des conſeils de Caſſandre:	Il me fait souvenir des conseils de Cassandre:
Elle me prédit chaque jour	Elle me prédit chaque jour
Que ſi jamais mon cœur s’abandonne à l’Amour	Que si jamais mon cœur s’abandonne à l’Amour
Ma foibleſſe ſera ſuivie	Ma faiblesse sera suivie
D'éternelles douleurs;	D’éternelles douleurs;
Elle m’annonce enfin de ſi cruels malheurs	Elle m’annonce enfin de si cruels malheurs
Qu’ils pourront me coûter la vie:	Qu’ils pourront me coûter la vie:
N'importe, je ne puis changer de ſentiment,	N’importe, je ne puis changer de sentiment,
Mon cœur eſt occupé d’un objet trop charmant.	Mon cœur est occupé d’un objet trop charmant.
Malgré les conſeils qu’on me donne	Malgré les conseils qu’on me donne
D’une plus vive ardeur je me ſans enflamer,	D’une plus vive ardeur je me sens enflammer,
Un cœur que le peril eſtonne	Un cœur que le péril étonne
N’eſt pas digne d’aimer.	N’est pas digne d’aimer.
MA fille, il n'eſt plus temps de répandre des pleurs,	Ma fille, il n’est plus temps de répandre des pleurs,
Voicy le jour heureux qui finit nos malheurs:	Voici le jour heureux qui finit nos malheurs;
Le fier Achile rend les armes	Le fier Achille rend les armes
A tes charmes,	À tes charmes,
Et malgré tous les Grecs jaloux de ton bon-heur	Et malgré tous les grecs, jaloux de ton bonheur
Il te donne aujourd'hui ſon Empire & ſon Cœur.	Il te donne aujourd’hui son Empire et son Cœur.
Princeſſe, ce Heros ne cherche qu'à vous plaire	Princesse, ce Héros ne cherche qu’à vous plaire
Vous avez en vos mains & ſa vie & ſa mort,	Vous avez en vos mains et sa vie et sa mort,
C'eſt à vous de regler ſon ſort;	C’est à vous de régler son sort;
Il a déja l'aveu de vôtre pere,	Il a déjà l’aveu de votre père,
Mais pour aſſûrer ſon bonheur,	Mais, pour assurer son bonheur,
Il veut ſçavoir ſi vôtre cœur	Il veut savoir si votre cœur
A ſes tendres deſirs ne ſera pas contraire.	À ses tendres désirs ne sera pas contraire.
C’eſt aſſeZ que le Roy m'ordonne d'obéïr,	C’est assez que le Roi m’ordonne d’obéir,
Ie connois mon devoir, je ne le puis trahir.	Je connais mon devoir, je ne le puis trahir.
Quel changement favorable	Quel changement favorable
Flate aujourd'huy mes deſirs!	Flatte aujourd’hui mes désirs!
Aurois-je cru mon cœur encor capable	Aurais-je cru mon cœur encor capable
De ſentir quelques plaiſirs?	De sentir quelques plaisirs?
Malgré ce changement un chagrin legitime	Malgré ce changement un chagrin légitime
En trouble la douceur & s'oppoſe à la paix;	En trouble la douceur et s’oppose à la paix;
Mais le ſoin de l'Etat eſt le ſeul qui m'anime,	Mais le soin de l’État est le seul qui m’anime,
Et je prefere à tout le bien de mes Sujets.	Et je préfère à tout le bien de mes Sujets.
Vous, que vôtre ſort intereſſe	Vous, que votre sort intéresse
Dans cét évenement heureux,	Dans cet événement heureux,
Peuples, montrez vôtre allegreſſe,	Peuples, montrez votre allégresse,
Par les Jeux les plus pompeux.	Par les Jeux les plus pompeux.
VOs beaux yeux, adorable Princeſſe,	VOs beaux yeux, adorable Princesse,
Ont détruit les deſſeins de la Grece,	Ont détruit les desseins de la Grèce,
Un ſeul de vos regards a rangé ſous vos loix	Un seul de vos regards a rangé sous vos lois
Un Heros dont le nom fait trembler tous ſes Rois.	Un Héros dont le nom fait trembler tous ses Rois.
Vos beaux yeux, adorable Princeſſe, &c.	Vos beaux yeux, adorable Princesse, etc.
Que ne peuvent point vos charmes?	Que ne peuvent point vos charmes?
Tout leur eſt ſoûmis,	Tout leur est soumis,
Ils arrachent les armes	Ils arrachent les armes
A nos ennemis.	À nos ennemis.
Que ne peuvent point vos charmes?	Que ne peuvent point vos charmes?
Tout leur eſt ſoûmis.	Tout leur est soumis.
Que ne peuvent point vos charmes,	Que ne peuvent point vos charmes,
Que l'Amour eſt puiſſant ſur les cœurs:	Que l’Amour est puissant sur les cœurs:
Il enchaîne	Il enchaîne
Sans peine	Sans peine
Les plus redoutables Vainqueurs.	Les plus redoutables Vainqueurs.
Qu'aprés une grande victoire	Qu’après une grande victoire
Un Guerrier eſt heureux,	Un Guerrier est heureux,
S'il ſçait mêler aux charmes de la gloire	S’il sait mêler aux charmes de la gloire
Le doux amuſement des plaiſirs amoureux.	Le doux amusement des plaisirs amoureux.
Vous ſi long-temps bannis de ce ſacré ſejour,	Vous, si longtemps bannis de ce sacré séjour,
Ieux charmans, revenez dans cette auguſte Cour.	Jeux charmants, revenez dans cette auguste Cour.
La Paix rameine icy l'abondance,	La Paix ramène ici l’abondance,
Faites voir vôtre magnificence,	Faites voir votre magnificence,
Par vos chants redoublez, celebrez ce grand jour,	Par vos chants redoublés, célébrez ce grand jour,
Et de vôtre bonheur rendez grace à l'Amour.	Et de votre bonheur rendez grâce à l’Amour.
La Paix rameine icy l’abondance,	La Paix ramène ici l’abondance,
Faiſons voir nôtre magnificence,	Faisons voir notre magnificence,
Par nos chants redoublez, celebrons ce grand Iour,	Par nos chants redoublés, célébrons ce grand Jour,
Et de nôtre bonheur rendons grace à l'Amour.	Et de notre bonheur rendons grâce à l’Amour.
AH, que ſur moy l’Amour regne avec violence!	Ah, aue sur moi l’Amour règne avec violence!
Que de tranſports puiſſans mon cœur eſt agité!	Que de transports puissants mon cœur est agité!
Mais j'apperçoy la divine beauté	Mais j’aperçois la divine beauté
Qui cauſe mon impatience,	Qui cause mon impatience,
Son Pere la conduit, & vient ſur ces Autels	Son père l’a conduit, et vient sur ces Autels
Entendre & confirmer nos ſerment mutuels.	Entendre et confirmer nos serments mutuels.
PRinceſſe enfin le Ciel répond à mon attente;	PRincesse enfin le Ciel répond à mon attente;
Il aſſure à mon cœur la plaiſirs la plus doux,	Il assure à mon cœur les plaisirs les plus doux,
Ah! que mon ſort doit faire de jaloux!	Ah! Que mon sort doit faire de jaloux!
Si l'Hymen dont l’eſpoir m'enchante	Si l’Hymen, dont l’espoir m’enchante
N’eſt pat un ſupplice pour vous.	N’est pas un supplice pour vous.
Quoy? ce tranſport ne ſert qu'à vous confondre?	Quoi? ce transport ne sert qu’à vous confondre?
Craignez-vous de me répondre?	Craignez-vous de me répondre?
Pourquoy tourner vos yeux de toutes parts?	Pourquoi tourner vos yeux de toute part?
N’oſez-vous ſur moy ſeul arrêter vos regards?	N’osez-vous sur moi seul arrêter vos regards?
Parlez, beauté charmante,	Parlez, beauté charmante,
Le don de vôtre cœur ſuivra-t’il vôtre foy?	Le don de votre cœur suivra-t-il votre foi?
Hélas! plus je vous voy,	Hélas! plus je vous vois,
Et plus mon trouble s'augmente.	Et plus mon trouble s’augmente.
Puis-je du moins en ma faveur	Puis-je du moins en ma faveur
Expliquer ce profond ſilence?	Expliquer ce profond silence?
Un Heros tel que vous, quand il donne ſon cœur,	Un héros tel que vous, quand il donne son cœur,
N’eſt-il pas aſſûré de la reconnoiſſance?	N’est-il pas assuré de la reconnaissance?
C'en eſt trop; vos bontez paſſent mon eſperance.	C’en est trop; vos bontés passent mon espérance.
Commençons à jouïr en ce jour	Commençons à jouir en ce jour
Des plaiſirs que la paix nous rameine	Des plaisirs que la paix nous ramène
Les feux de la haine	Les feux de la haine
Cédent à ceux de l'Amour.	Cèdent à ceux de l’Amour.
Commençons à jouïr en ce jour	Commençons à jouir en ce jour
Des plaiſirs que la paix nous rameine,	Des plaisirs que la Paix nous ramène,
Les feux de la haine	Les feux de la haine
Cédent à ceux de l'Amour.	Cèdent à ceux de l’Amour.
Peuples ſoûmis à mes loix,	Peuples soumis à mes lois,
Secondez les tranſports de mon ame;	Secondez les transports de mon âme;
Joignez vos voix	Joignez nos voix
Pour chanter les beautez de l'Objet qui m'enflâme.	Pour chanter les beautés de l’Objet qui m’enflamme.
Peuples ſoûmis à mes loix,	Peuples soumis à mes lois,
Vous joüiſſez d'un ſort tranquile,	Vous jouissez d’un sort tranquille,
Joignez vos voix	Joignez nos voix
Pour chanter les vertus & le bonheur d'Achile.	Pour chanter les vertus et le bonheur d’Achille.
Que tous ces lieux retentiſſent	Que tous ces lieux retentissent
Du nom de ces heureux époux,	Du nom de ces heureux époux,
Que l'Amour & l’Hymen les uniſſent	Que l’Amour et l’Hymen les unissent
De leurs nœuds les plus doux.	De leurs nœuds les plus doux.
Ah que vos chaînes ſont belles!	Ah! Que vos chaînes sont belles!
Tendres Amans, que vous ſerez heureux!	Tendres Amants, que vous serez heureux!
Seuls dignes l’un de l'autre, & pleins des mêmes feux,	Seuls, dignes l’un de l’autre, et pleins des mêmes feux,
Egalement charmez, également fidelles,	Également charmés, également fidèles,
Tendres Amans, que vous ſerez heureux.	Tendres Amants, que vous serez heureux.
Tendres Amans, que vous ſereZ heureux!	Tendres Amants, que vous serez heureux!
Chacun de vous connoit le prix de ce qu'il aime,	Chacun de vous connaît le prix de ce qu’il aime,
Et luy conſacre tous ſes vœux;	Et lui consacre tous ses vœux;
Chacun de ſon Amour fait ſa gloire ſuprême	Chacun de son Amour fait sa gloire suprême
Tendres Amans, que vous ſerez heureux!	Tendres Amants, que vous serez heureux!
Tendres Amans, que vous ſerez heureux.	Tendres Amants, que vous serez heureux.
Ne perdons plus de précieux momens,	Ne perdons plus de précieux moments,
Allons ſur les Autels conſacrer les Sermens	Allons sur les autels consacrer les Serments
D’une paix éternelle.	D’une paix éternelle.
Ne perdons plus de précieux momens,	Ne perdons plus de précieux moments,
Allons ſur les Autels conſacrer les Sermens,	Allons sur les Autels consacrer les Serments,
D'une paix éternelle,	D’une paix éternelle
Et d'un Amour tendre & fidele.	Et d’un Amour tendre et fidèle.
QVe vois-je? c'en eſt fait, & mon perfide Amant	QUe vois-je? C’en est fait et mon perfide Amant
Epouſe en ce moment	Épouse, en ce moment
Sa nouvelle Maîtreſſe.	Sa nouvelle Maîtresse.
Ah! Junon, eſt-ce ainſi que tu tiens ta promeſſe?	Ah! Junon, est-ce ainsi que tu tiens ta promesse?
Eſt-ce ainſi que tu romps ces funeſtes liens,	Est-ce ainsi que tu romps ces funestes liens,
Qui vont cauſer ma mort & ſauver les Troyens?	Qui vont causer ma mort et sauver les Troyens?
Un juſte deſeſpoir m'anime,	Un juste désespoir m’anime,
Mon Amour outragé demande une victime,	Mon Amour outragé demande une victime,
Courons l'immoler ou perir;	Courons l’immoler ou périr;
Si mes tranſports jaloux me font commettre un crime,	Si mes transports jaloux me font commettre un crime,
Pour l'expier je ſuis prête à mourir.	Pour l’expier je suis prête à mourir.
FUyons une mort certaine,	FUyons, une mort certaine,
Nous n'avons plus de deffenſeur.	Nous n’avons plus de défenseur.
Où courez-vous? quelle terreur	Où courez-vous? quelle terreur
Loin de ces lieux vous entraîne?	Loin de ces lieux vous entraîne?
Achile ne vit plus?	Achille ne vit plus?
Ciel! quel eſt ſon vainqueur?	Ciel! quel est son vainqueur?
L'indigne raviſſeur d'Helene	L’indigne ravisseur d’Hélène
Par une trahiſon a terminé ſon ſort.	Par une trahison a terminé son sort.
Quoy? le traiſtre Paris eſt l'autheur de ſa mort?	Quoi? le traître Pâris est l’auteur de sa mort?
DIeux! quel horrible ſpectacle!	DIeux! quel horrible spectacle!
Le perfide Paris triomphe ſans obſtacle,	Le perfide Pâris triomphe sans obstacle,
Il joüit de ſon crime, & ne me permet pas	Il jouit de son crime et ne permet pas
D'embraſſer mon époux même aprés ſon trépas.	D’embrasser mon époux même après son trépas.
D'un coup mortel j'ay vû fraper Achile,	D’un coup mortel j’ai vu frapper Achille,
J'ay retiré le trait dont il eſtoit percé;	J’ai retiré le trait dont il était percé;
Helas! dans les douleurs dont mon cœur eſt preſſé,	Hélas! Dans les douleurs dont mon cœur est pressé,
Ce trait fatal peut m'eſtre utile.	Ce trait fatal peut m’être utile.
Je vay preſſer nos Chefs & nos Soldats.	Je vais presser nos chefs et nos Soldats
De vanger le meurtre d’Achile.	De venger le meurtre d’Achille.
Oüy, dans mon deſeſpoir je conduiray leurs pas	Oui, dans mon désespoir je conduirai leur pas
Sur les remparts de vôtre Ville.	Sur les remparts de votre Ville.
Puiſſe le juſte Ciel ſe declarer pour nous!	Puisse le juste Ciel se déclarer pour nous!
Et puiſſent aujourd'huy les Toyens perir tous.	Et puissent aujourd’hui les Troyens périr tous.
VA punir les Troyens, cours hâter la vangeance	VA punir les Troyens, cours hâter la vengeance
D'un Heros qu'on vient d'immoler	D’un Héros qu’on vient d’immoler
Laiſſe-moy ſeule icy; ne vien plus me troubler	Laisse-moi seule ici; ne viens plus me troubler
Par ton odieuſe préſence.	Par son odieuse présence.
Par ces ſoins éclatans va prouver ton Amour,	Par ces soins éclatants va prouver ton Amour,
Pourſuy Paris, fais-luy ravir le jour,	Poursuis Pâris, fais lui ravir le jour,
Au Heros que tu perds l’on te verra ſurvivre.	Au Héros que tu perds l’on te verra survivre.
Depuis qu’il ne vit plus, rien ne plaiſt à mes yeux,	Depuis qu’il ne vit plus, rien ne plaît à mes yeux,
Vne ſanglante mort va finir en ces lieux	Une sanglante mort va finir en ces lieux
Les horribles tourmens ou ſa perte me livre,	Les horribles tourments où sa perte me livre,
Ah! n'eſt-il pas moins glorieux	Ah! N’est-il pas moins glorieux
De le vanger que de le ſuivre?	De le venger que de le suivre?
Mais quel triſtes objets viennent s'offrir à moy?	Mais quel tristes objets viennent s’offrir à moi?
Dieux! quel ſaiſiſſemẽt! quels tranſports! quel effroy!	Dieux! quel saisissement! quel transport! quel effroi!
Ah! je voy mon Epoux ſur l'infernale rive	Ah! Je vois mon Époux sur l’infernale rive
I'entends les cris de ſon ombre plaintive,	J’entends les cris de son ombre plaintive,
Elle m'appelle, elle me tend les bras,	Elle m’appelle, elle me tend les bras,
Ciel! je voy dans ſes yeux éclater ſa colere	Ciel! Je vois dans ses yeux éclater sa colère
Chere ombre, attends, je vais te ſatisfaire	Chère ombre, attends, je vais te satisfaire
S’il ne faut pour te plaire	S’il ne faut pour te plaire
Que courir au trépas.	Que courir au trépas.
Quel ſort d’une Amour ſi tendre!	Quel sort d’un Amour si tendre!
J'éprouve enfin tous les malheurs	J’éprouve enfin tous les malheurs
Que Caſſandre cent fois pleine de ſes fureurs	Que Cassandre cent fois, pleine de ses fureurs
Voulût en vain me faire entendre.	Voulut en vain me faire entendre.
Et toy qui teint encor du Sang de mon Epoux	Et toi? Qui teint encor du sang de mon Époux
As paſſé dans mes mains pour terminer ma vie,	As passé dans mes mains pour terminer ma vie,
Funeſte trait, ſeconde mon envie,	Funeste trait, seconde mon envie,
Que ton ſecours me ſera doux	Que ton secours me sera doux
Si tu frapes mon cœur d’une atteinte mortelle,	Si tu frappes mon cœur d’une atteinte mortelle,
Il s’avance luy même au devant de tes coups	Il s’avance lui-même au devant de tes coups,
Trop heureux ſi tu m'es fidelle.	Trop heureux si tu m’es fidèle.
C'en eſt fait, le ſuccés répond à mon attente,	C’en est fait le succès répond à mon attente,
Ie n'ay plus guere à ſouffrir,	Je n’ai plus guère à souffrir,
Ie ſens que je vais mourir	Je sens que je vais mourir
Et c'eſt aſſeZ pour me rendre contente.	Et c’est assez pour me rendre contente.
Reçoy mon Sang aprés mes pleurs	Reçois mon Sang après mes pleurs
Achile; c'eſt à toy que je me ſacrifie;....	Achille, c’est à toi que je me sacrifie;…
Sans toy je déteſte la vie,....	Sans toi je déteste la vie,…
Oüy je le jure.... helas.... je friſſonne... je meurs.	Oui, je le jure… hélas… je frissonne… je meurs.
