Il eſt icy traité d'aucunes Iuriſdictions royales, & d'autres non royales & ſubalternes.	Il est ici traité d’aucunes Juridictions royales, et d’autres non royales et subalternes.
Pour les royales, il n'eſt parlé que du Bailly & du Viconte qui ſont	Pour les royales, il n’est parlé que du Bailly et du Vicomte qui sont
dits communement les iuges ordinaires.	dits communément les juges ordinaires.
Les Iuriſdictions ſubalternes ſont celles des Seigneurs :	Les Juridictions subalternes sont celles des Seigneurs :
Il y en a de deux eſpeces, la haute & la baſſe Iuſtice.	Il y en a de deux espèces, la haute et la basse Justice.
La haute iuſtice eſt conſideree en deux ſortes.	La haute justice est considérée en deux sortes.
Il y en a dont les appellations reſſortiſſent par deuant les Baillys royaux, autres reſſortiſſent à la Cour.	Il y en a dont les appellations ressortissent par devant les Baillis royaux, autres ressortissent à la Cour.
La baſſe Iuſtice eſt celle qui appartient aux Seigneurs de fief, qui la font exercer par leurs	La basse Justice est celle qui appartient aux Seigneurs de fief, qui la font exercer par leurs
Seneſchaux pour le payement de leurs rentes, & pour les cas portez en l’article 24.	Sénéchaux pour le paiement de leurs rentes, et pour les cas portés en l’article 24.
de ceſte Couſtume & les ſuyuans.	de cette Coutume et les suivants.
ARTICLE I.	ARTICLE I.
Le Bailly ou ſon Lieutenant connoiſt de tous crimes en premiere inſtance.	Le Bailly ou son Lieutenant connaît de tous crimes en première instance.
LE BAILLY.	LE BAILLY.
Bailly eſt vn mot ancien qui vient de bail ou baillie, qu'on dit ſignifier garde & protection, & Bailly gardien, comme Charondas en ſes Pandectes, Bouteiller en ſa Somme Rural, & Guenois en la Conference des Couſtumes generales en traittent l’origine & office plus au long, & ſe liſent au cors du decret canonique pluſieurs chapitres & reſcrits faiſans mention de cet office & de celuy du Viconte.	Bailly est un mot ancien qui vient de bail ou baillie, qu’on dit signifier garde et protection, et Bailly gardien, comme Charondas en ses Pandectes, Bouteiller en sa Somme Rural, et Guenois en la Conférence des Coutumes générales en traitent l’origine et office plus au long, et se lisent au cors du secret canonique plusieurs chapitres et rescrits faisant mention de cet office et de celui du Vicomte.
Matthæus de Afflictis ſur les conſtitutions Neapolitaines, & ceux qui ont traité de Rebus Siculis rapportent que ces Iuriſdictions de Bailly & Viconte ont eſté eſtablies en Italie & Sicile par les Normans.	Matthæus de Afflictis sur les constitutions Napolitaines, et ceux qui ont traité de Rebus Siculis rapportent que ces Juridictions de Bailly et Vicomte ont été établies en Italie et Sicile par les Normands.
Entre les offices & charges d'vne Abbaye le Bailly eſt dit celuy qui a la garde des titres & enſeignemens.	Entre les offices et charges d’une Abbaye le Bailly est dit celui qui a la garde des titres et enseignements.
Bailliſtre dans les Ordonnances & la plus part des Couſtumes des autres prouinces eſt pris pour tuteur ou curateur.	Baillistre dans les Ordonnances et la plus part des Coutumes des autres provinces est pris pour tuteur ou curateur.
Ainſi le Bailly eſt comme le tuteur du peuple & le gardien & conſeruateur des loix auquel les Roys en commettent l'execution, & luy donnent pleine Iuriſdiction.	Ainsi le Bailly est comme le tuteur du peuple et le gardien et conservateur des lois auquel les Rois en commettent l’exécution, et lui donnent pleine Juridiction.
& le plet de l’eſpee,ainſi que portoit le vieil liure appellé Couſtumier, c'eſt à dire en droit ius gladij meri ac mixti Imperij.	et le plaid de l’épée, ainsi que portait le vieil livre appelé Coutumier, c’est à dire en droit ius gladij meri ac mixti Imperij.
Les appellations des Baillys en Normandie reſſortiſſoyent anciennement en	Les appellations des Baillis en Normandie ressortissaient anciennement en
l'Eſchiquier :	l’Échiquier :
mais dautant qu'il ne tenoit pas fouuent, le grand Seneſchal qui alloit par la prouince de trois ans en trois ans, connoiſſoit par forme de reformation & prouiſion, en attendant la tenuë de l'Eſchiquier, des cauſes & matieres iugees par le Bailly & Viconte, comme il ſe void audit ancien Couſtumier & en la gloſe au titre du Seneſchal au Duc.	mais d’autant qu’il ne tenait pas souvent, le grand Sénéchal qui allait par la province de trois ans en trois ans, connaissait par forme de reformation et provision, en attendant la tenue de l’Échiquier, des causes et matières jugées par le Bailly et Vicomte, comme il se void audit ancien Coutumier et en la glose au titre du Sénéchal au Duc.
Auenant vacation de l'eſtat de Bailly de Roüen le Bailliage eſt en la garde du procureur general du Roy, lequel peut tenir la Iuriſdiction du Bailliage, & a partie des gages, penſions & émolumens appartenans au Bailly durāt la vacation.	Avenant vacation de l’état de Bailly de Rouen le Bailliage est en la garde du procureur général du Roi, lequel peut tenir la Juridiction du Bailliage, et a partie des gages, pensions et émoluments appartenants au Bailly durant la vacation.
Ainſi fut pratiqué apres le decez de M. de Villebon Bailly de Roüen par M. Pericard lors procureur general du Roy, lequel nonobſtant le contredit & empeſchement du ſieur de Breuedent lieutenant general du Bailly fut mis en poſſeſſion & exercice dudit Bailliage par le premier huiſſier de la Cour en vertu de l'arreſt du 20. Aouſt 1565.	Ainsi fut pratiqué après le décès de M. de Villebon Bailly de Rouen par M. Péricard lors procureur général du Roy, lequel nonobstant le contredit et empêchement du sieur de Brévedent lieutenant général du Bailly fut mis en possession et exercice dudit Bailliage par le premier huissier de la Cour en vertu de l’arrêt du 20. Août 1565.
lequel fut ordonné à ceſte fin eſtre leu & publié en l'auditoire dudit Bailliage.	lequel fut ordonné à cette fin être lu et publié en l’auditoire dudit Bailliage.
Ledit procureur general toutesfois en ce cas ne ſe peut titrer Bailly mais ſeulement garde dudit Bailliage, comme il fut iugé par arreſt du 28. May 1516.	Ledit procureur général toutefois en ce cas ne se peut titrer Bailly mais seulement garde dudit Bailliage, comme il fut jugé par arrêt du 28. Mai 1516.
entre de Villy procureur general & le ſieur de la Barre pourueu à l'office de Bailly.	entre de Villy procureur général et le sieur de la Barre pourvu à l’office de Bailly.
Par lequel arreſt auſſi furent audit de la Barre adiugez tous les gages profits & droits du Bailliage tant en ciuil que crime depuis le decez du ſieur de Mont-Pipeau dernier Bailly, ſur leſquels neanmoins ſeroit deliuree la ſomme de cent liures audit de Villy, & que d'oreſnauant en tels cas le procureur general auroit le ſeau.	Par lequel arrêt aussi furent audit de la Barre adjugés tous les gages profits et droits du Bailliage tant en civil que crime depuis le décès du sieur de Mont-Pipeau dernier Bailly, sur lesquels néanmoins serait délivrée la somme de cent livres audit de Villy, et que dorénavant en tels cas le procureur général aurait le seau.
OV SON LIEVTENANT.	OU SON LIEUTENANT.
Les Baillys anciennement iugeoyent	Les Baillis anciennement jugeaient
eux meſmes, & eſtabliſſoyent leurs Lieutenans en chacun ſiege, Tabellions, Greffiers, Gardes du ſeel, Aduocats & Procureurs.	eux-mêmes, et établissaient leurs Lieutenants en chacun siège, Tabellions, Greffiers, Gardes du scel, Avocats et Procureurs.
Mais depuis Louys XII. par ſon Ordonnance voulut que les Lieutenans fuſſent pourueus par election & graduez, leur ayant eſté attribuee toute la function de Iuge, & oſtée aux Baillys que l’on voyoit s’addonner & arreſter plus aux armes & a la conduite de la Nobleſſe, aux conuentions des arriere-bans, ou a la ſuite de la Cour, qu'aux lettres & exercice perſonnel de la Iuſtice :	Mais depuis Louis XII. par son Ordonnance voulut que les Lieutenants fussent pourvus par élection et gradués, leur ayant été attribuée toute la fonction de Juge, et ôtée aux Baillis que l’on voyait s’adonner et arrêter plus aux armes et à la conduite de la Noblesse, aux conventions des arrière-bans, ou à la suite de la Cour, qu’aux lettres et exercice personnel de la Justice :
& veulent les Ordonnances qu'ils ſoyent maintenant de robe courte.	et veulent les Ordonnances qu’ils soient maintenant de robe courte.
Ce qui leur reſte des anciennes marc eſt la preſſeance, voix honoraire, non deliberatiue ny concluſiue par les Ordonnances de Blois art. 266.	Ce qui leur reste des anciennes marc est la préséance, voix honoraire, non délibérative ni conclusive par les Ordonnances de Blois art. 266.
& l’intitulement de leur nom aux ſentences, bien que prononcees par leurs Lieutenans, ſuyuant l'Edit de Henry II. de l'an 1551.	et l’intitulement de leur nom aux sentences, bien que prononcées par leurs Lieutenants, suivant l’Édit de Henry II. de l’an 1551.
& Ordonnances de Moullins art. 21.	et Ordonnances de Moullins art. 21.
Ce qui s’entend pour le regard des ſentences, commiſſions & autres actes emportans execution, & non des ſimples actes ſeruans à l'inſtruction des procez ſeulement, comme il a eſté iugé par arreſt ſur la modification dudit Edit.	Ce qui s’entend pour le regard des sentences, commissions et autres actes emportant exécution, et non des simples actes servants à l’instruction des procès seulement, comme il a été jugé par arrêt sur la modification dudit Édit.
Ce qui demonſtre que les Lieutenans vice Bailliuorum iudicant, non pas qu'ils reſſemblent aux Aſſeſſeurs, deſquels par le droit Romain les Gouuerneurs des prouinces ſe faiſoyent aſſiſter l. pen. C. de iud. ſans qu'iceux Aſſeſſeurs euſſent aucune autorité, ny pouuoir de faire aucune expedition de iuſtice l. 2. C. de Aſſeſſ. mais ils reſſemblent legatis corum :	Ce qui démontre que les Lieutenants vice Bailliuorum iudicant, non pas qu’ils ressemblent aux Assesseurs, desquels par le droit Romain les Gouverneurs des provinces se faisaient assister l. pen. C. de iud. sans qu’iceux Assesseurs eussent aucune autorité, ni pouvoir de faire aucune expédition de justice l. 2. C. de Assesse mais ils ressemblent legatis corum :
car à preſent aux Lieutenans tanquam ad vicarios omnis iuriſdictio tranſit. l. 2. C. de offic. eius qui vic. alt. obt. & faciunt idem tribunal cum Bailliuo.	car à présent aux Lieutenants tanquam ad vicarios omnis iurisdict o transit l. 2. C. de offic. eius qui vic. alt. obt. & faciunt idem tribunal cum Bailliuo.
Et ideo locum-tenens honoratur ſicut ille cuius locum tenet. c. ult. 93. dist.	Et ideo locum tenens honoratur sicut ille cujus locum tenet. c. ult. 93. dist.
Ce fut pourquoy par arreſt en audience du 11. May 1537. entre Maiſtre Iacques Desbuats Viconte de Fallaiſe & le Verrier Lieutenant particulier du Bailly de Caen audit Fallaiſe, fut dit que ledit Lieutenant en l'abſence du Lieutenant general du Bailly precederoit ledit Viconte en tous lieux publics, comme en l'Egliſe, offrande, proceſſion & autres honneurs, combien qu'il fuſt allegué que ledit le Verrier n'eſtoit noble, & poſtuloit deuāt ledit Vicomte, & qu'il fuſt Conſeiller de ville, & ledit Viconte Maire.	Ce fut pourquoi par arrêt en audience du 11. Mai 1537. entre Maistre Jacques Desbuats Vicomte de Fallaise et le Verrier Lieutenant particulier du Bailly de Caen audit Falaise, fut dit que ledit Lieutenant en l’absence du Lieutenant général du Bailly procéderait ledit Vicomte en tous lieux publics, comme en l’Eglise, offrande, procession et autres honneurs, combien qu’il fût allégué que ledit le Verrier n’était noble, et postulait devant ledit Vicomte, et qu’il fût Conseiller de ville, et ledit Vicomte Maire.
Et conformement a cet arreſt par autre donné au Conſeil le 19. May 1552. fut dit que de Bauquemare Lieutenant particulier du Bailly de Caux à Caudebec prefereroit Bacler Viconte en l'abſence du Lieutenant general.	Et conformément à cet arrêt par autre donné au Conseil le 19. May 1552. fut dit que de Bauquemare Lieutenant particulier du Bailly de Caux à Caudebec préfèrerait Bacler Vicomte en l’absence du Lieutenant général.
Ce qui doit eſtre eſtẽdu par identité de raiſon aux autres Lieutenans & Officiers :	Ce qui doit être entendu par identité de raison aux autres Lieutenants et Officiers :
membra enim caput ſequuntur cap. cum non liceat in princ. de preſcript. l. cum in diuerſis ff. de relig. & ſumpt. fun.	membra enim caput sequuntur cap. cum non liceat in princ. de prescript. l. cum in diuersis ff. de relig. & sumpt. fun.
En l'abſence ou recuſation des Lieutenans & Conſeillers, le plus ancien Aduocat doit tenir la iuriſdiction tant ciuile que criminelle, ainſi ordonné par arreſt les Chambres aſſemblees le 17. Nouembre 1548. arg. l. 1. & 2. de præpoſ. ſacri cubic. lib.	En l’absence ou récusation des Lieutenants et Conseillers, le plus ancien Avocat doit tenir la juridiction tant civile que criminelle, ainsi ordonné par arrêt les Chambres assemblées le 17. Novembre 1548. arg. l. 1. & 2. de præpos sacri cubic. lib.
12. c. l. 1. & 2. de præpoſ. præf. præt. C. eod. glo. pragm. ſanct. tit. de clect. S. & cum humanæ in verbo ſequentis & additio ibi.	12. c. l. 1. & 2. de præpos. præf. præt. C. eod. glo. pragm. sanct. tit. de clect. S. & cum humanæ in verbo sequentis & additio ibi.
Mais les graduez precedent les no graduez par le reglement de la Cour.	Mais les gradués précédent les non gradués par le règlement de la Cour.
Ce qui a lieu pour l'auenir, & non pour ceux qui auroient eſté receus auant ledit reglemẽt, comme il a eſté iugé par arreſt du 12. Decẽbre 1600.	Ce qui a lieu pour l’avenir, et non pour ceux qui auraient été reçus avant ledit règlement, comme il a été jugé par arrêt du 12. Décembre 1600.
contre vn nõmé Morin aduocat à Berney, qui vouloit preferer vn nõmé Deshayes & autres aduocats non graduez.	contre un nommé Morin avocat à Berney, qui voulait préférer un nommé Deshayes et autres avocats non gradués.
Autre arreſt a eſté donné à l'audience le 19. May 1542. ouy le procureur general du Roy ſur la requeſte faite par M. Oliuier Deſperroys licentié és Loix d'eſtre receu au ſerment d'aduocat:	Autre arrêt a été donné à l’audience le 19. May 1542. ouï le procureur général du Roy sur la requête faite par M. Gliuier Desperrois licenciés Lois d’être reçu au serment d’avocat:
Surquoy la Cour a ordonné que ledit Deſperrois ſera receu au ſerment ſimple d'aduocat lequel il a fait en la manière accouſtumee.	Sur quoi la Cour a ordonné que ledit Desperrois sera reçu au serment simple d’avocat lequel il a fait en la manière accoutumée.
Et auant que d'ordonner s'il ſera receu à aſſiſter aux iugemens deuant les iuges ordinaires & donner ſentence & opinion, a ordonné que ledit Deſperrois ſera examiné par deuant les Conſeillers Commiſſaires ſur ce deputez, & fait inhibitions & deffences a tous Iuges inferieurs de receuoir aucun a opiner pour donner ſentence & iugement és procez pendans par deuant eux iuſques a ce qu'il ait eſté examiné ſur ſa litterature, & experience & trouué ſuffiſant.	Et avant que d’ordonner s’il sera reçu à assister aux jugements devant les juges ordinaires et donner sentence et opinion, a ordonné que ledit Desperrois sera examiné par devant les Conseillers Commissaires sur ce députés, et fait inhibitions et défenses à tous Juges inférieurs de recevoir aucun à opiner pour donner sentence et jugement ès procès pendants par devant eux jusques a ce qu’il ait été examiné sur sa littérature, et expérience et trouvé suffisant.
Depuis par autre arreſt du 27. Mars 1612.	Depuis par autre arrêt du 27. Mars 1612.
a l'audience en la cauſe appellée des Docteurs de l'Vniuerſité de Caen & les aduocats de Bayeux, ſur la requeſte verbalement faite par M. du Viquet premier aduocat general du Roy, inhibitions & deffenſes ont eſté faites auſdicts Docteurs de paſſer aucuns licentiez ny docteurs ſans eſtre examinez ſuiuant l’ordonnance, & deffenſes pareillement aux iuges de receuoir aucuns aduocats ſans licences, & deffendu aux aduocats receus depuis trois ans de poſtuler ſans prendre grade, & ordonné que le preſent arreſt ſera enuoyé par tous les Bailliages pour y etre leu & publié.	à l’audience en la cause appelée des Docteurs de l’Université de Caen et les avocats de Bayeux, sur la requête verbalement faite par M. du Viquet premier avocat général du Roy, inhibitions et défenses ont été faites auxdits Docteurs de passer aucuns licenciés ni docteurs sans être examinés suivant l’ordonnance, et défenses pareillement aux juges de recevoir aucuns avocats sans licences, et défendu aux avocats reçus depuis trois ans de postuler sans prendre grade, et ordonné que le présent arrêt sera envoyé par tous les Bailliages pour y être lu et publié.
Par autre arreſt donné à l'audience le 2. Aouſt audit an 1612. ſur la requeſte faite par ledit ſieur du Viquet, la Cour a fait inhibitions & deffences à tous aduocats receus en icelle de prendre ladite qualité d'aduocat s’il n'en ſont actuellement la charge & function & poſtulent au barreau de ladite Cour ou aux principaux ſieges des Bailliages & Vicontez de ce reſſort, & à tous Iuges de les receuoir en cette charge s’ils n'ont pris lettre de licence en Vniuerſité fameuſe, & qu'ils n'en facent apparoir enſemble de l'acte de leur reception. Et par autre arreſt du 7. Iuin 1613. a eſté deffendu à tous Iuges de receuoir aucuns aduocats au ſerment de function de ladite charge d'aduocat ſinon les aſſiſes ſeantes, & ordonné que le preſent arreſt ſera enuoyé par tous les ſieges de ce reſſort.	Par autre arrêt donné à l’audience le 2. Août audit an 1612. sur la requête faite par ledit sieur du Viquet, la Cour a fait inhibitions et défenses à tous avocats reçus en icelle de prendre ladite qualité d’avocat s’il, n’en sont actuellement la charge et fonction et postulent au barreau de ladite Cour ou aux principaux sièges des Bailliages et Vicomtés de ce ressort, et à tous Juges de les recevoir en cette charge s’ils n’ont pris lettre de licence en Université fameuse, et qu’ils n’en fassent apparoir ensemble de l’acte de leur réception. Et par autre arrêt du 7. Juin 1613. a été défendu à tous Juges de recevoir aucuns avocats au serment de fonction de ladite charge d’avocat sinon les assises séantes, et ordonné que le présent arrêt sera envoyé par tous les sièges de ce ressort.
Par arreſt donné au Conſeille 27. Auril 1569. entre les Recteur & Suppoſts de l'Vniuerſité de Caen, fut dit que nul ne ſeroit receu au ſerment d'office & eſtat de iudicature és Iuriſdictions qui reſſortiſent en la Cour mediatement ou immediatement, s’il n’eſt licentié en droit ciuil ou canon ;	Par arrêt donné au Conseille 27. Avril 1569. entre les Recteur et Suppôts de l’Université de Caen, fut dit que nul ne serait reçu au serment d’office et état de judicature ès Juridictions qui ressortissent en la Cour médiatement ou immédiatement, s’il n’est licencié en droit civil ou canon ;
auec deffenſes aux Docteurs regens de ladite Vniuerſite de paſſer aucun licentié s’il n'eſt ſuffiſant & capable. Que ſi celuy qui a eſté receu au ſerment d'aduocat, n'en a fait profeſſion & exercice, & neanmoins ſe veut ingerer à faire la function de Iuge en ſon abſence & de ſes Lieutenans au deuant des autres aduocats receus apres luy & ayans fait continuel exercice d'aduocats, il ſemble n'eſtre raiſonnable le permettre, & ne luy appartient.	avec défenses aux Docteurs régents de ladite Université de passer aucun licencié s’il n’est suffisant et capable. Que si celui qui a été reçu au serment d’avocat, n’en a fait profession et exercice, et néanmoins se veut ingérer à faire la fonction de Juge en son absence et de ses Lieutenants au devant des autres avocats reçus après lui et ayant fait continuel exercice d’avocats , il semble n’être raisonnable le permettre, et ne lui appartient.
Qui ſunt enim in collegio alicuius artis, ſi illam artem non exercent non debent gaudere priuilegio illius artis, Bart. in l. ſemper S. quibuſdam ff. de iure immun. gloſ. pragmat. ſanct. S. quod ad dictas in verbo reſidebunt de collat.	Qui sunt enim in collegio alicuius artis, si illam artem non exercent non debent gaudere priuilegio illius artis, Bart, in l. semper S. quibusdam ff. de iure immun. glos. pragmat. sanct. S. quod ad dictas in verbo residebunt de collat.
Par la diſpoſition du droit ciuil Aduocatus qui abfuit per quinquennium perdit matriculam l.	Par la disposition du droit civil Aduocatus qui abfuit per quinquennium perdit matriculam l.
2. circa medium de primicerio lib.	2. circa medium de primicerio lib.
12. C. l. 3. de Domeſt. & protect. eod. Rebuffi in Tractatu de nominationibus, queſt. 21. num. 21.	12. C. l. 3. de Domest. & protect. eod. Rebuffi in Tractatu de nominationibus, quest. 21. num. 21.