Je ſçay que vous eſtes trop ſage pour conſeiller jamais un Duel;	Je sais que vous êtes trop sage pour conseiller jamais un Duel;
c’eſt pourquoy je vous demande voſtre avis ſur celuy que j’ay reſolu de faire;	c’est pourquoi je vous demande votre avis sur celui que j’ai résolu de faire;
car enfin (comme vous ſçavez) l’honneur ſaly ne ſe lave qu’avec du ſang.	car enfin (comme vous savez) l’honneur sali ne se lave qu’avec du sang.
Hier je fus apellé ſot, & l’on s’émancipa de me donner un ſoufflet en ma preſence:	Hier je fus appelé sot, et l’on s’émancipa de me donner un soufflet en ma présence:
Il eſt vray que ce fut en une compagnie fort honorable.	Il est vrai que ce fut en une compagnie fort honorable.
Certains ſtupides en matiere de démélez, diſent qu’il faut que je periſſe, ou que je me vange.	Certains stupides en matière de démêlés, disent qu’il faut que je périsse, ou que je me venge.
Vous, Monſieur, dites-moy, vous, mon plus cher Amy, & que j’eſtime trop ſage pour m’exciter à aucune action cruelle;	Vous, Monsieur, dites-moi, vous, mon plus cher Ami, et que j’estime trop sage pour m’exciter à aucune action cruelle;
Ne ſuis-je pas aſſez maltraitté de la langue, & de la main de ce Poltron, ſans irriter encore ſon épée;	Ne suis-je pas assez maltraité de la langue, et de la main de ce Poltron, sans irriter encore son épée;
car quoy que je ſois mary d’eſtre appellé ſot, je ſerois bien plus fâché qu’on me reprochât d’eſtre défunt.	car quoi que je sois marri d’être appelé sot, je serais bien plus fâché qu’on me reprochât d’être défunt.
Si j’eſtois enfermé dans un ſepulchre, il pourroit à ſon aiſe, & en ſeureté, mal parler de mon courage.	Si j’étais enfermé dans un sépulcre, il pourrait à son aise, et en sûreté, mal parler de mon courage.
Ne ſeray-je donc pas mieux de demeurer au monde, afin d’eſtre toûjours preſent pour le châtier quand ſa temerité m’en donnera ſujet.	Ne serai-je donc pas mieux de demeurer au monde, afin d’être toujours présent pour le châtier quand sa témérité m’en donnera sujet.
Infailliblement ceux qui me conſeillent la tragedie, ne jugent pas que ſi j’en ſuis la caſtatrophe, il ſe moquera de ma valeur:	Infailliblement ceux qui me conseillent la tragédie, ne jugent pas que si j’en suis la catastrophe, il se moquera de ma valeur:
Si je le tuë, on croira que je l’ay chaſſé du monde, parce que je n’oſois y demeurer tant qu’il y ſeroit;	Si je le tue, on croira que je l’ai chassé du monde, parce que je n’osais y demeurer tant qu’il y serait;
Si je luy oſte la rapiere, on dira que j’apprehendois qu’il demeurât armé:	Si je lui ôte la rapière, on dira que j’appréhendais qu’il demeurât armé:
Si nous demeurons égaux, à quoy bon ſe mettre au hazard du plus grand de tous les malheurs, qui eſt la mort, pour ne rien décider:	Si nous demeurons égaux, à quoi bon se mettre au hasard du plus grand de tous les malheurs, qui est la mort, pour ne rien décider:
Et puis quand j’aurois lettre du Dieu Mars, de ſortir de ce combat à mon honneur, il pourroit au moins ſe vanter de m’avoir contraint à commettre une inſigne folie:	Et puis quand j’aurais lettre du Dieu Mars, de sortir de ce combat à mon honneur, il pourrait au moins se vanter de m’avoir contraint à commettre une insigne folie:
Non, non, je ne déguaiſne point;	Non, non, je ne dégaine point;
c’eſt craindre ſon ennemy de vouloir par le moyen de la mort, ou l’éloigner de ſoy, ou s’éloigner de luy:	c’est craindre son ennemi de vouloir par le moyen de la mort, ou l’éloigner de soi, ou s’éloigner de lui:
Pour moy je n’apprehende pas qu’il ſoit où je ſeray.	Pour moi je n’appréhende pas qu’il soit où je serai.
Il tient à gloire de n’avoir jamais redouté les Parques;	Il tient à gloire de n’avoir jamais redouté les Parques;
s’il veut que je le croye, qu’il ſe tuë, j’iray conſulter tous les Sages pendant ſoixante ou quatre-vingts ans, pour ſçavoir s’il a bien fait;	s’il veut que je le croie, qu’il se tue, j’irai consulter tous les Sages pendant soixante ou quatre-vingts ans, pour savoir s’il a bien fait;
& ſi l’on me répond qu’oüy alors je tâcheray d’en vivre encore autant pour faire le reſte de mes jours penitence de ma poltronnerie.	et si l’on me répond que oui alors je tâcherai d’en vivre encore autant pour faire le reste de mes jours pénitence de ma poltronnerie.
Vous trouverez peut-eſtre ce procedé fort étrange dans un homme de cœur comme moy:	Vous trouverez peut-être ce procédé fort étrange dans un homme de cœur comme moi:
Mais, Monſieur, à parler franc, je trouve que j’aime mieux me tenir à ma carte, que de mettre au hazard en les broüillant, d’en avoir une pire.	Mais, Monsieur, à parler franc, je trouve que j’aime mieux me tenir à ma carte, que de mettre au hasard en les brouillant, d’en avoir une pire.
Ce Monſieur le Matamore veut peut eſtre mourir bien-toſt, afin d’en eſtre quitte de bonne heure;	Ce Monsieur le Matamore veut peut-être mourir bientôt, afin d’en être quitte de bonne heure;
mais moy qui ſuis plus genereux, je tâche de vivre plus long-temps, au riſque d’eſtre long-temps en eſtat de pouvoir mourir.	mais moi qui suis plus généreux, je tâche de vivre plus longtemps, au risque d’être longtemps en état de pouvoir mourir.
Penſe-t’il ſe rendre fort recommandable, pour témoigner qu’il s’ennuye de ne pas retourner à la nuit ſa premiere maiſon, eſt-ce qu’il a peur du Soleil?	Pense-t-il se rendre fort recommandable, pour témoigner qu’il s’ennuie de ne pas retourner à la nuit sa première maison, est-ce qu’il a peur du Soleil?
Helas!	Hélas!
le pauvre bufle, s’il ſçavoit ce que c’eſt que d’eſtre trépaſſé, rien ne le preſſeroit.	le pauvre buffle, s’il savait ce que c’est que d’être trépassé, rien ne le presserait.
Un homme ne fait rien d’illuſtre qui devant trente ans met ſa vie en danger, parce qu’il expoſe ce qu’il ne connoiſt pas;	Un homme ne fait rien d’illustre qui devant trente ans met sa vie en danger, parce qu’il expose ce qu’il ne connaît pas;
mais lors qu’il la hazarde depuis cét âge-là, je ſoûtiens qu’il eſt enragé de la riſquer, l’ayant connuë.	mais lorsqu’il la hasarde depuis cet âge-là, je soutiens qu’il est enragé de la risquer, l’ayant connue.
Quant à moy je trouve le jour tres-beau, & je n’aime point à dormir ſous terre, à cauſe qu’on n’y voit goutte.	Quant à moi je trouve le jour très-beau, et je n’aime point à dormir sous terre, à cause qu’on n’y voit goutte.
Qu’il ne s’enfle point pourtant de ce refus, car je veux bien qu’il ſçache que je ſçay une botte à tuer meſme un Geant charmé, & qu’à cauſe de cela je ne veux point me battre, de peur qu’on ne l’apprenne.	Qu’il ne s’enfle point pourtant de ce refus, car je veux bien qu’il sache que je sais une botte à tuer même un Géant charmé, et qu’à cause de cela je ne veux point me battre, de peur qu’on ne l’apprenne.
Il y a encore cent autres raiſons qui me font abhorrer le Duel;	Il y a encore cent autres raisons qui me font abhorrer le Duel;
Moy j’irois ſur le pré, & là fauché parmy l’herbe m’embarquer poſſible pour l’autre monde:	Moi j’irais sur le pré, et là fauché parmi l’herbe m’embarquer possible pour l’autre monde:
Helas!	Hélas!
mes creanciers n’attendent que cela pour m’accuſer de banqueroute;	mes créanciers n’attendent que cela pour m’accuser de banqueroute;
mais penſeroit-il meſme m’avoir mis à jubé, quand il m’auroit oſté la vie, au contraire j’en deviendrois plus terrible, & je ſuis aſſuré qu’il ne pourroit me regarder quinze jours aprés, ſans que je luy fiſſe peur.	mais penserait-il même m’avoir mis à jubé, quand il m’aurait ôté la vie, au contraire j’en deviendrais plus terrible, et je suis assuré qu’il ne pourrait me regarder quinze jours après, sans que je lui fisse peur.
S’il aſpire à la gloire de m’avoir égorgé pourveu que je me porte bien, je luy permets de ſe vanter par tout d’eſtre mon bourreau;	S’il aspire à la gloire de m’avoir égorgé pourvu que je me porte bien, je lui permets de se vanter par tout d’être mon bourreau;
auſſi-bien quand il m’auroit tué, la gloire ne ſeroit pas grande, une poignée de cyguë en feroit bien autant.	aussi bien quand il m’aurait tué, la gloire ne serait pas grande, une poignée de ciguë en ferait bien autant.
Il va s’imaginer peut-eſtre que la Nature m’a fort mal-traitté en me refuſant du courage;	Il va s’imaginer peut-être que la Nature m’a fort mal-traité en me refusant du courage;
mais qu’il apprenne que la Nature ne ſçauroit nous joüer un plus vilain trait, que de ſe ſervir contre nous de celuy du fort;	mais qu’il apprenne que la Nature ne saurait nous jouer un plus vilain trait, que de se servir contre nous de celui du fort;
que la moindre Puce en vie, vaut mieux que le grand Alexandre decedé;	que la moindre Puce en vie, vaut mieux que le grand Alexandre décédé;
& qu’enfin je me ſens indigne d’obliger des Torches beniſtes à pleurer ſur mes armoiries:	et qu’enfin je me sens indigne d’obliger des Torches bénites à pleurer sur mes armoiries:
J’aime veritablement qu’on me flate de toutes les qualitez d’un bel eſprit, horſmis de celle d’heureuſe memoire, qui m’eſt inſupportable, & pour cauſe;	J’aime véritablement qu’on me flatte de toutes les qualités d’un bel esprit, hormis de celle d’heureuse mémoire, qui m’est insupportable, et pour cause;
Une autre raiſon me défend encore les batailles;	Une autre raison me défend encore les batailles;
J’ay compoſé mon Epitaphe, dont la pointe eſt fort bonne, pourveu que je vive cent ans;	J’ai composé mon Épitaphe, dont la pointe est fort bonne, pourvu que je vive cent ans;
& j’en ruinerois la rencontre heureuſe, ſi je m’hazardois de mourir plus jeûne:	et j’en ruinerais la rencontre heureuse, si je m’hasardais de mourir plus jeûne:
Ajoutez à cela que j’abhorre ſur toutes choſes les maladies, & qu’il n’y a rien de plus nuiſible à la ſanté que la mort;	Ajoutez à cela que j’abhorre sur toutes choses les maladies, et qu’il n’y a rien de plus nuisible à la santé que la mort;
Ne vaut-il donc pas bien mieux s’encourager à devenir Poltron, que de ſe rendre la cauſe de tant de deſaſtres.	Ne vaut-il donc pas bien mieux s’encourager à devenir Poltron, que de se rendre la cause de tant de désastres.
Ainſi (forts de noſtre foibleſſe) on ne nous verra jamais ny pâlir, ny trembler que d’apprehenſion d’avoir trop de cœur:	Ainsi (forts de notre faiblesse) on ne nous verra jamais ni pâlir, ni trembler que d’appréhension d’avoir trop de cœur:
Et toy, ô ſalutaire poltronnerie!	Et toi, ô salutaire poltronnerie!
je te vouë un Autel, & je promets de te ſervir avec un culte ſi devot, que pour commencer dés aujourd’huy, je dédie cette Epiſtre au Lâche le plus confirmé de tes enfans, de peur que quelque Brave, à qui je l’euſſe envoyée, ne ſe fût imaginé que j’eſtois homme à le ſervir pour ces quatre méchans mots qu’on eſt obligé d’écrire à la fin de toutes les Lettres;	je te voue un Autel, et je promets de te servir avec un culte si dévot, que pour commencer dès aujourd’hui, je dédie cette Épître au Lâche le plus confirmé de tes enfants, de peur que quelque Brave, à qui je l’eusse envoyée, ne se fût imaginé que j’étais homme à le servir pour ces quatre méchants mots qu’on est obligé d’écrire à la fin de toutes les Lettres;
Je ſuis,	Je suis,
Je ſçay bien qu’une ame baſſe comme la voſtre, ne ſçauroit naturellement s’empêcher de médire, auſſi n’eſt-ce pas une abſtinence où je vous veüille condamner:	Je sais bien qu’une âme basse comme la vôtre, ne saurait naturellement s’empêcher de médire, aussi n’est-ce pas une abstinence où je vous veuille condamner:
La ſeule courtoiſie que je veux de vous, c’eſt de me déchirer ſi doucement, que je puiſſe faire ſemblant de ne le pas ſentir.	La seule courtoisie que je veux de vous, c’est de me déchirer si doucement, que je puisse faire semblant de ne le pas sentir.
Vous pouvez connoiſtre par là qu’on m’envoye la Gazette du Païs Latin;	Vous pouvez connaître par là qu’on m’envoie la Gazette du Pays Latin;
Remerciez Dieu, de ce qu’il m’a donné une ame aſſez raiſonnable, pour ne croire pas tout le monde de toutes choſes, à cauſe que tout le monde peut dire toutes choſes;	Remerciez Dieu, de ce qu’il m’a donné une âme assez raisonnable, pour ne croire pas tout le monde de toutes choses, à cause que tout le monde peut dire toutes choses;
autrement j’aurois appliqué à vos maux de ratte un plus ſolide & plus puiſſant antidote que le diſcours.	autrement j’aurais appliqué à vos maux de rate un plus solide et plus puissant antidote que le discours.
Ce n’eſt pas que j’aye jamais attendu des actions fort humaines d’une perſonne qui ſortoit de l’humanité;	Ce n’est pas que j’aie jamais attendu des actions fort humaines d’une personne qui sortait de l’humanité;
mais je ne pouvois croire, que voſtre cervelle euſt ſi generalement échoüé contre les bancs de la Rhetorique, que vous euſſiez porté en Philoſophie un homme ſans teſte.	mais je ne pouvais croire, que votre cervelle eût si généralement échoué contre les bancs de la Rhétorique, que vous eussiez porté en Philosophie un homme sans tête.
On auroit à la verité trouvé fort étrange, que dans un corps ſi vaſte, voſtre petit eſprit ne ſe fût pas perdu;	On aurait à la vérité trouvé fort étrange, que dans un corps si vaste, votre petit esprit ne se fût pas perdu;
auſſi ne l’a-t’il pas fait longue, & j’ay oüy dire qu’il y a de bonnes années que vous ne ſçauriez plus abandonner la vie, que voſtre trépas accompagné de miracles ne vous faſſe canoniſer:	aussi ne l’a-t’il pas fait longue, et j’ai ouï dire qu’il y a de bonnes années que vous ne sauriez plus abandonner la vie, que votre trépas accompagné de miracles ne vous fasse canoniser:
Ouy, prenez congé du Soleil quand il vous plaira, vous eſtes aſſuré d’une ligne dans nos Litanies, quand le Conſiſtoire apprendra que vous ſerez mort ſans avoir rendu l’eſprit;	Oui, prenez congé du Soleil quand il vous plaira, vous êtes assuré d’une ligne dans nos Litanies, quand le Consistoire apprendra que vous serez mort sans avoir rendu l’esprit;
mais conſolez vous, vous n’en durerez pas moins pour cela;	mais consolez vous, vous n’en durerez pas moins pour cela;
Les Cerfs & les Corbeaux, dont l’eſprit eſt taillé à la meſure du voſtre, vivent quatre cens ans;	Les Cerfs et les Corbeaux, dont l’esprit est taillé à la mesure du vôtre, vivent quatre cents ans;
& ſi le manque de genie eſt la cauſe de leur durée, vous devez eſtre celuy qui fera l’Epitaphe du Genre humain.	et si le manque de génie est la cause de leur durée, vous devez être celui qui fera l’Épitaphe du Genre humain.
C’eſt ſans doute en conſequence de ce brutal inſtinct de voſtre nature, que vous choiſiſſez l’or & les pierres precieuſes pour répandre deſſus voſtre venin.	C’est sans doute en conséquence de ce brutal instinct de votre nature, que vous choisissez l’or et les pierres précieuses pour répandre dessus votre venin.
Souffrez donc, encore que vous pretendiez vous ſouſtraire de l’empire que Dieu a donné aux hommes ſur les bêtes, que je vous commande de vomir ſur quelque choſe de plus ſale que mon nom, & de vous reſſouvenir (car je croy que les animaux comme vous ont quelque reminiſcence) que le Createur n’a donné à ceux de voſtre eſpece une langue que pour avaler, & non pas pour parler:	Souffrez donc, encore que vous prétendiez vous soustraire de l’empire que Dieu a donné aux hommes sur les bêtes, que je vous commande de vomir sur quelque chose de plus sale que mon nom, et de vous ressouvenir (car je crois que les animaux comme vous ont quelque réminiscence) que le Créateur n’a donné à ceux de votre espèce une langue que pour avaler, et non pas pour parler:
Souvenez-vous-en donc, c’eſt le meilleur conſeil que vous puiſſiez prendre;	Souvenez-vous-en donc, c’est le meilleur conseil que vous puissiez prendre;
car quoy que voſtre foibleſſe faſſe pitié, celles des Poux & des Puces qui nous importunent, ne nous obligent pas à leur pardonner.	car quoi que votre faiblesse fasse pitié, celles des Poux et des Puces qui nous importunent, ne nous obligent pas à leur pardonner.
Enfin ceſſez de mordre, Simulacre de l’envie;	Enfin cessez de mordre, Simulacre de l’envie;
car quoy que je ſois peu ſenſible à l’injure, je ſuis ſevere à la punir, rien n’empêcheroit la vertu d’un Elebore, qu’on appelle en François Tricot, duquel pour vous montrer que je ſuis Philoſophe (ce que vous ne croyez pas) je vous châtierois avec ſi peu d’animoſité, que le chapeau dans une main, & dans l’autre un bâton, je vous dirois en vous briſant les os;	car quoi que je sois peu sensible à l’injure, je suis sévère à la punir, rien n’empêcherait la vertu d’un Ellébore, qu’on appelle en Français Tricot, duquel pour vous montrer que je suis Philosophe (ce que vous ne croyez pas) je vous châtierais avec si peu d’animosité, que le chapeau dans une main, et dans l’autre un bâton, je vous dirais en vous brisant les os;
Je ſuis,	Je suis,
Si tout le monde eſtoit obligé comme moy, pour faciliter la lecture de ſes Lettre, d’envoyer de l’argent, les Balzacs, n’auroient jamais écrit, & les Aveugles ſçauroient lire;	Si tout le monde était obligé comme moi, pour faciliter la lecture de ses Lettre, d’envoyer de l’argent, les Balzacs, n’auraient jamais écrit, et les Aveugles sauraient lire;
Mais quoy, ſi les miennes ne ſont éclairées par la reflexion de l’or de quelque Loüys, vous n’y voyez que du noir de Grimoire;	Mais quoi, si les miennes ne sont éclairées par la réflexion de l’or de quelque Louis, vous n’y voyez que du noir de Grimoire;
& quand meſme je les aurois priſes dans Polexandre, je ſuis aſſuré d’avoir pour vous écrit en Hebreu;	et quand même je les aurais prises dans Polexandre, je suis assuré d’avoir pour vous écrit en Hébreu;
Ouvrir la bouche, & mouvoir les levres en toutes les façons neceſſaires à l’expreſſion de noſtre langue, ne vous fait entendre que de l’Arabe:	Ouvrir la bouche, et mouvoir les lèvres en toutes les façons nécessaires à l’expression de notre langue, ne vous fait entendre que de l’Arabe:
Pour vous parler François, il faut ouvrir la main, ainſi ma bourſe devient chez moy le ſeul organe, par lequel je vous puiſſe éclaircir les difficultez de la Bible, & vous rendre les Centuries de Noſtradamus auſſi faciles que le Pater.	Pour vous parler Français, il faut ouvrir la main, ainsi ma bourse devient chez moi le seul organe, par lequel je vous puisse éclaircir les difficultés de la Bible, et vous rendre les Centuries de Nostradamus aussi faciles que le Pater.
Enfin, Mademoiſelle, c’eſt de vous ſeule que l’on peut dire avec verité, point d’argent point de Suiſſe.	Enfin, Mademoiselle, c’est de vous seule que l’on peut dire avec vérité, point d’argent point de Suisse.
Je me conſole aiſément de voſtre humeur, parce que tant que vous ne changerez point, je ſuis aſſuré d’eſtre en puiſſance avec la Croix de quelques piſtoles, de chaſſer plus facilement, qu’avec l’eau beniſte & l’exorciſme, le Demon d’avarice;	Je me console aisément de votre humeur, parce que tant que vous ne changerez point, je suis assuré d’être en puissance avec la Croix de quelques pistoles, de chasser plus facilement, qu’avec l’eau bénite et l’exorcisme, le Démon d’avarice;
mais j’ay tort de vous reprocher une ſi grande baſſeſſe, ce ſont au contraire des motifs de vertu qui vous font agir de la ſorte;	mais j’ai tort de vous reprocher une si grande bassesse, ce sont au contraire des motifs de vertu qui vous font agir de la sorte;
car ſi vous tombez plus ſouvent ſous la Croix, que les malfaicteurs de Judée, c’eſt parce que vous croyez pieuſement que les Juſtes ne vous ſçauroient rien demander injuſtement, & que l’or, ce ſymbole de la pureté, ne vous ſçauroit eſtre donné qu’avec des intentions tres-pures.	car si vous tombez plus souvent sous la Croix, que les malfaiteurs de Judée, c’est parce que vous croyez pieusement que les Justes ne vous sauraient rien demander injustement, et que l’or, ce symbole de la pureté, ne vous saurait être donné qu’avec des intentions très pures.
Je penſe meſme, comme vous eſtes, auſſi bien que bonne Chreſtienne, encore meilleure Françoiſe, que vous vous abaiſſez devant tous ceux qui vous preſentent les Images de nos Roys;	Je pense même, comme vous êtes, aussi bien que bonne Chrétienne, encore meilleure Française, que vous vous abaissez devant tous ceux qui vous présentent les Images de nos Rois;
& que meſme comme vous eſtes d’une probité exemplaire, qui ne veut faire tort à perſonne, vous eſtes tellement ſcrupuleuſe à la diſtribution de vos faveurs, que vous vous appuyez davantage ſur les baiſers de dix piſtoles, que ſur ceux de neuf.	et que même comme vous êtes d’une probité exemplaire, qui ne veut faire tort à personne, vous êtes tellement scrupuleuse à la distribution de vos faveurs, que vous vous appuyez davantage sur les baisers de dix pistoles, que sur ceux de neuf.
Cette œconomie ne me déplaiſt pas, car je ſuis aſſuré, tenant ma bourſe dans une main, de tenir voſtre cœur dans l’autre.	Cette économie ne me déplaît pas, car je suis assuré, tenant ma bourse dans une main, de tenir votre cœur dans l’autre.
Tout ce qui me fâche, c’eſt de ce que cette chere Image, que vous juriez autrefois avoir imprimé fort avant dans voſtre cœur, vous la mettez hors de chez vous par les épaules, ſi toſt qu’elle y a demeuré trois jours ſans payer ſon giſte.	Tout ce qui me fâche, c’est de ce que cette chère Image, que vous juriez autrefois avoir imprimé fort avant dans votre cœur, vous la mettez hors de chez vous par les épaules, si tôt qu’elle y a demeuré trois jours sans payer son gîte.
Pour moy je penſe que vous avez oublié la definition de l’homme, car toutes vos actions me prouvent que vous ne me prenez que pour un animal donnant, cependant je croyois eſtre par l’opinion d’Ariſtote un animal raiſonnable;	Pour moi je pense que vous avez oublié la définition de l’homme, car toutes vos actions me prouvent que vous ne me prenez que pour un animal donnant, cependant je croyais être par l’opinion d’Aristote un animal raisonnable;
mais je voy bien qu’il me faut reſoudre à ceſſer d’eſtre ce que je ſuis, du moment que je ceſſe de foüiller à ma poche.	mais je vois bien qu’il me faut résoudre à cesser d’être ce que je suis, du moment que je cesse de fouiller à ma poche.
Corrigez, je vous prie, cette humeur qui convient fort mal à voſtre jeuneſſe & à cette generoſité dont vous vous faites toute blanche;	Corrigez, je vous prie, cette humeur qui convient fort mal à votre jeunesse et à cette générosité dont vous vous faites toute blanche;
car il vous eſt honteux d’eſtre à mes gages, moy qui ſuis,	car il vous est honteux d’être à mes gages, moi qui suis,
Par l’affection que je vous ay portée dont vous eſtes indigne, je vous ay fait meriter d’eſtre mon ennemy.	Par l’affection que je vous ai portée dont vous êtes indigne, je vous ai fait mériter d’être mon ennemi.
Si les Philiſtins autrefois n’euſſent laiſſé leurs vies ſous le bras de Samſon, nous ne ſçaurions pas aujourd’huy que la Terre eut porté des Philiſtins:	Si les Philistins autrefois n’eussent laissé leurs vies sous le bras de Samson, nous ne saurions pas aujourd’hui que la Terre eut porté des Philistins:
Ils doivent leur vie à leur mort, & s’ils euſſent vécu dix ans plus tard, ils fuſſent morts trente Siecles plûtoſt;	Ils doivent leur vie à leur mort, et s’ils eussent vécu dix ans plus tard, ils fussent morts trente Siècles plus tôt;
Ainſi vous moiſſonnez malgré moy cette gloire de voſtre lâcheté, de m’avoir contraint de vous en punir.	Ainsi vous moissonnez malgré moi cette gloire de votre lâcheté, de m’avoir contraint de vous en punir.
On me dira, je le ſçay bien, que pour avoir détruit un Pigmée, je n’attacheray pas à mon ſort la matière d’une illuſtre Epitaphe.	On me dira, je le sais bien, que pour avoir détruit un Pygmée, je n’attacherai pas à mon sort la matière d’une illustre Épitaphe.
Mais à regarder ſans intereſt le revers du paradoxe, ce Marius qui fit en trois Combats un Cimetiere à trois Nations, ne fut pas cenſé Poltron, lors qu’il frappoit les Grenoüilles du Marais, où il s’eſtoit jetté:	Mais à regarder sans intérêt le revers du paradoxe, ce Marius qui fit en trois Combats un Cimetière à trois Nations, ne fut pas censé Poltron, lorsqu’il frappait les Grenouilles du Marais, où il s’était jeté:
Et Socrate ne ceſſa pas d’eſtre le premier homme de l’Univers, quand il eut écraſé les poux qui le mordoient dans ſon cachot:	Et Socrate ne cessa pas d’être le premier homme de l’Univers, quand il eut écrasé les poux qui le mordaient dans son cachot:
Non, non petit Nain, ne penſez pas eſtre quelqu’autre choſe;	Non, non petit Nain, ne pensez pas être quelqu’autre chose;
eſſayez de vous humilier en voſtre neant, & croyez, comme une article de Foy, que ſi vous eſtes encore auſſi petit qu’au jour de voſtre naiſſance, le Ciel l’a permis ainſi, pour empêcher un petit mal de devenir grand:	essayez de vous humilier en votre néant, et croyez, comme une article de Foi, que si vous êtes encore aussi petit qu’au jour de votre naissance, le Ciel l’a permis ainsi, pour empêcher un petit mal de devenir grand:
Enfin vous n’eſtes pas homme;	Enfin vous n’êtes pas homme;
& que Diable eſtes-vous donc?	et que Diable êtes-vous donc?
Vous eſtes peut-eſtre une Momie que quelque Farfadet aura volée à l’Eſcole de Medecine pour en effrayer le monde:	Vous êtes peut-être une Momie que quelque Farfadet aura volée à l’École de Médecine pour en effrayer le monde:
Encore cela n’eſt-il point trop éloigné du vray-ſemblable, puis que ſi les yeux ſont les miroirs de l’ame, voſtre ame eſt quelque choſe de bien laid, cependant vous vous vantez de mon amitié.	Encore cela n’est-il point trop éloigné du vraisemblable, puis que si les yeux sont les miroirs de l’âme, votre âme est quelque chose de bien laid, cependant vous vous vantez de mon amitié.
O Ciel!	Ô Ciel!
puniſſeur des hereſies, châtiez celle-cy du Tonnerre.	punisseur des hérésies, châtiez celle-ci du Tonnerre.
Je vous ay donc aimé?	Je vous ai donc aimé?
Je vous ay donc porté mon cœur en offrande, donc vous m’eſtimiez ſot, au point d’avoir par charité donné mon ame au Diable;	Je vous ai donc porté mon cœur en offrande, donc vous m’estimiez sot, au point d’avoir par charité donné mon âme au Diable;
mais ce n’eſt pas de moy ſeul que vous avez médit, les plus chatoüillans Eloges qui partent de vous ſont des Satyres, & Dieu ne vous eut point échappé ſi vous l’euſſiez connu.	mais ce n’est pas de moi seul que vous avez médit, les plus chatouillants Éloges qui partent de vous sont des Satyres, et Dieu ne vous eut point échappé si vous l’eussiez connu.
Tout ce qui reſpire, intereſſé à la perte des Monſtres, auroit déja tenté mes bonnes grâces par voſtre mort, mais il la neglige comme un coup ſeur, ſçachant que vous aviez en moy ſeul,	Tout ce qui respire, intéressé à la perte des Monstres, aurait déjà tenté mes bonnes grâces par votre mort, mais il la néglige comme un coup sûr, sachant que vous aviez en moi seul,
HÉ!	HÉ!
par la mort, Monſieur le Coquin, je trouve que vous eſtes bien impudent de demeurer en vie aprés m’avoir offenſé:	par la mort, Monsieur le Coquin, je trouve que vous êtes bien impudent de demeurer en vie après m’avoir offensé:
Vous qui ne tenez lieu de rien au monde, ou qui n’eſtes plus qu’un clou aux feſſes de la Nature;	Vous qui ne tenez lieu de rien au monde, ou qui n’êtes plus qu’un clou aux fesses de la Nature;
Vous qui tomberez ſi bas, ſi je ceſſe de vous ſoûtenir, qu’une Puce en lêchant la terre, ne vous diſtinguera pas du pavé;	Vous qui tomberez si bas, si je cesse de vous soutenir, qu’une Puce en léchant la terre, ne vous distinguera pas du pavé;
Vous enfin ſi ſale & ſi puant, qu’on doute (en vous voyant) ſi voſtre Mère n’a point accouché de vous par le derriere;	Vous enfin si sale et si puant, qu’on doute (en vous voyant) si votre Mère n’a point accouché de vous par le derrière;
encore ſi vous m’euſſiez envoyé demander le temps d’un Peccavi:	encore si vous m’eussiez envoyé demander le temps d’un Peccavi:
Mais ſans vous enquêter ſi je trouve bon que vous viviez encore demain, ou que vous mouriez dés aujourd’huy, vous avez l’impudence de boire & de manger, comme ſi vous n’eſtiez pas mort.	Mais sans vous enquêter si je trouve bon que vous viviez encore demain, ou que vous mouriez dès aujourd’hui, vous avez l’impudence de boire et de manger, comme si vous n’étiez pas mort.
Ah!	Ah!
je vous proteſte de renverſer ſur vous un ſi long aneantiſſement, qu’il ne ſera pas vray de dire que vous ayez jamais vécu;	je vous proteste de renverser sur vous un si long anéantissement, qu’il ne sera pas vrai de dire que vous ayez jamais vécu;
Vous eſperez ſans doute m’attendrir par la dedicace de quelque ennuyeux Burleſque;	Vous espérez sans doute m’attendrir par la dédicace de quelque ennuyeux Burlesque;
Point, point, je ſuis inexorable, je veux que vous mouriez tout preſentement;	Point, point, je suis inexorable, je veux que vous mouriez tout présentement;
puis ſelon que ma belle humeur me rendra miſericordieux, je vous reſſuſciteray pour lire ma Lettre, auſſi bien quand pour regagner mes bonnes graces, vous me dedierez une Farce;	puis selon que ma belle humeur me rendra miséricordieux, je vous ressusciterai pour lire ma Lettre, aussi bien quand pour regagner mes bonnes grâces, vous me dédieriez une Farce;
je ſçay que tout ce qui eſt ſot ne fait pas rire, & qu’encore que pour faire quelque choſe de bien ridicule, vous n’ayez qu’à parler ſerieuſement, voſtre Poeſie eſt trop des Halles, & je penſe que c’eſt la raiſon pourquoy voſtre Jugement de Pâris n’a point de debit:	je sais que tout ce qui est sot ne fait pas rire, et qu’encore que pour faire quelque chose de bien ridicule, vous n’ayez qu’à parler sérieusement, votre Poésie est trop des Halles, et je pense que c’est la raison pourquoi votre Jugement de Pâris n’a point de débit:
Donc ſi vous m’en croyez, ſauvez-vous au Barreau des ruades de Pegaſe;	Donc si vous m’en croyez, sauvez-vous au Barreau des ruades de Pégase;
vous y ſerez ſans doute un Juge incorruptible, puis que voſtre Jugement ne ſe peut acheter.	vous y serez sans doute un Juge incorruptible, puisque votre Jugement ne se peut acheter.
Au reſte ce n’eſt point de voſtre Libraire ſeul, que j’ay appris que vous rimaſſiez:	Au reste ce n’est point de votre Libraire seul, que j’ai appris que vous rimassiez:
Je m’en doutois déja bien, parce que c’eût eſté un grand miracle ſi les Vers ne s’eſtoient pas mis dans un homme ſi corrompu:	Je m’en doutais déjà bien, parce que c’eût été un grand miracle si les Vers ne s’étaient pas mis dans un homme si corrompu:
Voſtre haleine ſeule ſuffit à faire croire que vous eſtes d’intelligence avec la mort, pour ne reſpirer que la peſte;	Votre haleine seule suffit à faire croire que vous êtes d’intelligence avec la mort, pour ne respirer que la peste;
& les muſcadins ne ſçauroient empêcher que vous ne ſoyez par tout le monde en fort mauvaiſe odeur:	et les muscadins ne sauraient empêcher que vous ne soyez par tout le monde en fort mauvaise odeur:
Je ne m’irrite point contre cette putrefaction, c’eſt un crime de vos Peres ladres:	Je ne m’irrite point contre cette putréfaction, c’est un crime de vos Pères ladres:
Voſtre chair meſme n’eſt autre choſe que de la terre crevaſſée par le Soleil, & tellement fumée, que ſi tout ce qu’on y a ſemé avoit pris racine, vous auriez maintenant ſur les épaules un grand bois de haute fuſtaye;	Votre chair même n’est autre chose que de la terre crevassée par le Soleil, et tellement fumée, que si tout ce qu’on y a semé avait pris racine, vous auriez maintenant sur les épaules un grand bois de haute futaie;
aprés cela, je ne m’étonne plus de ce que vous prouvez qu’on ne vous a point encore connu;	après cela, je ne m’étonne plus de ce que vous prouvez qu’on ne vous a point encore connu;
Il s’en faut en effet plus de quatre pieds de crote, qu’on ne vous puiſſe voir:	Il s’en faut en effet plus de quatre pieds de crotte, qu’on ne vous puisse voir:
Vous eſtes enſevely ſous le fumier avec tant de grace, que s’il ne vous manquoit un pot caſſé pour vous gratter, vous ſeriez un Job accomply.	Vous êtes enseveli sous le fumier avec tant de grâce, que s’il ne vous manquait un pot cassé pour vous gratter, vous sériez un Job accompli.
Ma foy vous donnez un beau démenty à ces Philoſophes qui ſe mocquent de la Création.	Ma foi vous donnez un beau démenti à ces Philosophes qui se moquent de la Création.
S’il s’en trouve encore, je ſouhaite qu’ils vous rencontrent;	S’il s’en trouve encore, je souhaite qu’ils vous rencontrent;
car je ſuis aſſuré qu’après voſtre veuë, ils croiroit aiſément que l’homme peut avoir eſté fait de bouë.	car je suis assuré qu’après votre vue, ils croirait aisément que l’homme peut avoir été fait de boue.
Ils vous prêcheront, & ſe ſerviront de vous-meſme, pour vous retirer de ce malheureux Atheïſme où vous croupiſſez.	Ils vous prêcheront, et se serviront de vous-même, pour vous retirer de ce malheureux Athéisme où vous croupissez.
Vous ſçavez que je ne parle point par cœur, & que je ne ſuis pas le ſeul qui vous a entendu prier Dieu, qu’il vous fit la grace de ne point croire en luy.	Vous savez que je ne parle point par cœur, et que je ne suis pas le seul qui vous a entendu prier Dieu, qu’il vous fit la grâce de ne point croire en lui.
Comment, petit Impie, Dieu n’oſeroit avoir laiſſé fermer une porte quand vous fuyez le bâton, qu’il ne ſoit par vous aneanty;	Comment, petit Impie, Dieu n’oserait avoir laissé fermer une porte quand vous fuyez le bâton, qu’il ne soit par vous anéanti;
& vous ne commencez à le recroire, que pour avoir contre qui jurer, quand vos Dezeſcamotez répondent mal à voſtre avarice.	et vous ne commencez à le recroire, que pour avoir contre qui jurer, quand vos Désescamotés répondent mal à votre avarice.
J’avouë que voſtre ſort n’eſt pas de ceux qui puiſſent patiemment porter la perte, car vous eſtes gueux comme un Diogene, & à peine le Chaos entier ſuffiroit-il pour vous raſſaſier, c’eſt ce qui vous a obligé d’affronter tant de monde:	J’avoue que votre sort n’est pas de ceux qui puissent patiemment porter la perte, car vous êtes gueux comme un Diogène, et à peine le Chaos entier suffirait-il pour vous rassasier, c’est ce qui vous a obligé d’affronter tant de monde:
Il n’y a plus moyen que vous trouviez pour marcher en cette Ville une ruë non creanciere, à moins que le Roy faſſe bâtir un Paris en l’air.	Il n’y a plus moyen que vous trouviez pour marcher en cette Ville une rue non créancière, à moins que le Roi fasse bâtir un Paris en l’air.
L’autre jour au Conſeil de Guerre, on donna avis à Monſieur de Turenne de vous mettre dans un Mortier, pour vous faire ſauter comme une bombe dans Sainte Menehould, pour contraindre en moins de trois jours par la faim, les Habitans de ſe rendre.	L’autre jour au Conseil de Guerre, on donna avis à Monsieur de Turenne de vous mettre dans un Mortier, pour vous faire sauter comme une bombe dans Sainte Menehould, pour contraindre en moins de trois jours par la faim, les Habitants de se rendre.
Je penſe, en verité, que ce ſtratagéme là reüſſiroit, puis que voſtre nez qui n’a pas l’uſage de raiſon;	Je pense, en vérité, que ce stratagème-là réussirait, puisque votre nez qui n’a pas l’usage de raison;
ce pauvre nez, le repoſoir & le paradis des chiquenodes, ſemble ne s’eſtre retrouſſé, que pour s’éloigner de voſtre bouche affamée:	ce pauvre nez, le reposoir et le paradis des chiquenaudes, semble ne s’être retroussé, que pour s’éloigner de votre bouche affamée:
Vos dents?	Vos dents?
Mais bons Dieux!	Mais bons Dieux!
où m’embaraſſay-je, elles ſont plus à craindre que vos bras, leur chancre & leur longueur m’épouvante;	où m’embarrassai-je, elles sont plus à craindre que vos bras, leur chancre et leur longueur m’épouvante;
auſſi bien quelqu’un me reprocheroit que c’eſt trop berner un homme, qui dit m’eſtimer beaucoup:	aussi bien quelqu’un me reprocherait que c’est trop berner un homme, qui dit m’estimer beaucoup:
Donc, ô plaiſant petit Singe, ô Marionnette incarnée, cela ſeroit-il poſſible;	Donc, ô plaisant petit Singe, ô Marionnette incarnée, cela serait-il possible;
mais je voy que vous vous cabrez de ce glorieux ſobriquet!	mais je vois que vous vous cabrez de ce glorieux sobriquet!
Helas demandez ce que vous eſtes à tout le monde, & vous verrez ſi tout le monde ne dit pas que vous n’avez rien d’homme que la reſſemblance d’un Magot:	Hélas demandez ce que vous êtes à tout le monde, et vous verrez si tout le monde ne dit pas que vous n’avez rien d’homme que la ressemblance d’un Magot:
Ce n’eſt pas pourtant, quoy que je vous compare à ce petit homme à quatre pattes, ny que je penſe que vous raiſonniez auſſi bien qu’un Singe:	Ce n’est pas pourtant, quoi que je vous compare à ce petit homme à quatre pattes, ni que je pense que vous raisonniez aussi bien qu’un Singe:
Non, non, méler gambade;	Non, non, mêler gambade;
car quand je vous contemple ſi décharné, je m’imagine que vos nerfs ſont aſſez ſecs & aſſez preparez pour exciter, en vous remuant, ce bruit que vous appellez parole, c’eſt infailliblement ce qui eſt cauſe que vous jaſez & fretillez ſans intervalle:	car quand je vous contemple si décharné, je m’imagine que vos nerfs sont assez secs et assez préparés pour exciter, en vous remuant, ce bruit que vous appelez parole, c’est infailliblement ce qui est cause que vous jasez et frétillez sans intervalle:
Mais puis que parler y a;	Mais puisque parler y a;
Apprenez-moy de grace, ſi vous parlez à force de remuer, ou ſi vous remuez à force de parler;	Apprenez-moi de grâce, si vous parlez à force de remuer, ou si vous remuez à force de parler;
ce qui fait ſoupçonner que tout le tintamarre que vous faites ne vient pas de voſtre langue, c’eſt qu’une langue ſeule ne ſçauroit dire le quart de ce que vous dites, & que la plûpart de vos diſcours ſont tellement éloignez de la raiſon, qu’on void bien que vous parlez par un endroit qui n’eſt pas fort prés du cerveau;	ce qui fait soupçonner que tout le tintamarre que vous faites ne vient pas de votre langue, c’est qu’une langue seule ne saurait dire le quart de ce que vous dites, et que la plupart de vos discours sont tellement éloignez de la raison, qu’on voit bien que vous parlez par un endroit qui n’est pas fort près du cerveau;
Enfin, mon petit gentil godenot, il eſt vray que vous eſtes toute langue, que s’il n’y avoit point d’impiété d’adapter les choſes ſaintes aux prophanes, je croirois que S.	Enfin, mon petit gentil godenot, il est vrai que vous êtes toute langue, que s’il n’y avait point d’impiété d’adapter les choses saintes aux profanes, je croirais que S.
Jean prophetiſoit de vous, quand il écrivit que la parole s’étoit fait chair;	Jean prophétisait de vous, quand il écrivit que la parole s’était fait chair;
En effet, s’il me falloit écrire autant que vous parlez, j’aurois beſoin de devenir plume;	En effet, s’il me fallait écrire autant que vous parlez, j’aurais besoin de devenir plume;
mais puis que cela ne ſe peut, vous me permettrez de vous dire adieu;	mais puis que cela ne se peut, vous me permettrez de vous dire adieu;
Adieu donc, mon Camarade, ſans compliment, auſſi bien ſeriez vous trop mal obey, ſi j’eſtois	Adieu donc, mon Camarade, sans compliment, aussi bien sériez-vous trop mal obéi, si j’étais
Tant de careſſes de la Fortune que j’ay perduës en perdant voſtre amitié, me perſuadent enfin de me repentir d’avoir ſi fort contribué à ſa perte;	Tant de caresses de la Fortune que j’ai perdues en perdant votre amitié, me persuadent enfin de me repentir d’avoir si fort contribué à sa perte;
& ſi je ſuis en diſgrace, je confeſſe que je la merite, pour ne m’eſtre pas conſervé plus ſoigneuſement, & l’eſtime & la veuë d’une perſonne qui fait paſſer les moindres, dont il eſt viſité, ſous le titre de Comtes & de Marquis:	et si je suis en disgrâce, je confesse que je la mérite, pour ne m’être pas conservé plus soigneusement, et l’estime et la vue d’une personne qui fait passer les moindres, dont il est visité, sous le titre de Comtes et de Marquis:
Certes, Monſieur, vous vous faites le Pere de force grands Seigneurs qui ne croyoient pas l’eſtre, & je commence à m’appercevoir que j’ay tort d’avoir ainſi negligé ma fortune, car j’aurois poſſible gagné à ce jeu-là une Principauté.	Certes, Monsieur, vous vous faites le Père de force grands Seigneurs qui ne croyaient pas l’être, et je commence à m’apercevoir que j’ai tort d’avoir ainsi négligé ma fortune, car j’aurais possible gagné à ce jeu-là une Principauté.
Quelques-uns blâment cette humeur prodigue;	Quelques-uns blâment cette humeur prodigue;
mais ils ne ſçavent pas que ce qui vous engage à ces magnificences, eſt le paſſionné deſir qui vous emporte pour la multiplication de la Nobleſſe & que c’eſt pour cela, que ne pouvant mettre au jour de Gentils-hommes ſelon la chair, vous en voulez du moins produire ſpirituellement.	mais ils ne savent pas que ce qui vous engage à ces magnificences, est le passionné désir qui vous emporte pour la multiplication de la Noblesse et que c’est pour cela, que ne pouvant mettre au jour de Gentilshommes selon la chair, vous en voulez du moins produire spirituellement.
Les Autheurs Romaneſques que vous connoiſſez donnent bien des Empires, à tel qui ſouvent n’avoit pas poſſedé deux arpens de terre;	Les Auteurs Romanesques que vous connaissez donnent bien des Empires, à tel qui souvent n’avait pas possédé deux arpents de terre;
mais voſtre talent eſt ſi égal au leur, qu’il vous met en droit d’uſer des meſmes privileges:	mais votre talent est si égal au leur, qu’il vous met en droit d’user des mêmes privilèges:
On ſçait aſſez que tous ces grands Autheurs ne parlent pas mieux que vous, puis que vous parlez tout comme eux, & qu’à chaque moment vous vomiſſez & Caſſandre & Polexandre ſi crus, qu’on penſe voir dans voſtre bouche le papier deſſous les paroles.	On sait assez que tous ces grands Auteurs ne parlent pas mieux que vous, puisque vous parlez tout comme eux, et qu’à chaque moment vous vomissez et Cassandre et Polexandre si crus, qu’on pense voir dans votre bouche le papier dessous les paroles.
Les Critiques murmurent que le grand bruit dont vous éclatez n’eſt pas la marque d’un grand eſprit, que les vaiſſeaux vuides en excitent plus que ceux qui ſont pleins, & que peut-eſtre à cauſe du concave de voſtre cerveau remply de rien, voſtre bouche à l’exemple des cavernes, fait un écho mal diſtinct de tous les ſons qui la frappent;	Les Critiques murmurent que le grand bruit dont vous éclatez n’est pas la marque d’un grand esprit, que les vaisseaux vides en excitent plus que ceux qui sont pleins, et que peut-être à cause du concave de votre cerveau rempli de rien, votre bouche à l’exemple des cavernes, fait un écho mal distinct de tous les sons qui la frappent;
mais quoy il ſe faut conſoler, celuy là eſt encore à naiſtre, qui a ſceu le moyen d’empêcher l’envie de mordre la vertu;	mais quoi il se faut consoler, celui là est encore à naître, qui a su le moyen d’empêcher l’envie de mordre la vertu;
car je veux meſme, comme ils le diſent, que vous ne fuſſiez pas un grand Genie, vous eſtes toutefois un grand homme:	car je veux même, comme ils le disent, que vous ne fussiez pas un grand Génie, vous êtes toutefois un grand homme:
Comment vous eſtes capable par voſtre ombre ſeule, de noircir un Jeu de Paulme tout entier;	Comment vous êtes capable par votre ombre seule, de noircir un Jeu de Paume tout entier;
perſonne n’entend parler de voſtre taille, qu’il ne croye qu’on faſſe l’hiſtoire d’un Cedre ou d’un Sapin;	personne n’entend parler de votre taille, qu’il ne croie qu’on fasse l’histoire d’un Cèdre ou d’un Sapin;
& d’autres qui vous connoiſſent un peu plus particulierement, prouvant que vous n’avez rien d’homme que le ſon de la voix, aſſurent qu’ils ont appris par tradition que vous eſtes un Chêne tranſplanté de la Foreſt de Dodone:	et d’autres qui vous connaissent un peu plus particulièrement, prouvant que vous n’avez rien d’homme que le son de la voix, assurent qu’ils ont appris par tradition que vous êtes un Chêne transplanté de la Forêt de Dodone:
Ce n’eſt pas de mon avis qu’ils portent ce jugement;	Ce n’est pas de mon avis qu’ils portent ce jugement;
au contraire, je leur ay dit cent fois qu’il n’y avoit point d’apparence que vous fuſſiez un Chêne, puis que les plus ſenſez tombent d’accord que vous n’eſtes qu’une bûche.	au contraire, je leur ai dit cent fois qu’il n’y avait point d’apparence que vous fussiez un Chêne, puis que les plus sensés tombent d’accord que vous n’êtes qu’une bûche.
Pour moy qui penſe vous connoiſtre de plus longue main, je leur ſoûtiens qu’il eſt tout à fait éloigné du vray-ſemblable d’imaginer que vous ſoyez un arbre;	Pour moi qui pense vous connaître de plus longue main, je leur soutiens qu’il est tout à fait éloigné du vraisemblable d’imaginer que vous soyez un arbre;
car encore que cette partie ſuperieure de voſtre tout (qu’à cauſe du lieu de ſa ſcituation on appelle voſtre teſte) ne faſſe aucune fonction raiſonnable, ny meſme ſenſitive, je ne me perſuade pas pourtant qu’elle ſoit de bois, mais je m’imagine qu’elle a eſté privée de l’uſage des ſens, à cauſe qu’une ame humaine n’eſtant pas aſſez grande pour animer de bout en bout un ſi vaſte Coloſſe, la Nature a eſté contrainte de laiſſer en friche la Région d’enhaut:	car encore que cette partie supérieure de votre tout (qu’à cause du lieu de sa situation on appelle votre teste) ne fasse aucune fonction raisonnable, ni même sensitive, je ne me persuade pas pourtant qu’elle soit de bois, mais je m’imagine qu’elle a été privée de l’usage des sens, à cause qu’une âme humaine n’étant pas assez grande pour animer de bout en bout un si vaste Colosse, la Nature a été contrainte de laisser en friche la Région d’enhaut:
Et en effet, y a-t’il quelqu’un qui ne ſçache que quand elle logea ce qu’en d’autres on nomme l’Eſprit dans voſtre corps demeſuré, elle eut beau le tirer & l’allonger, elle ne pût jamais le faire arriver juſqu’à voſtre cervelle;	Et en effet, y a-t’il quelqu’un qui ne sache que quand elle logea ce qu’en d’autres on nomme l’Esprit dans votre corps démesuré, elle eut beau le tirer et l’allonger, elle ne pût jamais le faire arriver jusqu’à votre cervelle;
Vos membres meſme ſont ſi prodigieux, qu’à les conſiderer, on croit que vous avez deux Geans pendus au bas du ventre, à la place de vos cuiſſes;	Vos membres même sont si prodigieux, qu’à les considérer, on croit que vous avez deux Géants pendus au bas du ventre, à la place de vos cuisses;
& vous avez la bouche ſi large, que je crains quelquefois que voſtre teſte ne tombe dedans.	et vous avez la bouche si large, que je crains quelquefois que votre tête ne tombe dedans.
En verité s’il eſtoit de la Foy de croire que vous fuſſiez homme, j’aurois un grand motif à ſoupçonner, qu’il a donc fallu mettre dans voſtre corps pour luy donner la vie, l’ame univerſelle du monde.	En vérité s’il était de la Foi de croire que vous fussiez homme, j’aurais un grand motif à soupçonner, qu’il a donc fallu mettre dans votre corps pour lui donner la vie, l’âme universelle du monde.
Il faut en effet que vous ſoyez quelque choſe de bien ample, puis que toute la Communauté des Frippiers eſt occupée à vous veſtir, ou bien que ces gens-là qui cherchent le debit, ne pouvant amener toutes les ruës de Paris à la Halle, ayent chargé ſur vous leurs guenilles, afin de promener la Halle par tout Paris.	Il faut en effet que vous soyez quelque chose de bien ample, puis que toute la Communauté des Fripiers est occupée à vous vêtir, ou bien que ces gens-là qui cherchent le débit, ne pouvant amener toutes les rues de Paris à la Halle, aient chargé sur vous leurs guenilles, afin de promener la Halle par tout Paris.
Au reſte ce reproche ne vous doit point offencer, au contraire il vous eſt avantageux, il fait connoiſtre que vous eſtes une perſonne publique, puis que le public vous habille à ſes dépens, & puis aſſez d’autres choſes vous rendent conſiderable;	Au reste ce reproche ne vous doit point offenser, au contraire il vous est avantageux, il fait connaître que vous êtes une personne publique, puis que le public vous habille à ses dépens, et puis assez d’autres choses vous rendent considérable;
Je dis meſme ſans mettre en ligne de compte, que comme de l’épaiſſeur de la Vaſe du Nil, en ſuite de ſon débordement, les Egyptiens jugent de leur abondance, on peut ſupputer par l’épaiſſeur de noſtre embonpoint, le nombre des embraſſemens illegitimes qui ſe ſont faits en voſtre Fauxbourg:	Je dis même sans mettre en ligne de compte, que comme de l’épaisseur de la Vase du Nil, ensuite de son débordement, les Égyptiens jugent de leur abondance, on peut supputer par l’épaisseur de notre embonpoint, le nombre des embrassements illégitimes qui se sont faits en votre Faubourg:
Et enfin, à propos d’arbre à qui je vous comparois tantoſt, on dit que vous en eſtes un ſi fertile, qu’il n’y a point de jour que vous ne produiſiez;	Et enfin, à propos d’arbre à qui je vous comparais tantôt, on dit que vous en êtes un si fertile, qu’il n’y a point de jour que vous ne produisiez;
mais je ſçay bien que ces ſortes d’injures paſſent fort loin de vous, & que vos calomniateurs n’euſſent oſé vous ſoûtenir en face tant d’injures, du temps que la troiſiéme peinture des Cartes eſtoit vôtre portrait, vous traîniez alors une brette, qui vous auroit vangé d’eux, ils ne vous euſſent pas accuſé, comme aujourd’huy, d’effronterie en un eſtat de condition, où vous changiez ſi ſouvent de couleur.	mais je sais bien que ces sortes d’injures passent fort loin de vous, et que vos calomniateurs n’eussent osé vous soutenir en face tant d’injures, du temps que la troisième peinture des Cartes était vôtre portrait, vous traîniez alors une brette, qui vous aurait vengé d’eux, ils ne vous eussent pas accusé, comme aujourd’hui, d’effronterie en un état de condition, où vous changiez si souvent de couleur.
Voila, Monſieur, les peaux d’Aſnes, à peu prés dont ils perſecutent voſtre déplorable renommée:	Voilà, Monsieur, les peaux d’Ânes, à peu près dont ils persécutent votre déplorable renommée:
J’en ferois l’Apologie un peu plus longue, mais la fin du papier m’oblige de finir;	J’en ferais l’Apologie un peu plus longue, mais la fin du papier m’oblige de finir;
Permettez donc que je prenne congé de vous ſans les ceremonies accoûtumées, parce que ces Meſſieurs qui vous mépriſent fort, & dont je fais beaucoup d’eſtime, penſeroient que je fuſſe le valet du valet des Tambourineux, ſi j’avois mis au bas de cette Lettre, que je ſuis,	Permettez donc que je prenne congé de vous sans les cérémonies accoutumées, parce que ces Messieurs qui vous méprisent fort, et dont je fais beaucoup d’estime, penseraient que je fusse le valet du valet des Tambourineux, si j’avais mis au bas de cette Lettre, que je suis,
La Faculté bien mieux que moy, vous mettra quelque jour à couvert de la vie de ce perſonnage;	La Faculté bien mieux que moi, vous mettra quelque jour à couvert de la vie de ce personnage;
Laiſſez-la donc faire, elle a des bras dont perſonne ne pare les coups:	Laissez-la donc faire, elle a des bras dont personne ne pare les coups:
Vous me répondrez ſans doute qu’il a paſſé déja plus de dix fois le temps de mourir, que la Parque ne s’eſt pas ſouvenuë de luy, & que maintenant qu’elle a tant marché depuis, elle ſera honteuſe & pareſſeuſe de revenir le prendre ſi loin.	Vous me répondrez sans doute qu’il a passé déjà plus de dix fois le temps de mourir, que la Parque ne s’est pas souvenue de lui, et que maintenant qu’elle a tant marché depuis, elle sera honteuse et paresseuse de revenir le prendre si loin.
Non, non, Monſieur, eſperez toûjours juſqu’à ce qu’il ait paſſé neuf cens ans, l’âge de Mathuſalem;	Non, non, Monsieur, espérez toujours jusqu’à ce qu’il ait passé neuf cents ans, l’âge de Mathusalem;
mais enfin parlez-luy ſans ceſſe en grondant, criez, peſtez, tonnez dans ſa maiſon, croiſſez par tout à ſes yeux, & faites en ſorte qu’il ſe dépite contre le jour, n’eſt-il pas temps auſſi bien qu’il faſſe place à d’autres;	mais enfin parlez-lui sans cesse en grondant, criez, pestez, tonnez dans sa maison, croissez partout à ses yeux, et faites en sorte qu’il se dépite contre le jour, n’est-il pas temps aussi bien qu’il fasse place à d’autres;
Comment Artephius & la Sybille Cumée au prix de luy n’ont fait que ſemblant de vivre.	Comment Artéphius et la Sybille Cumée au prix de lui n’ont fait que semblant de vivre.
Il nâquit auparavant que la Mort fut faite, & la Mort à cauſe de cela n’oſeroit tirer ſur luy, parce qu’elle craint de tuer ſon Pere;	Il naquit auparavant que la Mort fut faite, et la Mort à cause de cela n’oserait tirer sur lui, parce qu’elle craint de tuer son Père;
& puis même quand cette conſideration ne l’empêcheroit pas, elle le void ſi foible de vieilleſſe, qu’il n’auroit pas la force de marcher juſqu’en l’autre monde;	et puis même quand cette considération ne l’empêcherait pas, elle le voit si faible de vieillesse, qu’il n’aurait pas la force de marcher jusqu’en l’autre monde;
Et je penſe qu’une autre raiſon encore le fait demeurer debout, c’eſt que la Mort qui ne luy voit faire aucune action de vie, le prenant plutoſt pour une ſtatuë que pour un vivant, penſe qu’il eſt du devoir, ou du temps, ou de la Fortune, de le faire tomber.	Et je pense qu’une autre raison encore le fait demeurer debout, c’est que la Mort qui ne lui voit faire aucune action de vie, le prenant plutôt pour une statue que pour un vivant, pense qu’il est du devoir, ou du temps, ou de la Fortune, de le faire tomber.
Aprés cela, Monſieur, je m’étonne fort que vous diſiez qu’eſtant preſt de fermer le cercle de ſes jours, & arrivant au premier poinct, dont il eſt party, il redevienne enfant:	Après cela, Monsieur, je m’étonne fort que vous disiez qu’étant prêt de fermer le cercle de ses jours, et arrivant au premier point, dont il est parti, il redevienne enfant:
Ah!	Ah!
vous vous mocquez, & pour moy je ne ſçaurois pas meſme m’imaginer qu’il l’ait jamais eſté, quoy luy petit garçon?	vous vous moquez, et pour moi je ne saurais pas même m’imaginer qu’il l’ait jamais été, quoi lui petit garçon?
non, non, il ne le fut jamais, ou Moïſe s’eſt trompé au calcul qu’il a fait de la Creation du Monde:	non, non, il ne le fut jamais, ou Moïse s’est trompé au calcul qu’il a fait de la Création du Monde:
S’il eſt permis toutefois de nommer ainſi tout ce qui peut à peine faire les fonctions d’un enfant, je vous donne les mains;	S’il est permis toutefois de nommer ainsi tout ce qui peut à peine faire les fonctions d’un enfant, je vous donne les mains;
car il faut en effet qu’il ſoit plus ignorant qu’une Plante meſme, de ne ſçavoir pas mourir, choſe que tout ce qui a vie ſçait faire ſans Precepteur.	car il faut en effet qu’il soit plus ignorant qu’une Plante même, de ne savoir pas mourir, chose que tout ce qui a vie sait faire sans Précepteur.
O!	Ô!
que n’a-t’il eſté connu d’Ariſtote, ce Philoſophe n’euſt pas définy l’Homme Animal raiſonnable.	que n’a-t’il été connu d’Aristote, ce Philosophe n’eût pas défini l’Homme Animal raisonnable.
Ceux de la Secte d’Epicure, qui démontrent que les beſtes uſent de la raiſon, en doivent excepter celle-là encore, s’il eſtoit bien vray qu’il fût beſte;	Ceux de la Secte d’Épicure, qui démontrent que les bêtes usent de la raison, en doivent excepter celle-là encore, s’il était bien vrai qu’il fût bête;
Mais, helas!	Mais, hélas!
dans l’ordre des eſtres animez, il eſt un peu plus qu’un Artichaut, & un peu moins qu’une Huiſtre à l’Eſcaille;	dans l’ordre des êtres animés, il est un peu plus qu’un Artichaut, et un peu moins qu’une Huître à l’Écaille;
de ſorte que j’aurois crû, ſi ce n’eſtoit que vous le ſoupçonnez de ladrerie, qu’il eſt ce qu’on appelle la plante ſenſitive.	de sorte que j’aurais crû, si ce n’était que vous le soupçonnez de ladrerie, qu’il est ce qu’on appelle la plante sensitive.
Avoüez donc que vous avez tort de vous ennuyer de ſa vie;	Avouez donc que vous avez tort de vous ennuyer de sa vie;
il n’a pas encore vécu, il n’a que dormy, attendez au moins qu’il ait achevé un ſomme:	il n’a pas encore vécu, il n’a que dormi, attendez au moins qu’il ait achevé un somme:
Eſtes-vous aſſuré qu’on ne luy ait pas dit que le Sommeil & la Mort ſont freres, il fait peut-eſtre ſcrupule (ayant bonne conſcience) aprés avoir joüy de l’une, d’avoir affaire à l’autre.	Êtes-vous assuré qu’on ne lui ait pas dit que le Sommeil et la Mort sont frères, il fait peut-être scrupule (ayant bonne conscience) après avoir joui de l’une, d’avoir affaire à l’autre.
N’inferez-pas cependant, enſuite de cela, que je veüille prouver par cette enfilade, que le perſonnage dont il eſt queſtion ſoit un ſot homme, point du tout, il n’eſt rien moins qu’homme;	N’inférez-pas cependant, ensuite de cela, que je veuille prouver par cette enfilade, que le personnage dont il est question soit un sot homme, point du tout, il n’est rien moins qu’homme;
car outre qu’il nous reſſemble par le Bapteſme, c’eſt un privilege dont joüiſſent auſſi bien que luy les Cloches de ſa Paroiſſe.	car outre qu’il nous ressemble par le Baptême, c’est un privilège dont jouissent aussi bien que lui les Cloches de sa Paroisse.
Je parlerois de cette vie juſqu’à la mort pour ſoulager voſtre ennuy;	Je parlerais de cette vie jusqu’à la mort pour soulager votre ennui;
mais le ſommeil commence de cauſer à ma main de ſi grandes foibleſſes, que ma teſte par compagnie tombe ſur mon oreille.	mais le sommeil commence de causer à ma main de si grandes faiblesses, que ma tête par compagnie tombe sur mon oreille.
Ah!	Ah!
par ma foy, je ne ſçay plus ce que j’écris.	par ma foi, je ne sais plus ce que j’écris.
Adieu, bonſoir,	Adieu, bonsoir,
Puis que noſtre Amy butine nos Penſées, c’eſt une marque qu’il nous eſtime, il ne les prendroit pas s’il ne les croyoit bonnes, & nous avons grand tort de nous eſtomaquer de ce que n’ayant point d’enfans, il adopte les noſtres;	Puis que notre Ami butine nos Pensées, c’est une marque qu’il nous estime, il ne les prendrait pas s’il ne les croyait bonnes, et nous avons grand tort de nous estomaquer de ce que n’ayant point d’enfants, il adopte les nôtres;
Pour moy ce qui m’offence en mon particulier (car vous ſçavez que j’ay un eſprit vangeur de torts, & fort enclin à la juſtice diſtributive) c’eſt de voir qu’il attribuë à ſon ingrate imagination les bons ſervices que luy rend ſa memoire, & qu’il ſe diſe le pere de mille hautes conceptions, dont il n’a eſté au plus que la Sage-Femme;	Pour moi ce qui m’offense en mon particulier (car vous savez que j’ai un esprit vengeur de torts, et fort enclin à la justice distributive) c’est de voir qu’il attribue à son ingrate imagination les bons services que lui rend sa mémoire, et qu’il se dise le père de mille hautes conceptions, dont il n’a été au plus que la Sage-Femme;
Allons, Monſieur, aprés cela nous vanter d’écrire mieux que luy, lors qu’il écrit tout comme nous, & tournons en ridicule qu’à ſon âge il ait encore un Eſcrivain chez luy, puis qu’il ne nous fait point en cela d’autre mal que de rendre nos œuvres plus liſibles;	Allons, Monsieur, après cela nous vanter d’écrire mieux que lui, lorsqu’il écrit tout comme nous, et tournons en ridicule qu’à son âge il ait encore un Écrivain chez lui, puisqu’il ne nous fait point en cela d’autre mal que de rendre nos œuvres plus lisibles;
Nous devrions, au contraire, recevoir avec reſpect tant de ſages avertiſſemens moraux, dont il tâche de reprimer les emportemens de noſtre jeuneſſe;	Nous devrions, au contraire, recevoir avec respect tant de sages avertissements moraux, dont il tâche de réprimer les emportements de notre jeunesse;
Oüy, certes, nous devrions y ajoûter plus de foy, & n’en douter non plus que de l’Evangile;	Oui, certes, nous devrions y ajouter plus de foi, et n’en douter non plus que de l’Évangile;
car tout le monde ſçait que ce ne ſont pas des choſes qu’il ait inventées.	car tout le monde sait que ce ne sont pas des choses qu’il ait inventées.
À la verité d’avoir un Amy de la ſorte, c’eſt entretenir une Imprimerie à bon marché;	À la vérité d’avoir un Ami de la sorte, c’est entretenir une Imprimerie à bon marché;
Pour moy je m’imagine, en dépit de tous ſes grands Manuſcrits, que ſi quelque jour aprés ſa mort, on inventorie le Cabinet de ſes Livres, c’eſt à dire de ceux qui ſont ſortis de ſon Genie, tous ſes ouvrages enſemble, oſtant ce qui n’eſt pas de luy, compoſeront une Bibliotheque de papier blanc.	Pour moi je m’imagine, en dépit de tous ses grands Manuscrits, que si quelque jour après sa mort, on inventorie le Cabinet de ses Livres, c’est à dire de ceux qui sont sortis de son Génie, tous ses ouvrages ensemble, ôtant ce qui n’est pas de lui, composeront une Bibliothèque de papier blanc.
Il ne laiſſe pas de vouloir s’attribuer les dépoüilles des morts, & de croire inventer ce dont il ſe ſouvient;	Il ne laisse pas de vouloir s’attribuer les dépouilles des morts, et de croire inventer ce dont il se souvient;
mais de cette façon il prouve mal la noble extraction de ſes penſées, de n’en tirer l’antiquité que d’un homme qui vit encore;	mais de cette façon il prouve mal la noble extraction de ses pensées, de n’en tirer l’antiquité que d’un homme qui vit encore;
mais il veut par là conclure à la Metempſicoſe, & montrer que quand il ſe ſerviroit des imaginations de Socrate, il ne les voleroit point, ayant eſté jadis ce meſme Socrate qui les imagina;	mais il veut par là conclure à la Métempsycose, et montrer que quand il se servirait des imaginations de Socrate, il ne les volerait point, ayant été jadis ce même Socrate qui les imagina;
& puis n’a-t’il pas aſſez de memoire pour eſtre riche de ce bien-là ſeul?	et puis n’a-t’il pas assez de mémoire pour être riche de ce bien-là seul?
Comment il l’a ſi grande, qu’il ſe ſouvient de ce qu’on a dit trente Siecles auparavant qu’il fut au monde.	Comment il l’a si grande, qu’il se souvient de ce qu’on a dit trente Siècles auparavant qu’il fut au monde.
Quant à moy qui ſuis un peu moins ſouffrant que les morts, obtenez de luy qu’il me permette de datter mes penſées, afin que ma poſterité ne ſoit point douteuſe:	Quant à moi qui suis un peu moins souffrant que les morts, obtenez de lui qu’il me permette de dater mes pensées, afin que ma postérité ne soit point douteuse:
Il y eut jadis une Déeſſe Echo;	Il y eut jadis une Déesse Écho;
celuy-cy ſans doute, en doit eſtre le Dieu;	celui-ci sans doute, en doit être le Dieu;
car de meſme qu’elle il ne dit jamais que ce que les autres ont dit, & le repete ſi mot à mot, que tranſcrivant l’autre jour une de mes Lettres (il appelloit cela compoſer) il eut toutes les peines du monde à s’empêcher de mettre, Voſtre Serviteur, Beaulieu, parce qu’il y avoit au bas,	car de même qu’elle il ne dit jamais que ce que les autres ont dit, et le répète si mot à mot, que transcrivant l’autre jour une de mes Lettres (il appelait cela composer) il eut toutes les peines du monde à s’empêcher de mettre, Votre Serviteur, Beaulieu, parce qu’il y avait au bas,
Aprés avoir échauffé contre nous cét homme qui n’eſt que flegme, n’apprehendons-nous point qu’un de ces jours on nous accuſe d’avoir brûlé la riviere.	Après avoir échauffé contre nous cet homme qui n’est que flegme, n’appréhendons-nous point qu’un de ces jours on nous accuse d’avoir brûlé la rivière.
Cét eſprit aquatique murmure continuellement comme les fontaines, ſans que l’on puiſſe entendre ce qu’il dit.	Cet esprit aquatique murmure continuellement comme les fontaines, sans que l’on puisse entendre ce qu’il dit.
Ah!	Ah!
Monſieur, que cét homme me fait prévoir à la fin des Siecles une étrange avanture;	Monsieur, que cet homme me fait prévoir à la fin des Siècles une étrange aventure;
c’eſt que s’il ne meurt qu’au bout de ſa memoire, les Trompettes de la Reſurrection n’auront pas de ſilence:	c’est que s’il ne meurt qu’au bout de sa mémoire, les Trompettes de la Résurrection n’auront pas de silence:
Cette ſeule faculté dans luy ne laiſſe point de place aux autres, & il eſt un ſi grand perſecuteur du ſens commun, qu’il me fait ſoupçonner que le Jugement univerſel n’a eſté promis que pour en faire avoir aux perſonnes comme luy, qui n’en ont point eu de particulier;	Cette seule faculté dans lui ne laisse point de place aux autres, et il est un si grand persécuteur du sens commun, qu’il me fait soupçonner que le Jugement universel n’a été promis que pour en faire avoir aux personnes comme lui, qui n’en ont point eu de particulier;
Et à vous parler ingenuëment, quiconque le fera ſortir du monde aura grand tort, puis qu’il l’en fera ſortir ſans raiſon;	Et à vous parler ingénument, quiconque le fera sortir du monde aura grand tort, puisqu’il l’en fera sortir sans raison;
mais cependant il parle autant que tous les Livres, & tous les Livres ſemblent n’avoir parlé que pour luy.	mais cependant il parle autant que tous les Livres, et tous les Livres semblent n’avoir parlé que pour lui.
Il n’ouvre jamais la bouche que nous n’y trouvions un larcin, & il eſt ſi accoûtumé à mettre au jour ſon pillage, que meſme quand il ne dit mot, c’eſt pour dérober cela aux muets.	Il n’ouvre jamais la bouche que nous n’y trouvions un larcin, et il est si accoutumé à mettre au jour son pillage, que même quand il ne dit mot, c’est pour dérober cela aux muets.
Nous ſommes pourtant de faux braves, & nous partageons avec injuſtice les avantages du combat, noſtre eſprit ayant trois facultez de l’oppoſer au ſien, qui n’en a qu’une;	Nous sommes pourtant de faux braves, et nous partageons avec injustice les avantages du combat, notre esprit ayant trois facultés de l’opposer au sien, qui n’en a qu’une;
c’eſt pourquoy s’il a dans la teſte beaucoup de vuide, on luy doit pardonner, puis qu’il n’a pas eſté poſſible à la Nature de la remplir avec le tiers d’une ame raiſonnable;	c’est pourquoi s’il a dans la tête beaucoup de vide, on lui doit pardonner, puis qu’il n’a pas été possible à la Nature de la remplir avec le tiers d’une âme raisonnable;
En récompenſe il ne la laiſſe pas dormir, il la tient ſans ceſſe occupée à dépoüiller quelqu’un;	En récompense il ne la laisse pas dormir, il la tient sans cesse occupée à dépouiller quelqu’un;
Et ces grands Philoſophes, qui croyoient s’eſtre mis par la pauvreté qu’ils profeſſoient, à couvert d’impoſts & de contributions, luy doivent par jour chacun juſqu’au plus miſerable une rente de dix penſées, & ce Maltotier de conceptions, n’en laiſſe pas échapper un qu’il ne taxe aux aiſez, ſelon l’étenduë de ſon revenu;	Et ces grands Philosophes, qui croyaient s’être mis par la pauvreté qu’ils professaient, à couvert d’impôts et de contributions, lui doivent par jour chacun jusqu’au plus misérable une rente de dix pensées, et ce Maltôtier de conceptions, n’en laisse pas échapper un qu’il ne taxe aux aisés, selon l’étendue de son revenu;
Ils ont beau ſe cacher dans l’obſcurité, il les ſçait bien trouver, & les fait bien parler François:	Ils ont beau se cacher dans l’obscurité, il les sait bien trouver, et les fait bien parler Français:
Encore ont-ils ſouvent le regret de voir confiſquer leurs œuvres toutes entieres, quand ils n’ont pas le moyen de payer leur taxe, mais il continuë ces brigandages en ſeureté;	Encore ont-ils souvent le regret de voir confisquer leurs œuvres toutes entières, quand ils n’ont pas le moyen de payer leur taxe, mais il continue ces brigandages en sûreté;
car il ſçait que la Grece & l’Italie relevant d’autres Princes que du noſtre, il ne ſera pas recherché en France des larcins qu’il aura fait chez eux.	car il sait que la Grèce et l’Italie relevant d’autres Princes que du nôtre, il ne sera pas recherché en France des larcins qu’il aura fait chez eux.
Je croy meſme qu’il penſe, à cauſe que les Payens ſont nos ennemis, ne pouvoir rien butiner ſur eux qui ne ſoit pris de bonne guerre.	Je crois même qu’il pense, à cause que les Païens sont nos ennemis, ne pouvoir rien butiner sur eux qui ne soit pris de bonne guerre.
Voila, Monſieur, ce qui eſt cauſe que nous voyons chaque page de ſes Epitres eſtre le Cimetiere des vivans & des morts:	Voilà, Monsieur, ce qui est cause que nous voyons chaque page de ses Épîtres être le Cimetière des vivants et des morts:
Ne doutez point aprés cela que ſi au jour de la conſommation des Siecles, chacun reprend ce qui luy appartient, le partage de ſes écrits ne ſoit la derniere querelle des hommes.	Ne doutez point après cela que si au jour de la consommation des Siècles, chacun reprend ce qui lui appartient, le partage de ses écrits ne soit la dernière querelle des hommes.
Aprés avoir eſté dans nos converſations cinq ou ſix jours à l’affût aux penſées, plus chargé de pointes qu’un Porc-épic, il les va ficher dans ſes Epigrammes & dans ſes Sonnets, comme des éguilles dans un ploton;	Après avoir été dans nos conversations cinq ou six jours à l’affût aux pensées, plus chargé de pointes qu’un Porc-épic, il les va ficher dans ses Épigrammes et dans ses Sonnets, comme des aiguilles dans un peloton;
Cependant il ſe vante qu’il n’y a rien dans ſes Eſcrits qui ne luy appartienne auſſi juſtement, que le papier & l’encre qu’il a payez;	Cependant il se vante qu’il n’y a rien dans ses Écrits qui ne lui appartienne aussi justement, que le papier et l’encre qu’il a payés;
que les vingt-quatre Lettres de l’Alphabet ſont à luy comme à nous, & la diſpoſition par conſequent;	que les vingt-quatre Lettres de l’Alphabet sont à lui comme à nous, et la disposition par conséquent;
& qu’Ariſtote eſtant mort, il peut s’emparer de ſes Livres, puis que ſes terres qui ſont des immeubles, ne ſont pas aujourd’huy ſans Maiſtres;	et qu’Aristote étant mort, il peut s’emparer de ses Livres, puis que ses terres qui sont des immeubles, ne sont pas aujourd’hui sans Maîtres;
mais aprés tout cela quelques-fois quand on luy trouve le manteau ſur les épaules, il l’adopte pour ſien, & proteſte de n’avoir jamais logé dans ſa memoire que ſes propres imaginations:	mais après tout cela quelques-fois quand on lui trouve le manteau sur les épaules, il l’adopte pour sien, et proteste de n’avoir jamais logé dans sa mémoire que ses propres imaginations:
pour cela il ſe peut faire, ſes Écrits eſtans l’Hoſpital où il retire les miennes.	pour cela il se peut faire, ses Écrits étants l’Hôpital où il retire les miennes.
Si maintenant vous me demandez la definition de cét homme, je vous répondray que c’eſt un Echo qui s’eſt fait penſer de la courte haleine, & qui auroit eſté muet ſi je n’avois jamais parlé:	Si maintenant vous me demandez la définition de cet homme, je vous répondrai que c’est un Écho qui s’est fait penser de la courte haleine, et qui aurait été muet si je n’avais jamais parlé:
Pour moy, je ſuis un miſerable Pere, qui pleure la perte de mes enfans;	Pour moi, je suis un misérable Père, qui pleure la perte de mes enfants;
Il eſt vray que de ſes richeſſes il en uſe fort genereuſement, car elles ſont plus à moy qu’à luy;	Il est vrai que de ses richesses il en use fort généreusement, car elles sont plus à moi qu’à lui;
Et il eſt encore vray que ſi l’on y mettoit le feu, en y jettant de l’eau, je ne ſauverois que mon bien, c’eſt pourquoy je me retracte de tout ce que je luy ay reproché:	Et il est encore vrai que si l’on y mettait le feu, en y jetant de l’eau, je ne sauverais que mon bien, c’est pourquoi je me rétracte de tout ce que je lui ai reproché:
De quelle faute, en effet, puis-je accuſer un innocent qui n’a rien fait, ou qui (quoy qu’il ait fait) ne l’a fait enfin qu’aprés moy?	De quelle faute, en effet, puis-je accuser un innocent qui n’a rien fait, ou qui (quoi qu’il ait fait) ne l’a fait enfin qu’après moi?
Je ne l’accuſe donc plus, nous ſommes trop bons amis, & j’ay toujours eſté ſi joint à luy, qu’on ne peut pas dire qu’il ait jamais travaillé à quelque choſe où je n’aye eſté attentif.	Je ne l’accuse donc plus, nous sommes trop bons amis, et j’ai toujours été si joint à lui, qu’on ne peut pas dire qu’il ait jamais travaillé à quelque chose où je n’aie été attentif.
Ses ouvrages eſtoient mes ſeules penſées, & quand je m’occupois à imaginer, je ſongeois à ce qu’il devoit écrire:	Ses ouvrages étaient mes seules pensées, et quand je m’occupais à imaginer, je songeais à ce qu’il devait écrire:
Tenez donc je vous ſupplie pour aſſuré, que tout ce que je ſemble avoir reproché cy-deſſus à ſa mandicité, eſt ſeulement pour le prier qu’il épargne ſes ridicules comparaiſons de nos peres, car ce n’eſt pas le moyen de devenir, comme il l’eſpere, Écrivain ſans comparaiſon, puis que c’eſt une marque d’avoir bien de la pente au larcin, de dérober juſqu’à des guenilles, & de n’avoir pour toute fineſſe de bien dire, que des comme, des de meſmes, ou des tout ainſi.	Tenez donc je vous supplie pour assuré, que tout ce que je semble avoir reproché ci-dessus à sa mendicité, est seulement pour le prier qu’il épargne ses ridicules comparaisons de nos pères, car ce n’est pas le moyen de devenir, comme il l’espère, Écrivain sans comparaison, puis que c’est une marque d’avoir bien de la pente au larcin, de dérober jusqu’à des guenilles, et de n’avoir pour toute finesse de bien dire, que des comme, des de mêmes, ou des tout ainsi.
Comment la foudre n’eſt pas aſſez loin de ſes mains dans la moyenne région de l’air, ny les torrens de la Trace aſſez rapides pour empêcher qu’il ne les détourne juſqu’en ce Royaume pour les marier par force à ſes comparaiſons?	Comment la foudre n’est pas assez loin de ses mains dans la moyenne région de l’air, ni les torrents de la Trace assez rapides pour empêcher qu’il ne les détourne jusqu’en ce Royaume pour les marier par force à ses comparaisons?
Je ne vois pas le motif de ce mauvais butin, ſi ce n’eſt que ce flegmatique, de peur de laiſſer croupir ſes aquatiques penſées, eſſaye d’en former des torrens, craignant qu’elles ne ſe corrompent, ou qu’il veüille échauffer ſes froides rencontres avec le feu des éclairs & des Tonnerres;	Je ne vois pas le motif de ce mauvais butin, si ce n’est que ce flegmatique, de peur de laisser croupir ses aquatiques pensées, essaye d’en former des torrents, craignant qu’elles ne se corrompent, ou qu’il veuille échauffer ses froides rencontres avec le feu des éclairs et des Tonnerres;
Mais puis qu’enfin, pour tout ce que je luy ſçaurois dire, il ne vainquera pas les tyranniques malignitez de ſa Planette;	Mais puis qu’enfin, pour tout ce que je lui saurais dire, il ne vaincra pas les tyranniques malignités de sa Planète;
& puis que cette inclination de Filou le gourmande avec tant d’empire, qu’il glanne au moins ſur les bons Autheurs;	et puis que cette inclination de Filou le gourmande avec tant d’empire, qu’il glane au moins sur les bons Auteurs;
car quel butin pretend-il faire ſur un miſerable comme moy, il ne ſe chargera que de vétilles.	car quel butin prétend-il faire sur un misérable comme moi, il ne se chargera que de vétilles.
Cependant il conſomme & les nuits & les jours à me dépouiller depuis les pieds juſqu’à la teſte;	Cependant il consomme et les nuits et les jours à me dépouiller depuis les pieds jusqu’à la tête;
de cela eſt ſi vray, que je vous feray voir dans toutes ſes Lettres le commencement & la fin des miennes.	de cela est si vrai, que je vous ferai voir dans toutes ses Lettres le commencement et la fin des miennes.
Je fuis,	Je fuis,
ENfin, gros Homme, je vous ay veu, mes prunelles ont achevé ſur vous de grands voyages;	ENfin, gros Homme, je vous ai vu, mes prunelles ont achevé sur vous de grands voyages;
& le jour que vous éboulâtes corporellement juſqu’à moy, j’eus le temps de parcourir voſtre Hemiſphere, ou pour parler plus véritablement, d’en découvrir quelques cantons:	et le jour que vous éboulâtes corporellement jusqu’à moi, j’eus le temps de parcourir votre Hémisphère, ou pour parler plus véritablement, d’en découvrir quelques cantons:
Mais comme je ne ſuis pas tout ſeul les yeux de tout le monde, permettez que je donne voſtre portrait à la Poſterité, qui un jour ſera bien aiſe de ſçavoir comment vous eſtiez fait.	Mais comme je ne suis pas tout seul les yeux de tout le monde, permettez que je donne votre portrait à la Postérité, qui un jour sera bien aise de savoir comment vous étiez fait.
On ſçaura donc en premier lieu, que la Nature qui vous ficha une teſte ſur la poitrine, ne voulut pas expreſſément y mettre de col, afin de le dérober aux malignitez de voſtre Horoſcope;	On saura donc en premier lieu, que la Nature qui vous ficha une tête sur la poitrine, ne voulut pas expressément y mettre de col, afin de le dérober aux malignités de votre Horoscope;
Que voſtre ame eſt ſi groſſe, qu’elle ſerviroit bien de corps à une perſonne un peu déliée;	Que votre âme est si grosse, qu’elle servirait bien de corps à une personne un peu déliée;
Que vous avez ce qu’aux Hommes on appelle la face ſi fort au deſſous des épaules, & ce qu’on appelle les épaules ſi fort au deſſus de la face, que vous ſemblez un S.	Que vous avez ce qu’aux Hommes on appelle la face si fort au dessous des épaules, et ce qu’on appelle les épaules si fort au dessus de la face, que vous semblez un S.
Denys portant ſon Chef entre ſes mains:	Denis portant son Chef entre ses mains:
Encore je ne dis que la moitié de ce que je voy, car ſi je deſcens mes regards juſqu’à voſtre bedaine, je m’imagine voir aux Limbes tous les Fidelles dans le ſein d’Abraham;	Encore je ne dis que la moitié de ce que je vois, car si je descends mes regards jusqu’à votre bedaine, je m’imagine voir aux Limbes tous les Fidèles dans le sein d’Abraham;
Sainte Urſule qui porte les onze mille Vierges envelopées dans ſon manteau, ou le Cheval de Troye farcy de quarante mille hommes:	Sainte Ursule qui porte les onze mille Vierges enveloppées dans son manteau, ou le Cheval de Troie farci de quarante mille hommes:
Mais je me trompe, vous eſtes quelque choſe de plus gros, ma raiſon trouve bien plus d’apparence à croire que vous eſtes une louppe aux entrailles de la Nature, qui rend la Terre jumelle.	Mais je me trompe, vous êtes quelque chose de plus gros, ma raison trouve bien plus d’apparence à croire que vous êtes une loupe aux entrailles de la Nature, qui rend la Terre jumelle.
Hé!	Hé!
quoy, vous n’ouvrez jamais la bouche, qu’on ne ſe ſouvienne de la Fable de Phaëton, où le Globe de la Terre parle, oüy le Globe de la Terre;	quoi, vous n’ouvrez jamais la bouche, qu’on ne se souvienne de la Fable de Phaéton, où le Globe de la Terre parle, oui le Globe de la Terre;
Et ſi la Terre eſt un Animal, vous voyant auſſi rond, & auſſi large qu’elle, je ſoûtiens que vous vous eſtes ſon mâle, & qu’elle a depuis peu accouché l’Amerique, dont vous l’aviez engroſſie.	Et si la Terre est un Animal, vous voyant aussi rond, et aussi large qu’elle, je soutiens que vous vous êtes son mâle, et qu’elle a depuis peu accouché l’Amérique, dont vous l’aviez engrossie.
Hé bien, qu’en dites-vous, le Portrait eſt-il reſſemblant, pour n’y avoir donné qu’une touche?	Hé bien, qu’en dites-vous, le Portrait est-il ressemblant, pour n’y avoir donné qu’une touche?
par la deſcription de voſtre ſphere de chair, dont tous les membres ſont ſi ronds, que chacun fait un cercle, & par l’arondiſſement univerſel de voſtre épaiſſe maſſe, n’ay-je pas appris à nos Neveux que vous n’eſtiez point fourbe, puis que vous marchez rondement?	par la description de votre sphère de chair, dont tous les membres sont si ronds, que chacun fait un cercle, et par l’arrondissement universel de votre épaisse masse, n’ai-je pas appris à nos Neveux que vous n’étiez point fourbe, puis que vous marchez rondement?
Pouvois-je mieux convaincre de menſonge ceux qui vous menacent de pauvreté, qu’en leur faiſant voir à l’œil que vous roulerez toujours?	Pouvais-je mieux convaincre de mensonge ceux qui vous menacent de pauvreté, qu’en leur faisant voir à l’œil que vous roulerez toujours?
Et enfin eſtoit-il poſſible d’enſeigner plus intelligiblement que vous eſtes un miracle, puis que voſtre gras embonpoint vous fait prendre par vos Spectateurs pour une Longe de Veau qui ſe promene ſur ſes lardons.	Et enfin était-il possible d’enseigner plus intelligiblement que vous êtes un miracle, puis que votre gras embonpoint vous fait prendre par vos Spectateurs pour une Longe de Veau qui se promène sur ses lardons.
Je me doute bien que vous m’objecterez qu’une Boule, qu’un Globe, ny qu’un morceau de chair, ne font pas des Ouvrages, & que la belle Sidon vous a fait triompher ſur les Théâtres de Veniſe:	Je me doute bien que vous m’objecterez qu’une Boule, qu’un Globe, ni qu’un morceau de chair, ne font pas des Ouvrages, et que la belle Sidon vous a fait triompher sur les Théâtres de Venise:
Mais entre vous & moy, vous en connoiſſez l’encloüeure;	Mais entre vous et moi, vous en connaissez l’enclouure;
il n’y a perſonne en Italie, qui ne ſçache que cette Tragédie eſt la Corneille d’Eſope;	il n’y a personne en Italie, qui ne sache que cette Tragédie est la Corneille d’Ésope;
que vous l’avez ſceuë par cœur auparavant que de l’avoir inventée, eſtant tirée de l’Aminte du Paſtor fido de Guarini, du Cavalier Marin, & de cent autres;	que vous l’avez sue par cœur auparavant que de l’avoir inventée, étant tirée de l’Aminte du Pastor fido de Guarini, du Cavalier Marin, et de cent autres;
on la peut appeller la Piece des Pieces, & que vous ſeriez non ſeulement un Globe, une Boule, & un morceau de chair;	on la peut appeler la Pièce des Pièces, et que vous seriez non seulement un Globe, une Boule, et un morceau de chair;
mais encore un miroir qui prend tout ce qu’on luy montre, n’eſtoit que vous repreſentez trop mal.	mais encore un miroir qui prend tout ce qu’on lui montre, n’était que vous représentez trop mal.
Sus donc confeſſez la debte, je n’en parleray point;	Sus donc confessez la dette, je n’en parlerais point;
au contraire, pour vous excuſer, je diray à tout le monde que voſtre Reyne de Cartage doit eſtre un corps compoſé de toutes les Natures;	au contraire, pour vous excuser, je dirais à tout le monde que votre Reine de Carthage doit être un corps composé de toutes les Natures;
parce qu’étant d’Afrique, c’eſt de là que viennent les Monſtres:	parce qu’étant d’Afrique, c’est de là que viennent les Monstres:
Et j’ajoûteray meſme que cette Piece parut ſi belle aux Nobles de cette Republique, qu’à l’exemple des Acteurs qui la joüoient, tout le monde la joüoit.	Et j’ajouterais même que cette Pièce parut si belle aux Nobles de cette République, qu’à l’exemple des Acteurs qui la jouaient, tout le monde la jouait.
Quelques ignorans peut-eſtre concluront, à cauſe de la ſterilité de penſées qu’on y trouve, que vous ne penſiez à rien quand vous la fiſtes;	Quelques ignorants peut-être concluront, à cause de la stérilité de pensées qu’on y trouve, que vous ne pensiez à rien quand vous la fîtes;
mais tous les habiles ſçavent qu’afin d’éviter l’obſcurité, vous y avez mis les bonnes choſes fort claires, & quand meſme ils auroient prouvé que depuis l’Ortil juſqu’au Sapin, c’eſt à dire depuis le Taſſe juſqu’à Corneille, les Poetes ont accouché de voſtre enfant, ils ne pourroient rien inſerer, ſinon qu’une ame ordinaire n’eſtant pas allez grande pour vivifier voſtre maſſe de bout en bout, vous fûtes animé de celle du monde, & qu’aujourd’huy c’eſt ce qui eſt cauſe que vous imaginez par le cerveau de tous les hommes:	mais tous les habiles savent qu’afin d’éviter l’obscurité, vous y avez mis les bonnes choses fort claires, et quand même ils auraient prouvé que depuis l’Ortie jusqu’au Sapin, c’est à dire depuis le Tasse jusqu’à Corneille, les Poètes ont accouché de votre enfant, ils ne pourraient rien insérer, sinon qu’une âme ordinaire n’étant pas allez grande pour vivifier votre masse de bout en bout, vous fûtes animé de celle du monde, et qu’aujourd’hui c’est ce qui est cause que vous imaginez par le cerveau de tous les hommes:
Mais encore ils ſont bien éloignez d’avouer que vous imaginez, ils ſoûtiennent qu’il n’eſt pas poſſible que vous puiſſiez parler, ou que ſi vous parlez, c’eſt, comme jadis l’antre de la Sibille, qui parloit ſans le ſçavoir:	Mais encore ils sont bien éloignés d’avouer que vous imaginez, ils soutiennent qu’il n’est pas possible que vous puissiez parler, ou que si vous parlez, c’est, comme jadis l’antre de la Sibylle, qui parlait sans le savoir:
mais encore que les fumées qui ſortent de voſtre bouche, je voulois dire de voſtre bondon, ſoient auſſi capables d’enyvrer que celles qui s’exhaloient de cette Grotte, je n’y vois rien d’auſſi prophétique;	mais encore que les fumées qui sortent de votre bouche, je voulais dire de votre bondon, soient aussi capables d’enivrer que celles qui s’exhalaient de cette Grotte, je n’y vois rien d’aussi prophétique;
c’eſt pourquoy j’eſtime que vous n’eſtes au plus que la Caverne des ſept Dormans, qui ronflent par voſtre bouche.	c’est pourquoi j’estime que vous n’êtes au plus que la Caverne des sept Dormants, qui ronflent par votre bouche.
Mais, bons Dieux!	Mais, bons Dieux!
qu’eſt-ce que je voy?	qu’est-ce que je vois?
vous me ſemblez encore plus enflé qu’a l’ordinaire.	vous me semblez encore plus enflé qu’a l’ordinaire.
Eſt-ce donc le courroux qui vous ſert de Seringue?	Est-ce donc le courroux qui vous sert de Seringue?
Déjà vos jambes & voſtre teſte ſe ſont tellement unies par leur extenſion à la circonférence de voſtre Globe, que vous n’eſtes plus qu’un Balon.	Déjà vos jambes et votre tête se sont tellement unies par leur extension à la circonférence de votre Globe, que vous n’êtes plus qu’un Ballon.
Vous vous figurez peut-eſtre que je me moque, par ma foy vous avez deviné, & le miracle n’eſt pas grand, qu’une boule ait frappé au but:	Vous vous figurez peut-être que je me moque, par ma foi vous avez deviné, et le miracle n’est pas grand, qu’une boule ait frappé au but:
Je vous puis meſme aſſurer que ſi les coups de bâton s’envoyoient par écrit, vous liriez ma Lettre des épaules;	Je vous puis même assurer que si les coups de bâton s’envoyaient par écrit, vous liriez ma Lettre des épaules;
& ne vous étonnez pas de mon procédé, car la vaſte étendue de voſtre rondeur me fait croire ſi fermement que vous eſtes une terre, que de bon cœur je planterois du bois ſur vous pour voir comment il s’y porteroit?	et ne vous étonnez pas de mon procédé, car la vaste étendue de votre rondeur me fait croire si fermement que vous êtes une terre, que de bon cœur je planterais du bois sur vous pour voir comment il s’y porterait?
Penſez-vous donc à cauſe qu’un Homme ne vous ſçauroit battre tout entier en vingt-quatre heures, & qu’il ne ſçauroit en un jour échigner qu’une de vos omoplates, que je me veuille repoſer de voſtre mort ſur le Bourreau?	Pensez-vous donc à cause qu’un Homme ne vous saurait battre tout entier en vingt-quatre heures, et qu’il ne saurait en un jour échiner qu’une de vos omoplates, que je me veuille reposer de votre mort sur le Bourreau?
Non, non, je ſeray moy-meſme voſtre Parque, & ce ſeroit déjà fait de vous, ſi j’eſtois bien délivré d’un mal de rate, pour la gueriſon duquel les Medecins m’ont ordonné encore quatre ou cinq priſes de vos impertinences;	Non, non, je serai moi-même votre Parque, et ce serait déjà fait de vous, si j’étais bien délivré d’un mal de rate, pour la guérison duquel les Médecins m’ont ordonné encore quatre ou cinq prises de vos impertinences;
mais ſi-toſt que j’auray fait banqueroute aux divertiſſemens, & que je ſeray las de rire, tenez pour tout aſſuré que je vous envoyeray défendre de vous compter entre les choſes qui vivent;	mais si-tôt que j’aurais fait banqueroute aux divertissements, et que je serai las de rire, tenez pour tout assuré que je vous enverrai défendre de vous compter entre les choses qui vivent;
Adieu, c’eſt fait.	Adieu, c’est fait.
J’euſſe bien finy ma Lettre à l’ordinaire, mais vous n’euſſiez pas crû pour cela que je fuſſe voſtre tres-humble, tres-obeïſſant, & tres-affectionné:	J’eusse bien fini ma Lettre à l’ordinaire, mais vous n’eussiez pas crû pour cela que je fusse votre très humble, très obéissant, et très affectionné:
C’eſt pourquoy, Gros Crevé,	C’est pourquoi, Gros Crevé,
