Polexandre ne ſe croiroit pas legitime poſſeſſeur de ſa gloire, s'il n'en faiſoit hommage à VOSTRE MAIESTE': & ne reconnoiſſoit les miracles de VOSTRE VIE, pour les premiers autheurs des grandes actions qu'il a faites.	Polexandre ne se croirait pas légitime possesseur de sa gloire, s’il n’en faisait hommage à VOSTRE MAJESTÉ: et ne reconnaissait les miracles de VOTRE VIE, pour les premiers auteurs des grandes actions qu’il a faites.
C'eſt-pourquoy, SIRE, il deſcend de ſon Troſne, & apporte aux pieds de VOSTRE MAIESTE' ſa Couronne & ſon Sceptre, comme le tribut de cette haute & immortelle reputation, qu'il n'euſt iamais acquiſe, ſans l'emulation magnanime, dont les beaux faits de VOSTRE MAIESTE' ont enflamé ſon courage.	C’est-pourquoi, SIRE, il descend de son Trône, et apporte aux pieds de VOTRE MAJESTÉ sa Couronne et son Sceptre, comme le tribut de cette haute et immortelle réputation, qu’il n’eût jamais acquise, sans l’émulation magnanime, dont les beaux faits de VOSTRE MAJESTÉ ont enflammé son courage.
En effet, SIRE il n'y a rien de grand, rien d'extraordinaire, rien de merueilleux en toutes les auantures de ce Heros, qui ne trouue ſon exemple, dans les admirables euenemens qui compoſent l’hiſtoire du regne de VOSTRE MAIESTE’.	En effet, SIRE il n’y a rien de grand, rien d’extraordinaire, rien de merveilleux en toutes les aventures de ce Héros, qui ne trouve son exemple, dans les admirables événements qui composent l’histoire du règne de VOSTRE MAJESTÉ.
Quand ie voy que preſque au ſortir du berceau Polexandre prend les armes pour le ſalut de ſon peuple;	Quand je vois que presque au sortir du berceau Polexandre prend les armes pour le salut de son peuple;
& que les combats, les ſieges, & les autres trauaux de la guerre ſont les ieux & les exercices de ſon enfance.	et que les combats, les sièges, et les autres travaux de la guerre sont les jeux et les exercices de son enfance.
Quand ie lis que pour le bien general du monde il porte la terreur & la mort dans le ſejour des Tyrans;	Quand je lis que pour le bien général du monde il porte la terreur et la mort dans le séjour des Tyrans;
& ſe declare le Protecteur vniuerſel de l'innocence, opprimee.	et se déclare le Protecteur universel de l’innocence, opprimée.
Quand ie le conſidere vainqueur des hommes, des Elemens, de la fortune, & de ſa propre puiſſance, ie ne puis m'empeſcher de croire, ou que Polexandre eſt LOVYS LE IVSTE, ou que c'eſt vn autre luy-meſme.	Quand je le considère vainqueur des hommes, des Éléments, de la fortune, et de sa propre puissance, je ne puis m’empêcher de croire, ou que Polexandre est LOUIS LE JUSTE, ou que c’est un autre lui-même.
Ie diray dauantage.	Je dirai davantage.
SIRE, ceſt qu'il ſe remarque vne ſi parfaite conformité entre les merueilles de VOSTRE MAIESTE', & celles de ce demy-Dieu, qu'il ſemble qu'vne meſme ame faict mouuoir vos deux corps;	SIRE, c'est qu’il se remarque une si parfaite conformité entre les merveilles de VOSTRE MAJESTÉ, et celles de ce demi-Dieu, qu’il semble qu’une même âme fait mouvoir vos deux corps;
ou bien que ce Prince, incomparable eſt né auec ce glorieux deſtin, d'eſtre en paix & en la guerre, la viuante Image de VOSTRE MAIESTE’.	ou bien que ce Prince, incomparable est né avec ce glorieux destin, d’être en paix et en la guerre, la vivante Image de VOSTRE MAJESTÉ.
Comme elle, il bruſle de l'Amour de la Vertu, & du deſir de la Gloire;	Comme elle, il brûle de l’Amour de la Vertu, et du désir de la Gloire;
& comme elle, il remporte autant de Victoires qu'il entreprend de Combats.	et comme elle, il remporte autant de Victoires qu’il entreprend de Combats.
C'eſt pour ces conſiderations, SIRE, que non ſeulement ie me ſuis engagé à dreſſer les Memoires de ſa vie, mais que ie prens la hardieſſe de les preſenter à VOSTRE MAIESTE'.	C’est pour ces considérations, SIRE, que non seulement je me suis engagé à dresser les Mémoires de sa vie, mais que je prends la hardiesse de les présenter à VOSTRE MAJESTÉ.
Si elle daigne baiſſer les yeux ſur mon ouurage, elle reconnoiſtra que i'ay trauaillé pour ſa gloire quand i'ay trauaille pour celle de ſon Imitateur;	Si elle daigne baisser les yeux sur mon ouvrage, elle reconnaîtra que j’ai travaillé pour sa gloire quand j’ai travaillé pour celle de son Imitateur;
& que ie ne pouuois donner vne plus ſuperbe & plus magnifique Preface à l'hiſtoire de LOVIS LE IVSTE, que l'hiſtoire meſme de POLEXANDRE.	et que je ne pouvais donner une plus superbe et plus magnifique Préface à l’histoire de LOUIS LE IVSTE, que l’histoire même de POLEXANDRE.
SIRE, De VOSTRE MAIESTE' Le tres-humble, tres-obeïſſant, & tres-fidele ſubiect & ſeruiteur,	SIRE, De VOSTRE MAJESTÉ Le très humble, très obéissant, et très fidèle sujet et serviteur,
VN nauire qui ſembloit triompher de la tempeſte dont il eſtoit combatu, vint relaſcher à la rade de cette Iſle bien-heureuſe, qui par vn miracle perpetuel, voit couler des feüilles de ſes arbres, les ſources ineſpuiſables dont elle eſt arrouzée.	UN navire qui semblait triompher de la tempête dont il était combattu, vint relâcher à la rade de cette Île bienheureuse, qui par un miracle perpétuel, voit couler des feuilles de ses arbres, les sources inépuisables dont elle est arrosée.
Auſſi toſt parut à la poupe de ce ſuperbe vaiſſeau, vn ieune Turc, qui pouuoit eſtre pris tant il eſtoit beau;	Aussitôt parut à la poupe de ce superbe vaisseau, un jeune Turc, qui pouvait être pris tant il était beau;
pour vne de ces merueilles qui ont rendu fameuſes les Iſles de l’Archipelague.	pour une de ces merveilles qui ont rendu fameuses les Îles de l’Archipélague.
Il fit mettre vne chalouppe en mer, auec deſſein de ſe faire porter à terre;	Il fit mettre une chaloupe en mer, avec dessein de se faire porter à terre;
& deſia ceux qu’il auoit choiſis pour le ſuiure, eſtoient deſcendus auecque les Matelots, quand des voix confuſes & des hurlemens effroyables, l'arreſterent ſur le bord de ſon nauire.	et déjà ceux qu’il avait choisis pour le suivre, étaient descendus avec les Matelots, quand des voix confuses et des hurlements effroyables, l’arrêtèrent sur le bord de son navire.
Il tourna les yeux vers le lieu d’où ce bruit venoit, & ayant eſté quelque temps ſans rien découurir, apperçût à la pointe d’vn rocher fort haut, & fort eſcarpé, deux hommes qui s’eſtant embraſſez ſe precipiterent dans la mer.	Il tourna les yeux vers le lieu d’où ce bruit venait, et ayant été quelque temps sans rien découvrir, aperçût à la pointe d’un rocher fort haut, et fort escarpé, deux hommes qui s’étant embrassés se précipitèrent dans la mer.
Il fut touché d’vne ſi eſtrange & ſi pitoyable auanture.	Il fut touché d’une si étrange et si pitoyable aventure.
Ceux de ſa ſuite témoignerent par vn grandcry, le déplaiſir qu’ils en receuoient;	Ceux de sa suite témoignèrent par un grand cri, le déplaisir qu’ils en recevaient;
& les Mariniers meſme ſuſpendant l’impaſſibilité que leur condition leur rend comme naturelle, s’offrirent d’aller ſecourir ces deux deſeſperez.	et les Mariniers même suspendant l’impassibilité que leur condition leur rend comme naturelle, s’offrirent d’aller secourir ces deux désespérés.
Le beauTurc loüa leur reſolution, & leur commanda de l’executer.	Le beau Turc loua leur résolution, et leur commanda de l’exécuter.
Quinze ou vingt ſe ietterent dans la chalouppe, & voguerent auec toute l’ardeur dont la charité doit eſtre accompagnée.	Quinze ou vingt se jetèrent dans la chaloupe, et voguèrent avec toute l’ardeur dont la charité doit être accompagnée.
L’excez de la leur faillit à les perdre.	L’excès de la leur faillit à les perdre.
Mais les vents & les flots ſenſibles à ce rare exemple, ſuſpendirent leur violance;	Mais les vents et les flots sensibles à ce rare exemple, suspendirent leur violence;
& pour auoir part à la gloire de ſauuer deux miſerables;	et pour avoir part à la gloire de sauver deux misérables;
en ietterent vn ſur vn banc de ſable, & porterent l’autre contre la chalouppe des Turcs.	en jetèrent un sur un banc de sable, et portèrent l’autre contre la chaloupe des Turcs.
En meſme temps quatre ou cinq le prirent par les cheueux & le tirerent de la mer.	En même temps quatre ou cinq le prirent par les cheveux et le tirèrent de la mer.
Ils allerent auſſi toſt au ſecours de ſon compagnon, mais il leur fut beaucoup plus difficile de le ſauuer.	Ils allèrent aussitôt au secours de son compagnon, mais il leur fut beaucoup plus difficile de le sauver.
A la fin toutefois leur adreſſe iointe à leur affection, ſurmonta les obſtacles de la terre & de la mer;	À la fin toutefois leur adresse jointe à leur affection, surmonta les obstacles de la terre et de la mer;
& l’arracha d’entre les ſables où ces deux elemens ſembloient auoir creuſé ſon tombeau.	et l’arracha d’entre les sables où ces deux éléments semblaient avoir creusé son tombeau.
Si leur ioye fut grande d’auoir ſi bien reüſſi, leur eſtonnement le fut beaucoup plus, lors qu’en deſpoüillant l’vn de ces malheureux;	Si leur joie fut grande d’avoir si bien réussi, leur étonnement le fut beaucoup plus, lorsqu’en dépouillant l’un de ces malheureux;
ils luy trouuerent deux chaiſnes d’or, où pendoient deux boëtes couuertes de diamants & de perles.	ils lui trouvèrent deux chaînes d’or, où pendaient deux boîtes couvertes de diamants et de perles.
Vray-ſemblablement ils deuoient auoir aſſez de curioſité pour s’arreſter quelque temps à conſiderer des choſes ſi precieuſes.	Vraisemblablement ils devaient avoir assez de curiosité pour s’arrêter quelque temps à considérer des choses si précieuses.
Cependant la paſſion qu’ils auoient de plaire au beau Turc, eſtant plus forte que toutes les autres;	Cependant la passion qu’ils avaient de plaire au beau Turc, étant plus forte que toutes les autres;
ils reprirent les rames, & regagnerent leur nauire auecque autant de viſteſſe qu’ils s’en eſtoient eſloignez.	ils reprirent les rames, et regagnèrent leur navire avec autant de vitesse qu’ils s’en étaient éloignés.
Tandis que les vns y racontent le merueilleux ſuccez de leur petit voyage, les autres eſſayent de tirer de leur long euanoüiſſement, ceux qu’ils auoient tirez de la mer.	Tandis que les uns y racontent le merveilleux succès de leur petit voyage, les autres essaient de tirer de leur long évanouissement, ceux qu’ils avaient tirés de la mer.
Mais cognoiſſant que tout ce qu’ils faiſoient eſtoit inutile, ils remonterent dans leur nauire, & y enleüerent les deux euanoüis, auecque vne de ces machines qui ſeruent à remuer le canon & les marchandiſes.	Mais connaissant que tout ce qu’ils faisaient était inutile, ils remontèrent dans leur navire, et y enlevèrent les deux évanouis, avec une de ces machines qui servent à remuer le canon et les marchandises.
Le beau Turc les fit porter à ſa chambre, & ne remarquant en eux aucun ſigne de vie, eut peur que la nature ſeule ne fuſt pas aſſez forte pour leur rendre ce que la crainte & la cheute leur auoient oſté.	Le beau Turc les fit porter à sa chambre, et ne remarquant en eux aucun signe de vie, eut peur que la nature seule ne fût pas assez forte pour leur rendre ce que la crainte et la chute leur avaient ôté.
Il enuoya querir vn François, qui faiſoit profeſſion de la Medecine;	Il envoya quérir un Français, qui faisait profession de la Médecine;
& le conjura d’employer ſes excellans remedes pour le ſoulagement des deux inconnus.	et le conjura d’employer ses excellents remèdes pour le soulagement des deux inconnus.
Le François ſatisfit auſſi toſt à ce iuſte deſir, & trauailla ſi heureuſement qu’en moins d’vn quart d’heure il rendit à l'vn & à l’autre l’vſage de voir & d’entendre.	Le Français satisfit aussitôt à ce juste désir, et travailla si heureusement qu’en moins d’un quart d’heure il rendit à l’un et à l’autre l’usage de voir et d’entendre.
Celuy qui auoit les pierreries, ouurit les yeux le premier, mais ne pouuant ſouffrir la lumiere, il les referma;	Celui qui avait les pierreries, ouvrit les yeux le premier, mais ne pouvant souffrir la lumière, il les referma;
& apres auoir ſouſpiré pluſieurs fois recheut dans ſa foibleſſe.	et après avoir soupiré plusieurs fois rechu dans sa faiblesse.
L’autre monſtrant plus de vigueur, & plus de courage regarda fixement tous ceux qui l’enuironnoient, & s’eſtant apres conſideré luy-meſme:	L’autre montrant plus de vigueur, et plus de courage regarda fixement tous ceux qui l’environnaient, et s’étant après considéré lui-même:
teſmoigna par ſes regards & par ſes admirations, qu’il auoit bien de la peine à ſe recognoiſtre.	témoigna par ses regards et par ses admirations, qu’il avait bien de la peine à se reconnaître.
Le beau Turc en ayant conçeu d’abord vne tres-aduantageuſe opinion, & voulant le conſoler de ſes deſplaiſirs, ou pour le moins faire ceſſer ſes troubles & ſes agitations;	Le beau Turc en ayant conçu d’abord une très avantageuse opinion, et voulant le consoler de ses déplaisirs, ou pour le moins faire cesser ses troubles et ses agitations;
Ie ſouhaitterois d’eſtre aſſez heureux, luy dit-il, pour vous tirer du deſeſpoir que ie voy peint ſur voſtre viſage.	Je souhaiterais d’être assez heureux, lui dit-il, pour vous tirer du désespoir que je vois peint sur votre visage.
Mais il me ſera fort mal-aiſé d’en venir à bout, ſi vous ne prenez la peine de m’en dire la cauſe, & m’apprendre le moyen dont il faut que ie me ſerue pour la faire ceſſer.	Mais il me sera fort mal-aisé d’en venir à bout, si vous ne prenez la peine de m’en dire la cause, et m’apprendre le moyen dont il faut que je me serve pour la faire cesser.
Cét homme qui paroiſſoit Ethyopien, auſſi bien à ſes habits qu'à ſon viſage; ſe mit à pleurer auecque tant de violance, qu’il ſembloit rendre par les yeux, vne partie de l’eau qu’il auoit beuë.	Cet homme qui paraissait Éthiopien, aussi bien à ses habits qu’à son visage; se mit à pleurer avec tant de violence, qu’il semblait rendre par les yeux, une partie de l’eau qu’il avait bue.
Il arreſta toutefois le débordement de ſes pleurs;	Il arrêta toutefois le débordement de ses pleurs;
& tournant pitoyablement les yeux ſur le beau Turc;	et tournant pitoyablement les yeux sur le beau Turc;
luy fit comprendre par ſes ſignes qu’il auoit la langue couppée.	lui fit comprendre par ses signes qu’il avait la langue coupée.
Vne nouueauté ſi peu attenduë accreut l’eſtonnement & du beau Turc & des ſiens; mais comme ſi la fortune euſt concerté diuers ſpectacles pour les faire paſſer d’vne admiration à l’autre;	Une nouveauté si peu attendue accrut l’étonnement et du beau Turc et des siens; mais comme si la fortune eût concerté divers spectacles pour les faire passer d’une admiration à l’autre;
voila que le Muët ſe iette ſur le ſabre d’vn Portugais qui eſtoit contre luy;	voilà que le Muet se jette sur le sabre d’un Portugais qui était contre lui;
& l’ayant pluſtoſt tiré que le Portugais ne ſe fuſt mis en eſtat de l’empeſcher;	et l’ayant plutôt tiré que le Portugais ne se fût mis en état de l’empêcher;
s’élance auec vne extraordinaire fureur contre ſon compagnon, qui ne faiſoit que de ſortir de ſon éuanoüiſſement;	s’élance avec une extraordinaire fureur contre son compagnon, qui ne faisait que de sortir de son évanouissement;
& le luy porte à la gorge.	et le lui porte à la gorge.
Le beau Turc pour la ſeconde fois ſauua la vie à ce miſerable, & conjurant le furieux Muet de ſurmonter ſes reſſentimens, luy promit que s’ils eſtoient iuſtes, ils ne demeureroient pas ſans eſtre ſatisfaits.	Le beau Turc pour la seconde fois sauva la vie à ce misérable, et conjurant le furieux Muet de surmonter ses ressentiments, lui promit que s’ils étaient justes, ils ne demeureraient pas sans être satisfaits.
Le Muët fut arreſté par ces remonſtrances & par ces promeſſes:	Le Muet fut arrêté par ces remontrances et par ces promesses:
mais arreſté de telle ſorte qu’il ne laiſſa pas d’arracher les cheſnes que ſon compagnon auoit au col;	mais arrêté de telle sorte qu’il ne laissa pas d’arracher les chaînes que son compagnon avait au col;
& apres les auoir baiſées pluſieurs fois, & les auoir miſes dans ſon ſein, ſembla dire par ces deux actions qu’il les luy auoit volées.	et après les avoir baisées plusieurs fois, et les avoir mises dans son sein, sembla dire par ces deux actions qu’il les lui avait volées.
Tous les ſpectateurs regarderent l’accuſé, & iugeant de ſa vie par ſa mauuaiſe mine, ne douterent nullement que l’accuſation ne fuſt iuſte.	Tous les spectateurs regardèrent l’accusé, et jugeant de sa vie par sa mauvaise mine, ne doutèrent nullement que l’accusation ne fût juste.
Le beau Turc euſt eu la meſme opinion, s’il ſe fuſt laiſſé emporter à ſes premiers mouuemens;	Le beau Turc eût eu la même opinion, s’il se fût laissé emporter à ses premiers mouvements;
mais ne voulant faire aucun preiugé qui fuſt deſauantageux à ce pretendu voleur;	mais ne voulant faire aucun préjugé qui fût désavantageux à ce prétendu voleur;
il ſe reſolut de l’entendre auant que de le condamner.	il se résolut de l’entendre avant que de le condamner.
Il s’approcha donc de luy apres qu’il eut fait retirer non ſeulement le Muët, mais auſſi tous ceux que la curioſité auoit fait entrer dans ſa chambre;	Il s’approcha donc de lui après qu’il eut fait retirer non seulement le Muet, mais aussi tous ceux que la curiosité avait fait entrer dans sa chambre;
& l’ayant r’aſſeuré auec cette douceur & cette éloquence, dont il ſçauoit charmer les ames les plus brutales, & fortifier les plus laſches;	et l’ayant rassuré avec cette douceur et cette éloquence, dont il savait charmer les âmes les plus brutales, et fortifier les plus lâches;
La fortune, luy dit-il, en te tirant du fond de la mer, a voulu ſe iuſtifier, & poſſible te iuſtifier toy meſme.	La fortune, lui dit-il, en te tirant du fond de la mer, a voulu se justifier, et possible te justifier toi-même.
Ton compagnon t’accuſe, & ſi i’entens bien ſon langage, ſouſtient que tu luy auois oſté les chaines qu’il t’a repriſes.	Ton compagnon t’accuse, et si j’entends bien son langage, soutient que tu lui avais ôté les chaînes qu’il t’a reprises.
Confeſſe la verité;	Confesse la vérité;
& que le deſir d’eſtre riche, ne ſoit pas plus puiſſant ſur ton eſprit, que celuy de te conſeruer la vie.	et que le désir d’être riche, ne soit pas plus puissant sur ton esprit, que celui de te conserver la vie.
Tu es parmy des hommes qui font profeſſion de proteger l’innocence, & de chaſtier les crimes: mais qui ont appris par leurs propres foibleſſes, à ne pas condamner toutes les infirmitez de la nature humaine.	Tu es parmi des hommes qui font profession de protéger l’innocence, et de châtier les crimes: mais qui ont appris par leurs propres faiblesses, à ne pas condamner toutes les infirmités de la nature humaine.
Ce miſerable n’oſant nier vn crime dont ſa conſcience, les hommes, & les élemens meſme le déclaroient coupable;	Ce misérable n’osant nier un crime dont sa conscience, les hommes, et les éléments même le déclaraient coupable;
& d’ailleurs ſe voyant ſi fauorablement traicté, ſe ietta aux pieds du ieune Turc, & luy embraſſant les genoux;	et d’ailleurs se voyant si favorablement traité, se jeta aux pieds du jeune Turc, et lui embrassant les genoux;
Seigneur, luy dit-il, il eſt vray, i’ay commis le larcin dont le Muët m’accuſe.	Seigneur, lui dit-il, il est vrai, j’ai commis le larcin dont le Muet m’accuse.
Les pierreries ſont à luy, ſi celuy-là ſe peut dire le vray poſſeſſeur d’vn bien, qui pour l’acquerir a violé la ſaincteté des tombeaux, & deſpoüillé les morts, des richeſſes que les viuans leur auoient laiſſées.	Les pierreries sont à lui, si celui-là se peut dire le vrai possesseur d’un bien, qui pour l’acquérir a violé la sainteté des tombeaux, et dépouillé les morts, des richesses que les vivants leur avaient laissées.
Mais de peur que vous ne croyez que ie vueille ioindre l’impoſture au vol, donnez vous la patience d’entendre qui ie ſuis, & comme quoy ie m’eſtois rendu maiſtre des richeſſes du Muët.	Mais de peur que vous ne croyez que je veuille joindre l’imposture au vol, donnez-vous la patience d’entendre qui je suis, et comme quoi je m’étais rendu maître des richesses du Muet.
Sçachez que ie ſuis né d’vn des plus mal-heureux & des plus hardis habitans de cette Iſle.	Sçachez que je suis né d’un des plus malheureux et des plus hardis habitants de cette Île.
En me donnant la vie il me donna l’vne & l’autre de ſes deſtinées.	En me donnant la vie il me donna l’une et l’autre de ses destinées.
Dés mon enfance i’aimay les entrepriſes où il y auoit à gagner, quelques hazardeuſes qu'elles fuſſent;	Dès mon enfance j’aimai les entreprises où il y avait à gagner, quelques hasardeuses qu’elles fussent;
& ſans autre cognoiſſance que celle du ſens commun, iugeay qu’il valloit mieux mourir ieune, que de vieillir miſerable.	et sans autre connaissance que celle du sens commun, jugeai qu’il valait mieux mourir jeune, que de vieillir misérable.
I’ay couru la mer & la terre.	J’ai couru la mer et la terre.
I'ay porté les armes parmy les Chreſtiens, & parmy les Turcs.	J’ai porté les armes parmi les Chrétiens, et parmi les Turcs.
I’ay gardé & violé indifféremment ma foy, & tout cela pour auoir du bien.	J’ai gardé et violé indifféremment ma foi, et tout cela pour avoir du bien.
Cependant il ne m'a iamais eſté poſſible d’en acquerir ny par les voyes permiſes, ny par les deffenduës.	Cependant il ne m’a jamais été possible d’en acquérir ni par les voies permises, ni par les défendues.
I’eſtois il n’y a pas long temps auec le renommé Corſaire Baiazet.	J’étais il n’y a pas longtemps avec le renommé Corsaire Bajazet.
I’apprins d’vn de mes compagnons, qu’vn Prince incognû faiſoit baſtir vn ſuperbe tombeau dans l'Iſle que vous voyez;	J’appris d’un de mes compagnons, qu’un Prince inconnu faisait bâtir un superbe tombeau dans l’Île que vous voyez;
& que non content d’y employer les Marbres & la Bronze, il faiſoit entrer l’or & les pierres precieuſes, en la ſtructure de ce ſuperbe edifice.	et que non content d’y employer les Marbres et la Bronze, il faisait entrer l’or et les pierres précieuses, en la structure de ce superbe édifice.
Ces nouuelles toucherent ſi fort ma paſſion dominante, qu’à l’heure meſme ie pris congé de mon Capitaine;	Ces nouvelles touchèrent si fort ma passion dominante, qu’à l’heure même je pris congé de mon Capitaine;
& abandonnay vne profeſſion qui malgré tous les perils dont elle eſt enuiron née, ſe peut nommer les delices de la vie.	et abandonnai une profession qui malgré tous les périls dont elle est environ née, se peut nommer les délices de la vie.
Ie ne vous diray point les dangers que i’ay courus pour me rendre en mon païs.	Je ne vous dirai point les dangers que j’ai courus pour me rendre en mon pays.
C’eſt aſſez que vous ſçachiez que ie n’y ſuis arriué que d’hier, & que la fortune qui a touſiours pris plaiſir de me repaiſtre de belles apparances, me preſenta d’abord tous les treſors que i’y venois chercher.	C’est assez que vous sachiez que je n’y suis arrivé que d’hier, et que la fortune qui a toujours pris plaisir de me repaître de belles apparences, me présenta d’abord tous les trésors que j’y venais chercher.
I'entray dans vn petit bois d’arbres pleurans, qui n’eſt qu’à deux cens pas du rocher d’où ie ſuis tombé;	I’entrai dans un petit bois d’arbres pleurants, qui n’est qu’à deux cents pas du rocher d’où je suis tombé;
& lors que ie fus au milieu;	et lorsque je fus au milieu;
deſcouury le riche tombeau du Prince Inconnû.	découvris le riche tombeau du Prince Inconnu.
Si mes yeux furent eſbloüis de l’éclat de tant d’or & de tant de pierres precieuſes;	Si mes yeux furent éblouis de l’éclat de tant d’or et de tant de pierres précieuses;
mon ame le fut encore dauantage.	mon âme le fut encore davantage.
Ie courus à ces treſors comme à mon ſouuerain bon-heur;	Je courus à ces trésors comme à mon souverain bonheur;
& conceuant des deſſeins auſſi ridicules qu’ils eſtoient releuez;	et concevant des desseins aussi ridicules qu’ils étaient relevés;
perdis la raiſon iuſqu'à croire que ie pourrois oſter au grand Polexandre, la Couronne de toutes les Canaries.	perdis la raison jusqu’à croire que je pourrais ôter au grand Polexandre, la Couronne de toutes les Canaries.
Tandis que mon imagination gaſtée me depeignoit ces agreables chimeres;	Tandis que mon imagination gâtée me dépeignait ces agréables chimères;
certains gemiſſemens & certaines voix languiſſantes, ſortirent du creux de ce tombeau;	certains gémissements et certaines voix languissantes, sortirent du creux de ce tombeau;
& par l'extréme effroy dont ie fus frappé, arreſterent pour quelque temps, l’auidité de mes yeux, & de mes mains.	et par l’extrême effroi dont je fus frappé, arrêtèrent pour quelque temps, l’avidité de mes yeux, et de mes mains.
Mais ceſte vaine terreur ne fut pas de longue durée.	Mais cette vaine terreur ne fut pas de longue durée.
Les anciennes chaſſerent cette nouuelle, & bien qu’il ny ait point de mal-heur eſgal au mien;	Les anciennes chassèrent cette nouvelle, et bien qu’il n'y ait point de malheur égal au mien;
ie ne me creu pas toutefois ſi mal-heureux que de faire reſſuſciter les morts pour trauerſer mes deſſeins.	ie ne me cru pas toutefois si malheureux que de faire ressusciter les morts pour traverser mes desseins.
Ie m’approchay de l’entrée de ce tombeau, & au trauers d’vne grille d’or dont la porte eſtoit fermee;	Je m’approchai de l’entrée de ce tombeau, et au travers d’une grille d’or dont la porte était fermée;
ie vy vn ſpectacle ſi horrible, que meſme en vous le racontant ie ne puis m'empeſcher de fremir.	Je vis un spectacle si horrible, que même en vous le racontant je ne puis m’empêcher de frémir.
Le Muët que vous auez ſauué, eſtoit enfermé dans ce ſepulcre, & venoit indubitablement d’égorger vn homme, qui eſtoit eſtendu à ſes piés.	Le Muet que vous avez sauvé, était enfermé dans ce sépulcre, et venait indubitablement d’égorger un homme, qui était étendu à ses pieds.
Le cimeterre dont il auoit fait ce mal-heureux coup, fumoit encore du ſang qu’il auoit reſpandu;	Le cimeterre dont il avait fait ce malheureux coup, fumait encore du sang qu’il avait répandu;
& luy tranſporté de l’horreur de ſon aſſaſſinat, ſembloit deuoir perdre le ſens, apres auoir perdu l’humanité.	et lui transporté de l’horreur de son assassinat, semblait devoir perdre le sens, après avoir perdu l’humanité.
Car au lieu de profiter de ſon homicide, il ſe mit à le déplorer, auec des grimaces, & des hurlemens eſtranges.	Car au lieu de profiter de son homicide, il se mit à le déplorer, avec des grimaces, et des hurlements étranges.
Mais il eſt mal-aiſé qu’vn meſchant garde long temps les bons mouuemens que la raiſon luy donne.	Mais il est malaisé qu’un méchant garde longtemps les bons mouvements que la raison lui donne.
Le barbare Muët paſſa incontinant d’vne extremité à l’autre, & ſe remit en ſon vray naturel.	Le barbare Muet passa incontinent d’une extrémité à l’autre, et se remit en son vrai naturel.
Il finit les actions extrauagantes qu’il faiſoit ſur le corps du mort;	Il finit les actions extravagantes qu’il faisait sur le corps du mort;
& bien qu’à ſes ſouſpirs & ſes larmes, il paruſt extremement affligé, il ne laiſſa pas toutefois de luy oſter vne robbe d’écarlatte dont il eſtoit couuert;	et bien qu’à ses soupirs et ses larmes, il parût extrêmement affligé, il ne laissa pas toutefois de lui ôter une robe d’écarlate dont il était couvert;
& par vne cruauté ſans exemple, il luy fendit le coſté gauche & luy arracha le cœur.	et par une cruauté sans exemple, il lui fendit le côté gauche et lui arracha le cœur.
Ie fûs eſpouuanté d’vn acte ſi barbare.	Je fus épouvanté d’un acte si barbare.
Celuy meſme qui le commettoit en eut vne telle horreur, que le cœur & l'eſpée qu’il tenoit, luy tomberent des mains:	Celui même qui le commettait en eut une telle horreur, que le cœur et l’épée qu’il tenait, lui tombèrent des mains:
mais comme s’il euſt perdu le ſens, ou que tout à coup il ſe fuſt repenty de ſes inhumanitez, ils reprint ce cœur, le baiſa pluſieurs fois tout ſanglant qu’il eſtoit;	mais comme s’il eût perdu le sens, ou que tout à coup il se fût repenti de ses inhumanités, ils reprit ce cœur, le baisa plusieurs fois tout sanglant qu’il était;
& apres luy auoir par ſes pleurs & par ſes hurlemens rendu les derniers deuoirs, il l’enferma dans vne dës deux boëttes qu’il ma repriſes: Pendant que ie delibere ſur les moyens d’auoir vn cœur ſi pretieux, & que ie meſure mon courage & mes forces, au courage & aux forces du Müet, ie voy qu’il foüille ce mort pour la ſeconde fois, & luy prend vne boëtte plus petite que la premiere, mais (a ce qu’il me ſembla) beaucoup plus belle & beaucoup plus riche.	et après lui avoir par ses pleurs et par ses hurlements rendu les derniers devoirs, il l’enferma dans une des deux boîtes qu’il m'a reprises: Pendant que je délibère sur les moyens d’avoir un cœur si précieux, et que je mesure mon courage et mes forces, au courage et aux forces du Muet, je vois qu’il fouille ce mort pour la seconde fois, et lui prend une boîte plus petite que la première, mais (à ce qu’il me sembla) beaucoup plus belle et beaucoup plus riche.
Dés lors ie fis deſſein de punir ce cruel ennemy des morts, & de poſſeder par vne iuſte conqueſte des treſors qu’il auoit acquis par de ſi abominables ſacrileges.	Dès lors je fis dessein de punir ce cruel ennemi des morts, et de posséder par une juste conquête des trésors qu’il avait acquis par de si abominables sacrilèges.
Pour executer facillement ceſte reſolution, ie m’eſlogne de l’entree du tombeau & me cache entre des arbres afin de ſurprẽdre ce Müet, & l’enuoyer tenir compagnie à celuy qu’il auoit volé.	Pour exécuter facilement cette résolution, je m’éloigne de l’entrée du tombeau et me cache entre des arbres afin de surprendre ce Muet, et l’envoyer tenir compagnie à celui qu’il avait volé.
Il ne me laiſſa pas long temps exercer ma patience.	Il ne me laissa pas longtemps exercer ma patience.
Il ſortit du ſepulchre l’eſpée toute ſanglante à la main, & ſi plein de douleur & de rage, que pour l’attaquer il euſt fallu n’eſtre pas moins deſeſperé que luy.	Il sortit du sépulcre l’épée toute sanglante à la main, et si plein de douleur et de rage, que pour l’attaquer il eût fallu n’être pas moins désespéré que lui.
Il marcha iuſqu’au pres de moy, menaſſant par ſes geſtes le Ciel & la terre, & ſa fureur le trãſportant il courrut de toute ſa force droit à ce rocher d’où nous ſommes tombez enſemble.	Il marcha jusqu’auprès de moi, menaçant par ses gestes le Ciel et la terre, et sa fureur le transportant il courut de toute sa force droit à ce rocher d’où nous sommes tombés ensemble.
Cette fuitte ineſperée me fit changer de reſolution & iuger que cette affaire demandoit l’artifice pluſtoſt que la force. Ie le ſuiuis donc auecque cette incroiable viteſſe qui m'a fait acquerir le nõ du meilleur coureur d’Afrique, & l’ayant atteint comme il s’alloit ietter dans la mer;	Cette fuite inespérée me fit changer de résolution et juger que cette affaire demandait l’artifice plutôt que la force. Je le suivis donc avec cette incroyable vitesse qui m’a fait acquérir le nom du meilleur coureur d’Afrique, et l’ayant atteint comme il s’allait jeter dans la mer;
ie fis par auarice ce qu’vn autre auroit fait par compaſſion.	je fis par avarice ce qu’un autre aurait fait par compassion.
Lors qu’il ſe ſentit arreſté, il ſe ietta ſur moy auec la fureur d’vn lion à qui l’on a fermé le paſſage.	Lorsqu’il se sentit arrêté, il se jeta sur moi avec la fureur d’un lion à qui l’on a fermé le passage.
Ie luy repreſentay que ſon deſeſpoir eſtoit indigne d’vn homme de cour, & que pour extraordinaire que fût ſon infortune;	Je lui représentai que son désespoir était indigne d’un homme de cour, et que pour extraordinaire que fût son infortune;
il n’en deuoit pas ſortir par vne voye ſi criminelle.	il n’en devait pas sortir par une voie si criminelle.
Mon diſcours l’aiant fait reuenir à ſoy, il me voulut dire qu’il auoit de grands ſujets de haïr la vie mais ne croiant pas s’expliquer aſſez bien par ſes geſtes;	Mon discours l’ayant fait revenir à soi, il me voulut dire qu’il avait de grands sujets de haïr la vie mais ne croyant pas s’expliquer assez bien par ses gestes;
il me prit par la main, me remena au tombeau, en ouürit la grille d’or, & m’ayant fait entrer, me monſtra le corps que i’auois deſ-ja vû.	il me prit par la main, me ramena au tombeau, en ouvrit la grille d’or, et m’ayant fait entrer, me montra le corps que j’avais déjà vu.
A ce funeſte objet il renouuella ſes cris & ſes larmes, & fut long temps à celebrer de cette ſorte les funerailles de ce mort.	À ce funeste objet il renouvela ses cris et ses larmes, et fut longtemps à célébrer de cette sorte les funérailles de ce mort.
Moy qui n’auois autre penſée que d’executer mon premier deſſein, ie fus quatre ou cinq fois ſur le point de me deffaire de luy, mais autãt de fois en eſtant empeſché par ie ne ſçay quelle crainte:	Moi qui n’avais autre pensée que d’exécuter mon premier dessein, je fus quatre ou cinq fois sur le point de me défaire de lui, mais autant de fois en étant empêché par je ne sais quelle crainte:
ie le tiray de ce ſepulchre, & l'emmenay du coſté de la mer.	je le tirai de ce sépulcre, et l’emmenai du côté de la mer.
La nuict nous print auãt que nous y fuſſions arriuez, & fut ſuiuie d’vne ſi grãde obſcurité, que malgré tous mes ſoins & tous les yeux que l’eſperance & la crainte me donnoient, ie fus ſeparé du Müet.	La nuit nous prit avant que nous y fussions arrivés, et fut suivie d’une si grande obscurité, que malgré tous mes soins et tous les yeux que l’espérance et la crainte me donnaient, je fus séparé du Muet.
Ie ne ceſſay de marcher tant que la nuict dura, de peur de le perdre:	Je ne cessai de marcher tant que la nuit dura, de peur de le perdre:
mais il eſtoit deſ-ja iour lors que ie le rencontray dormant à la pointe de l'eſcueil, d’ou vous nous auez veu tomber.	mais il était déjà jour lorsque je le rencontrai dormant à la pointe de l’écueil, d’ou vous nous avez vu tomber.
De peur de l’eſueiller ie me couchay tout doucement aupres de luy, & me ſeruis ſi bien de la ſubtillité que pluſieurs excellents maiſtres m’ont enſeignee, qu’insẽſiblemẽt ie me ſaiſy de ſes deux chaiſnes & des boëttes qui y eſtoiẽt attachées.	De peur de l’éveiller je me couchai tout doucement auprès de lui, et me servis si bien de la subtilité que plusieurs excellents maîtres m’ont enseignée, qu’insensiblement je me saisi de ses deux chaînes et des boîtes qui y étaient attachées.
Ie me les paſſay auſſi-toſt dans le col, & pour n’auoir plus rien à demeſler auecque le Müet ie me reſolus de rendre ſon ſomme eternel.	Je me les passai aussitôt dans le col, et pour n’avoir plus rien à démêler avec le Muet je me résolus de rendre son somme éternel.
Mais en ce meſme inſtant la Fortune qui enrageroit ſi i’auois du bien, le reueilla, & luy fit prendre garde non ſeulemẽt à ce que i’auois fait, mais à ce que i’eſtois ſur le poinct d’executer.	Mais en ce même instant la Fortune qui enragerait si j’avais du bien, le réveilla, et lui fit prendre garde non seulement à ce que j’avais fait, mais à ce que j’étais sur le point d’exécuter.
Il ſe lance ſur moy auec vne fureur eſpouuentable, & malgré toute ma reſiſtance m’enleue de terre, me preſſe entre ſes bras de telle ſorte qu'à peine pouuois-je reſpirer, me porte à la pointe de noſtre fatal rocher & hurlant comme vne beſte enragée me precipite auec luy dans la mer.	Il se lance sur moi avec une fureur épouvantable, et malgré toute ma résistance m’enlève de terre, me presse entre ses bras de telle sorte qu’à peine pouvais-je respirer, me porte à la pointe de notre fatal rocher et hurlant comme une bête enragée me précipite avec lui dans la mer.
Voila Seigneur le malheureux ſuccez d’vne entrepriſe où i’auois mis mes plus hautes eſperances.	Voilà Seigneur le malheureux succès d’une entreprise où j’avais mis mes plus hautes espérances.
Permettez maintenant que ie me plaigne de vous, & qu’au lieu de vous demander le pardon de mes crimes, ie vous accuſe d’en auoir empeſché la punitiõ.	Permettez maintenant que je me plaigne de vous, et qu’au lieu de vous demander le pardon de mes crimes, je vous accuse d’en avoir empêché la punition.
Pourquoy m’auez vous fait retirer du fond de la mer, & par vne pitié qui m’eſt ſi cruelle, rendu le ſentimẽt de mes maux, & la cognoiſſe de ma deſtinée funeſte.	Pourquoi m’avez vous fait retirer du fond de la mer, et par une pitié qui m’est si cruelle, rendu le sentiment de mes maux, et la connaissance de ma destinée funeste.
Que le bien-heureux Müet poſſede en repos (puiſque ie vous y voy reſolu) les richeſſes, qu’il a ſi mal acquiſes, mais qu’il ne les poſſede pas à mõ perpetuel deſeſpoir, & pour le moins, accordez moy que ie perde la vie afin qu'en meſme temps ie perde la memoire de tant de treſors qui m’eſtoient aſſeurez.	Que le bienheureux Muet possède en repos (puisque je vous y vois résolu) les richesses, qu’il a si mal acquises, mais qu’il ne les possède pas à mon perpétuel désespoir, et pour le moins, accordez-moi que je perde la vie afin qu’en même temps je perde la mémoire de tant de trésors qui m’étaient assurés.
Le jeune Turc qui n’ignoroit pas les iniuſtices de la Fortune, s’arreſta moins ſur les mauuaiſes inclinations de ce ſoldat, que ſur ſa conſtance, & ſes diſgraces:	Le jeune Turc qui n’ignorait pas les injustices de la Fortune, s’arrêta moins sur les mauvaises inclinations de ce soldat, que sur sa constance, et ses disgrâces:
& l’ayant aſſeuré que s’il vouloit bien viure il le rendroit heureux;	et l’ayant assuré que s’il voulait bien vivre il le rendrait heureux;
luy fit faire reflectiõ ſur les calomnies qu’il auoit inuẽtées contre le Müet, & confeſſer malgré toute ſon enuie que cét hõme n’auoit pas moins d'innocence qu’il auoit de courage.	lui fit faire réflexion sur les calomnies qu’il avait inventées contre le Muet, et confesser malgré toute son envie que cet homme n’avait pas moins d’innocence qu’il avait de courage.
Mais, adjouſta-t'il, il faut que nous ſçachions le reſte de ſon aduenture, & que nous eſſayons de tirer de luy par ſignes ou par eſcrit ce que tu ne me ſçaurois apprendre.	Mais, ajouta-t-il, il faut que nous sachions le reste de son aventure, et que nous essayons de tirer de lui par signes ou par écrit ce que tu ne me saurais apprendre.
A l’inſtant meſme il fit r’entrer le Müet auec ceux qui l’auoient ſuiuy;	À l’instant même il fit rentrer le Muet avec ceux qui l’avaient suivi;
& l’ayant coniuré de ne ſe plus ſouuenir des actions du Canarien, le pria de luy faire entẽdre qui eſtoit le Prince dont il portoit le cœur.	et l’ayant conjuré de ne se plus souvenir des actions du Canarien, le pria de lui faire entendre qui était le Prince dont il portait le cœur.
Le Müet tira ce cœur precieux de ſon ſein, & apres l’auoir baizé pluſieurs fois l’eſleua en haut, comme s’il euſt voulu dire que c’eſtoit le cœur d’vn homme incomparable.	Le Muet tira ce cœur précieux de son sein, et après l’avoir baisé plusieurs fois l’éleva en haut, comme s’il eût voulu dire que c’était le cœur d’un homme incomparable.
En ſuitte de pluſieurs exclamations non articulées;	Ensuite de plusieurs exclamations non articulées;
il le preſenta au jeune Turc, & luy montrant auec le doigt l’Iſle de fer, le conuia d’y deſcendre & d’aller s’éclaircir des auentures qu’il ne luy pouuoit raconter.	il le présenta au jeune Turc, et lui montrant avec le doigt l’Île de fer, le convia d’y descendre et d’aller s’éclaircir des aventures qu’il ne lui pouvait raconter.
Comme il vit que le beau Turc ne s’y preparoit pas aſſez viſte, il ſe douta qu’il n’en eſtoit pas entendu, & pour ſe mieux expliquer, il print ſon autre boëtte, & auec vne mine pleine d’indignation & de triſteſſe la mit entre les mains de ce Turc.	Comme il vit que le beau Turc ne s’y préparait pas assez vite, il se douta qu’il n’en était pas entendu, et pour se mieux expliquer, il prit son autre boîte, et avec une mine pleine d’indignation et de tristesse la mit entre les mains de ce Turc.
Le Turc la receut, & l’ayant curieuſemẽt regardée, remarqua que les diamants dont elle eſtoit couuerte, non ſeulement eſtoiẽt d’vne beauté & d’vne groſſeur prodigieuſe;	Le Turc la reçut, et l’ayant curieusement regardée, remarqua que les diamants dont elle était couverte, non seulement étaient d’une beauté et d’une grosseur prodigieuse;
mais auſſi qu’ils eſtoient preſque tous grauez.	mais aussi qu’ils étaient presque tous gravés.
Sur les vns on voyoit des flâmes, qui ſembloient donner aux diamants l’eſclat qu’elles leur deuoient.	Sur les uns on voyait des flammes, qui semblaient donner aux diamants l’éclat qu’elles leur devaient.
Sur les autres on voyoit des chiffres de diferente façon, des Septres meſlez de traits, & des couronnes de palmes, & de myrthes enlacées les vnes dans les autres.	Sur les autres on voyait des chiffres de différente façon, des Sceptres mêlés de traits, et des couronnes de palmes, et de myrtes enlacées les unes dans les autres.
Apres qu’il eut bien regardé le deſſus de ceſte boëtte, il l’ouurit, & trouua dedans;	Après qu’il eut bien regardé le dessus de cette boîte, il l’ouvrit, et trouva dedans;
le pourtraict d’vne ieune merueille, qui par la majeſté que le Peintre auoit repreſentée ſur ſon viſage, faiſoit bien mieux cognoiſtre ſa condition, que par la couronne qu'elle portoit ſur la teſte.	le portrait d’une jeune merveille, qui par la majesté que le Peintre avait représentée sur son visage, faisait bien mieux connaître sa condition, que par la couronne qu’elle portait sur la tête.
La delicateſſe des traits de ſon viſage, l’incarnat de ſes lévres, & la beauté de ſon teint, l’auroient fait prendre pour vn enfant, ſi l’embonpoint de ſa gorge, & l’eſclat de ſes yeux n’euſſent fait ayſemẽt iuger qu'elle pouuoit auoir quinze ou ſeize ans.	La délicatesse des traits de son visage, l’incarnat de ses lèvres, et la beauté de son teint, l’auraient fait prendre pour un enfant, si l’embonpoint de sa gorge, et l’éclat de ses yeux n’eussent fait aisément juger qu’elle pouvait avoir quinze ou seize ans.
Ses cheueux n’eſtoient ny trop clairs ny trop bruns & sẽ bloient eſtre faits expres pour accompagner vn viſage parfaictement delicat, & releuer vn teint parfaictement vif.	Ses cheveux n’étaient ni trop clairs ni trop bruns et semblaient être faits exprès pour accompagner un visage parfaitement délicat, et relever un teint parfaitement vif.
Le ieune Turc ayant eſté long temps attaché ſur ce pourtraict, le rendit au Müet, & luy dit qu’il n’en auoit iamais vû l’original.	Le jeune Turc ayant été longtemps attaché sur ce portrait, le rendit au Muet, et lui dit qu’il n’en avait jamais vu l’original.
Le Müet s’eſtant frappé diuerſes fois l’eſtomac, & ayãt repris cette peinture en cholere, fit entendre par ſes actions qu'elle eſtoit la ſeule cauſe de la mort du Prince Incognu.	Le Muet s’étant frappé diverses fois l’estomac, et ayant repris cette peinture en colère, fit entendre par ses actions qu’elle était la seule cause de la mort du Prince Inconnu.
Le Turc n’eſtãt pas encore bien eſclaircy de ſes doutes, ſe reſolut de mettre pied à terre en l’Iſle de fer, & d’aller iuſqu'à ce fameux tombeau, pour auoir l’intelligence des geſtes du Müet.	Le Turc n’étant pas encore bien éclairci de ses doutes, se résolut de mettre pied à terre en l’Île de fer, et d’aller jusqu’à ce fameux tombeau, pour avoir l’intelligence des gestes du Muet.
Il ne pût executer ce deſſein:	Il ne pût exécuter ce dessein:
car en meſme temps vn matelot qui eſtoit à la hune de ſon nauire, teſmoignant tout à la fois ſa vigilance & ſa crainte; Voiles, voiles, ſeſcria-t’il, voiles de Maroc.	car en même temps un matelot qui était à la hune de son navire, témoignant tout à la fois sa vigilance et sa crainte; Voiles, voiles, s'écria-t’il, voiles de Maroc.
Ce peu de mots apporta vn ſi grand effroy & vne ſi eſtrange confuſion dans le vaiſſeau, que les matelots n’ecouttãt plus la voix du pilote, ny les ſoldats celle du Capitaine:	Ce peu de mots apporta un si grand effroi et une si étrange confusion dans le vaisseau, que les matelots n’écoutant plus la voix du pilote, ni les soldats celle du Capitaine:
il y en eut meſmes quelques vns qui n’ozant attendre la mort dont ils eſtoient menacez;	il y en eut mêmes quelques-uns qui n’osant attendre la mort dont ils étaient menacés;
ſe ietterent dans la mer pour la preuenir.	se jetèrent dans la mer pour la prévenir.
Le ieune Turc fut le ſeul qui demeurant debout parmy la cheute de tous les ſiens, oppoſa vne incroiable grãdeur de courage à leur incroiable eſpouuentement.	Le jeune Turc fut le seul qui demeurant debout parmi la chute de tous les siens, opposa une incroyable grandeur de courage à leur incroyable épouvantement.
Il courut par tout le vaiſſeau l'eſpée à la main, & frappant les vns & menaçant les autres, leur dõna pour le moins vn iuſte ſuiet de craindre.	Il courut par tout le vaisseau l’épée à la main, et frappant les uns et menaçant les autres, leur donna pour le moins un juste sujet de craindre.
Comme il reconût que cette nouuelle terreur leur faiſoit oublier la premiere;	Comme il reconnut que cette nouvelle terreur leur faisait oublier la première;
& que chacun reuenoit de l’extremité où la voix d’vn chetif matelot les auoit iettez;	et que chacun revenait de l’extrémité où la voix d’un chétif matelot les avait jetés;
hé bien, mes compagnõs, leur dit-il, il vous eſt arriué ce qui peut arriuer aux plus vaillans ſoldats;	hé bien, mes compagnons, leur dit-il, il vous est arrivé ce qui peut arriver aux plus vaillants soldats;
& vous auez apris par vne bien violente, mais bien courte experiance, que les hommes pour hardis qu’ils ſoient, ne ſont pas maiſtres de leurs premiers mouuemens.	et vous avez appris par une bien violente, mais bien courte expérience, que les hommes pour hardis qu’ils soient, ne sont pas maîtres de leurs premiers mouvements.
Certes ce ſeroit vn prodige bien monſtrueux, que ceux la meme qui ont témoigné tãt de cœur pour acquerir leur liberté n’en euſsent point lorsqu’il eſt queſtion de la conſeruer.	Certes ce serait un prodige bien monstrueux, que ceux la même qui ont témoigné tant de cœur pour acquérir leur liberté n’en eussent point lorsqu’il est question de la conserver.
Non non il ne ſera iamais dit que ce malheur nous ſoit auenu;	Non non il ne sera jamais dit que ce malheur nous soit advenu;
& du meſme courage dont nous auons mis en pieces nos chaiſnes, & malgré toute la reſiſtance des Maures, rompû nos priſons, nous deuons ſouſtenir leur choc, & nous vanger de leur barbarie.	et du même courage dont nous avons mis en pièces nos chaînes, et malgré toute la résistance des Maures, rompu nos prisons, nous devons soutenir leur choc, et nous venger de leur barbarie.
Il arriuera sãs doute, que ceſte main toute-puiſſante qui protege les cauſes iuſtes, fortifiera les noſtres, & poſſible que c'eſt elle-meſme qui nous amene nos tyrans, afin que par vne legitime retribution nous en facions nos eſclaues.	Il arrivera sans doute, que cette main toute-puissante qui protège les causes justes, fortifiera les nôtres, et possible que c’est elle-même qui nous amène nos tyrans, afin que par une légitime rétribution nous en fassions nos esclaves.
Mais d’où procede cette nouuelle terreur que ie voy peinte ſur vos viſages?	Mais d’où procède cette nouvelle terreur que je vois peinte sur vos visages?
Le nom de vos ennemis auroit il maintenãt plus de puiſſance ſur vos ames que n’ont eu leurs fers, leurs feux & leurs bourreaux?	Le nom de vos ennemis aurait il maintenant plus de puissance sur vos âmes que n’ont eu leurs fers, leurs feux et leurs bourreaux?
Ie me trompe mes compagnons, & ſuis ie l’auouë) vn mauuais interprete du changement de voſtre viſage.	Je me trompe mes compagnons, et suis je l’avoue) un mauvais interprète du changement de votre visage.
C’eſt vn genereux couroux, & vn impatient deſir de vẽgeance, qui vous échaufe le ſang & qui vous donne ces émotions guerrieres.	C’est un généreux courroux, et un impatient désir de vengeance, qui vous échauffe le sang et qui vous donne ces émotions guerrières.
Conſeruez vne ſi belle fureur, & vous imaginés qu’apres auoir forcé nos priſons, tué nos gardes & gaigné ce vaiſſeau:	Conservez une si belle fureur, et vous imaginez qu’après avoir forcé nos prisons, tué nos gardes et gagné ce vaisseau:
nous auons rendu noſtre cõdition pire qu'elle n’eſtoit, ſi nous ne ſommes aſſez reſolus pour exterminer ces barbares qui ſont deſeſperez de noſtre fuitte.	nous avons rendu notre condition pire qu’elle n’était, si nous ne sommes assez résolus pour exterminer ces barbares qui sont désespérés de notre fuite.
A toute extremité vendons-leur cherement noſtre vie, & les enuelopans dans noſtre perte, faiſons ou qu’ils ne ſe ſouuiennent iamais de leur victoire, ou qu’ils ne s’en ſouuiennẽt qu’aqu’auec larmes.	À toute extrémité vendons-leur chèrement notre vie, et les enveloppants dans notre perte, faisons ou qu’ils ne se souviennent jamais de leur victoire, ou qu’ils ne s’en souviennent qu’avec larmes.	A toute extremité vendons-leur cherement noſtre vie, & les enuelopans dans noſtre perte, faiſons ou qu’ils ne ſe ſouuiennent iamais de leur victoire, ou qu’ils ne s’en ſouuiennẽt qu’auec larmes.
Il n’y eut ſang ſi glacé que ceſte eloquance n’eſchauffaſt, ny matelot ſi laſche, qui ne ſouhaittaſt d’eſtre aux mains auec l’ennemy.	Il n’y eut sang si glacé que cette éloquence n’échauffât, ni matelot si lâche, qui ne souhaitât d’être aux mains avec l’ennemi.
En meſme temps le beau Turc fit prendre les armes à tous, & plaça chacun à ſa poſte.	En même temps le beau Turc fit prendre les armes à tous, et plaça chacun à sa poste.
Le Pilote ayant receu l’ordre qu’il falloit garder en vn combat ſi inégal, s’eſloigna de l’iſle de Fer;	Le Pilote ayant reçu l’ordre qu’il fallait garder en un combat si inégal, s’éloigna de l’île de Fer;
& pour contenter la genereuſe impatiance de ſon Capitaine, fut au deuant des ennemis, & gagna la pleine mer, en gagnant le deſſus du vent.	et pour contenter la généreuse impatience de son Capitaine, fut au devant des ennemis, et gagna la pleine mer, en gagnant le dessus du vent.
Les huict vaiſſeaux qui venoient à pleines voiles fondre ſur luy;	Les huit vaisseaux qui venaient à pleines voiles fondre sur lui;
ſe diſpoſerent au combat auec autant d’ordre que s’ils euſſent eſté les plus foibles.	se disposèrent au combat avec autant d’ordre que s’ils eussent été les plus faibles.
Ils ſe ſeparerent, & ayant formé vn croiſſant, en aduancerent de telle ſorte les pointes, qu’ils ſembloient vouloir enfermer celuy qui voguoit le premier.	Ils se séparèrent, et ayant formé un croissant, en avancèrent de telle sorte les pointes, qu’ils semblaient vouloir enfermer celui qui voguait le premier.
Ce vaiſſeau ſe conſerua touſiours l’auantage qu’il auoit ſur les ſept autres;	Ce vaisseau se conserva toujours l’avantage qu’il avait sur les sept autres;
& les laiſſant aſſez loing derriere ſoy, fit croire aux Turcs qu’il vouloit commencer le combat.	et les laissant assez loin derrière soi, fit croire aux Turcs qu’il voulait commencer le combat.
Mais il ne fut pas à la portée de leur Canon, que ceux qui eſtoient dedans, baiſſerent les voiles, & par toutes les marques qui ſont en vſage ſur la mer;	Mais il ne fut pas à la portée de leur Canon, que ceux qui étaient dedans, baissèrent les voiles, et par toutes les marques qui sont en usage sur la mer;
firent cognoiſtre aux Turcs qu’ils ne venoient pas pour les attaquer, mais pour ſe mettre en leur protection.	firent connaître aux Turcs qu’ils ne venaient pas pour les attaquer, mais pour se mettre en leur protection.
Leur genereux Capitaine ne delibera point ſur ce qui eſtoit le plus ſeur de faire en vne coniecture ſi perilleuſe.	Leur généreux Capitaine ne délibéra point sur ce qui était le plus sûr de faire en une conjecture si périlleuse.
D’abord il accorda à ces ſupplians l’aſſiſtance qu’ils luy demandoient;	D’abord il accorda à ces suppliants l’assistance qu’ils lui demandaient;
& s’eſtant aduancé pour les couurir, leur dit en paſſant qu’il les deffendroit contre tout le monde.	et s’étant avancé pour les couvrir, leur dit en passant qu’il les défendrait contre tout le monde.
Ils le remercierent par de longs cris, & des voix confuſes;	Ils le remercièrent par de longs cris, et des voix confuses;
& gaignerent le derriere de l’iſle de Fer.	et gagnèrent le derrière de l’île de Fer.
Luy cepandant rauy que tant de rares aduantures ſe preſentaſſent tout à la fois;	Lui cependant ravi que tant de rares aventures se présentassent tout à la fois;
print vn habillement de teſte, & vne rondache; & ſe tournant vers les ſiens, Aduoüez, leur dit-il, chers compagnons de mes chaines & de ma liberté, que la fortune vient de bonne grace ſe reconcilier auec nous.	prit un habillement de tête, et une rondache; et se tournant vers les siens, Avouez, leur dit-il, chers compagnons de mes chaînes et de ma liberté, que la fortune vient de bonne grâce se réconcilier avec nous.
Nous auons crû que pour nous continuer les teſmoignages de ſa haine, elle nous vouloit reduire a la neceſſité de nous deffendre;	Nous avons crû que pour nous continuer les témoignages de sa haine, elle nous voulait réduire à la nécessité de nous défendre;
& voila que pour nous faire paroiſtre ſon amitié, elle nous conuie à la deffence des autres.	et voilà que pour nous faire paraître son amitié, elle nous convie à la défense des autres.
Que chacun reçoiue comme il doit, ſes premieres faueurs;	Que chacun reçoive comme il doit, ses premières faveurs;
& puis qu’ordinairement elle eſt amoureuſe des des grands courages, monſtrons en ceſte occaſion, que c’eſt auec iuſtice qu’elle veut auoir de l’amour pour nous.	et puis qu’ordinairement elle est amoureuse des des grands courages, montrons en cette occasion, que c’est avec justice qu’elle veut avoir de l’amour pour nous.
Il mit la main à l'eſpée en finiſſant ce diſcours, & commanda à ſes canoniers de ne point tirer que les ennemis n’euſſent fait leur deſcharge.	Il mit la main à l’épée en finissant ce discours, et commanda à ses canonniers de ne point tirer que les ennemis n’eussent fait leur décharge.
Mais ces inconnus, au lieu de fondre tout à la fois ſur ſon vaiſſeau, s’ouurirent à droict & à gauche;	Mais ces inconnus, au lieu de fondre tout à la fois sur son vaisseau, s’ouvrirent à droit et à gauche;
& firent bien voir qu’ils n’auoient autre deſſein que de ſuiure la proye qui leur eſtoit eſchappée.	et firent bien voir qu’ils n’avaient autre dessein que de suivre la proie qui leur était échappée.
Le beau Turc ne fut pas ſatisfait de ceſte déclaration.	Le beau Turc ne fut pas satisfait de cette déclaration.
Il fit auancer ſon vaiſſeau, & alla comme fermer le chemin à celuy des ennemis, qui eſtoit & le plus grand & le plus auancé.	Il fit avancer son vaisseau, et alla comme fermer le chemin à celui des ennemis, qui était et le plus grand et le plus avancé.
Auant qu’il l’euſt ioint, il vit paroiſtre ſur la poupe vn homme armé de toutes pièces, qui par ſon action teſmoignoit bien certainement qu’il n’eſtoit pas vn homme ordinaire.	Avant qu’il l’eût joint, il vit paraître sur la poupe un homme armé de toutes pièces, qui par son action témoignait bien certainement qu’il n’était pas un homme ordinaire.
Si toſt qu’il crût que le Turc le pouuoit oüir;	Si tôt qu’il crut que le Turc le pouvait ouïr;
Ie t’ay reſpecté, luy dit-il, pource que ie t’ay crû ſubiect d’Alcidiane.	Je t’ai respecté, lui dit-il, pource que je t’ai cru sujet d’Alcidiane.
Mais tes habits me font voir que ie me ſuis trompé.	Mais tes habits me font voir que je me suis trompé.
Qui és tu donc, adiouſtat’il, qui foible comme tu és, ozes prendre la deffence des autres, & la prendre ſans ſçauoir ſi tu le peux faire auec iuſtice?	Qui es-tu donc, ajouta-t-il, qui faible comme tu es, oses prendre la défense des autres, et la prendre sans savoir si tu le peux faire avec justice?
La voix de l'affligé qui crie, reſpondit le Turc, & qui demande ſecours contre la violance de ſes perſecuteurs, eſt toujours accompagnée de iuſtice.	La voix de l’affligé qui crie, répondit le Turc, et qui demande secours contre la violence de ses persécuteurs, est toujours accompagnée de justice.
Mais d’où vient, continua-t’il, que connoiſſant ſi bien la Iuſtice, tu la pratiques ſi mal;	Mais d’où vient, continua-t-il, que connaissant si bien la Justice, tu la pratiques si mal;
& veux exercer ſur les foibles, la tyrannie que la force te conſeille?	et veux exercer sur les faibles, la tyrannie que la force te conseille?
Ie donne tes iniures à ta generoſité, luy repliqua l’autre, & ſerois bien aiſe, ſi i’en auois le loiſir, d’apprendre qui tu és.	Je donne tes injures à ta générosité, lui répliqua l’autre, et serais bien aise, si j’en avais le loisir, d’apprendre qui tu es.
Ce ſera pour vne autre fois.	Ce sera pour une autre fois.
Cepandant ne m’arreſtes pas dauantage, ſi tu n’as deſſein de t'expoſer aux violances que tu me reproches.	Cependant ne m’arrêtes pas davantage, si tu n’as dessein de t’exposer aux violences que tu me reproches.
Le beau Turc piqué de ces menaces, & tout enflammé de cette belle ardeur que la gloire allume dans les ieunes courages.	Le beau Turc piqué de ces menaces, et tout enflammé de cette belle ardeur que la gloire allume dans les jeunes courages.
Non, non, dit-il, ie ne puis abandonner les mal-heureux que le Ciel m’ordonne de proteger.	Non, non, dit-il, je ne puis abandonner les malheureux que le Ciel m’ordonne de protéger.
Deſormais ie luy ſuis reſponſable de leurs libertez & de leurs vies.	Désormais je lui suis responsable de leurs libertés et de leurs vies.
Ne croy pas auſſi que ie te quitte, que ie ne ſois aſſuré que tu ne le ſuiuras plus.	Ne crois pas aussi que je te quitte, que je ne sois assuré que tu ne le suivras plus.
Au reſte, apprend que les menaces audacieuſes n’eſpouuantent iamais ceux qui ſçauent comme il faut en chaſtier les autheurs.	Au reste, apprend que les menaces audacieuses n’épouvantent jamais ceux qui savent comme il faut en châtier les auteurs.
Ta reſolution eſt belle, reprit l’autre, mais s’il eſt vray que tes actions reſpondent à la magnificence de tes paroles, n’employe point d’autre bras que le tien pour faire ce glorieux chaſtiment;	Ta résolution est belle, reprit l’autre, mais s’il est vrai que tes actions répondent à la magnificence de tes paroles, n’emploie point d’autre bras que le tien pour faire ce glorieux châtiment;
& commande à tes compagnons d’eſtre ſpectateurs de noſtre combat.	et commande à tes compagnons d’être spectateurs de notre combat.
Ie te promets que non ſeulement ceux qui ſont auec moy, mais ceux auſſi qui me ſuiuent, obſerueront exactement l’ordre que ie leur auray preſcript.	Je te promets que non seulement ceux qui sont avec moi, mais ceux aussi qui me suivent, observeront exactement l’ordre que je leur aurai prescrit.
Le ieune Turc, au lieu de luy reſpondre, ſe tourna vers ſes gens, & pour les obliger à mettre les armes bas, Mes compagnons, leur dit-il, vous auez oüy la propoſition de l’ennemy.	Le jeune Turc, au lieu de lui répondre, se tourna vers ses gens, et pour les obliger à mettre les armes bas, Mes compagnons, leur dit-il, vous avez ouï la proposition de l’ennemi.
Acceptez-la ſi vous m’aimez;	Acceptez-la si vous m’aimez;
& ſouffrez que ie vous dérobe vne partie de la gloire que vous euſſiez acquiſe en ce combat.	et souffrez que je vous dérobe une partie de la gloire que vous eussiez acquise en ce combat.
Ces Turcs poſſible bien contents de ceſte priere, obeïrent diligemment à la volonté de leur Chef.	Ces Turcs possible bien contents de cette prière, obéirent diligemment à la volonté de leur Chef.
Luy s'adreſſant à celuy auquel il deuoit auoir à faire;	Lui s’adressant à celui auquel il devait avoir à faire;
Que tardons nous, luy dit-il.	Que tardons nous, lui dit-il.
Voila mes amis en l’eſtat que tu les deſires.	Voilà mes amis en l’état que tu les désires.
En diſant cela, il s’auance pour frapper le premier.	En disant cela, il s’avance pour frapper le premier.
Mais il fut preuenu, & receut vn ſi peſant coup ſur ſon habillement de teſte, qu’il connut par cét eſſay, qu’il auoit trouué vn ennemy tel qu’il l’auoit ſouuant deſiré.	Mais il fut prévenu, et reçut un si pesant coup sur son habillement de tête, qu’il connut par cet essai, qu’il avait trouvé un ennemi tel qu’il l’avait souvent désiré.
Il voulut en meſme temps faire voir ce qu’il valloit, & porta vn coup de toute ſa force à ſon ennemy.	Il voulut en même temps faire voir ce qu’il valait, et porta un coup de toute sa force à son ennemi.
Il le para, & l’ayant paré, frappa derechef le ieune Turc.	Il le para, et l’ayant paré, frappa derechef le jeune Turc.
Ce cœur de Lion ne conſiderant que la victoire, ſe lance de ſon vaiſſeau dans l’autre, & prend ſa reuanche des coups qu’il a reçeus.	Ce cœur de Lion ne considérant que la victoire, se lance de son vaisseau dans l’autre, et prend sa revanche des coups qu’il a reçus.
Il pare;	Il pare;
il preſſe;	il presse;
il frappe;	il frappe;
il ioint l’adreſſe à la force, & taſte ſon ennemy par tout où il croit le trouuer deſarmé.	il joint l’adresse à la force, et tâte son ennemi par tout où il croit le trouver désarmé.
L’autre qui eſt bien aiſe d’auoir trouué vn ſi vaillant aduerſaire, l’eſpargne;	L’autre qui est bien aise d’avoir trouvé un si vaillant adversaire, l’épargne;
& ne luy fait ſentir la peſanteur de ſon bras, qu’autant qu’il y eſt obligé par la neceſſité de vaincre.	et ne lui fait sentir la pesanteur de son bras, qu’autant qu’il y est obligé par la nécessité de vaincre.
Mais ayant laiſſé tomber ſon eſpée ſur la teſte du beau Turc, plus lourdement qu’il ne vouloit, il le fit chanceler;	Mais ayant laissé tomber son épée sur la tête du beau Turc, plus lourdement qu’il ne voulait, il le fit chanceler;
& le força de mettre vn genoüil ſur le plancher.	et le força de mettre un genou sur le plancher.
Cét eſpouuantable coup ayant eſté vu de tous les ſpectateurs;	Cet épouvantable coup ayant été vu de tous les spectateurs;
les vns paſlirent, & les autres par vne indiſcretion de perſonnes trop zelées, crierent que Polexandre eſtoit touſiours ſans pareil, & touſiours victorieux.	les uns pâlirent, et les autres par une indiscrétion de personnes trop zélées, crièrent que Polexandre était toujours sans pareil, et toujours victorieux.
A peine le ieune Turc eut oüy le nom de Polexandre, qu’il ietta ſon eſpée & ſa rondache;	À peine le jeune Turc eut ouï le nom de Polexandre, qu’il jeta son épée et sa rondache;
& ſe vint luy meſme ietter aux pieds de ſon ennemy.	et se vint lui même jeter aux pieds de son ennemi.
Polexandre fut ſurpris de ceſte action, mais il le fut beaucoup plus lors que le ieune Turc ayant oſté ſon caſque;	Polexandre fut surpris de ceste action, mais il le fut beaucoup plus lorsque le jeune Turc ayant osté son casque;
Ouy, luy dit-il, Polexandre eſt touſiours ſans pareil;	Oui, lui dit-il, Polexandre est toujours sans pareil;
eſt touſiours victorieux; & le temeraire Iphidamante eſt trop honoré d’eſtre vaincu par vn bras qui peut vaincre tout le monde.	est toujours victorieux; et le téméraire Iphidamante est trop honoré d’être vaincu par un bras qui peut vaincre tout le monde.
Seigneur, adiouſta-t’il, vous voyez à vos piés cét Iphidamante, qui ſe nommeroit le plus mal-heureux des hommes, s’il n’auoit le bon-heur d’eſtre voſtre frere.	Seigneur, ajouta-t’il, vous voyez à vos pieds cet Iphidamante, qui se nommerait le plus malheureux des hommes, s’il n’avait le bonheur d’être votre frère.
Iphidamante mon frere?	Iphidamante mon frère?
reprit Polexandre.	reprit Polexandre.
Cela ne peut eſtre.	Cela ne peut être.
Iphidamante eſt mort il y a long temps.	Iphidamante est mort il y a longtemps.
Vn homme de fort bonne mine interuenant à ce diſcours, Sire, dit-il à Polexandre, apres auoir bien conſideré le ieune Turc;	Un homme de fort bonne mine intervenant à ce discours, Sire, dit-il à Polexandre, après avoir bien considéré le jeune Turc;
le Prince Iphidamate n'eſt pas mort comme la Reine voſtre mere à voulu vous faire accroire.	le Prince Iphidamate n’est pas mort comme la Reine votre mère à voulu vous faire accroire.
Il fut donné au Sultan Baiazet pour la rançon du Roy voſtre pere.	Il fut donné au Sultan Bajazet pour la rançon du Roi votre père.
quoy donc, s’eſcria Polexandre, c’eſt icy cét Iphidamante que i’ay tant pleuré?	quoi donc, s’écria Polexandre, c’est ici cet Iphidamante que j’ai tant pleuré?
Ha! mon cher frere, que voſtre rencontre m’eſt chere.	Ha! mon cher frère, que votre rencontre m’est chère.
Mais il ne faut pas s’il vous plaiſt, que nous laiſſions eſchapper le vaiſſeau que vous m’auez empeſché de prendre.	Mais il ne faut pas s’il vous plaît, que nous laissions échapper le vaisseau que vous m’avez empêché de prendre.
Si ie le pers, vous perdrez Polexandre le iour meſme que vous le recouurez.	Si je le perds, vous perdrez Polexandre le jour même que vous le recouvrez.
Allons apres.	Allons après.
Il eſt à Alcidiane, & le Pilote qui le conduit, eſt le ſeul qui ſçait la route par laquelle on peut arriuer à l’iſle de ceſte belle Princeſſe.	Il est à Alcidiane, et le Pilote qui le conduit, est le seul qui sait la route par laquelle on peut arriver à l’île de cette belle Princesse.
Iphidamante extrémement faſché d’eſtre cauſe du deſplaiſir de Polexandre;	Iphidamante extrêmement fâché d’être cause du déplaisir de Polexandre;
luy demanda pardon de la faute qu’il auoit faite;	lui demanda pardon de la faute qu’il avait faite;
& oyant ſouſpirer ce Prince qui le tenoit embraſſé;	et oyant soupirer ce Prince qui le tenait embrassé;
Ie fay vœu, luy dit-il, de ne prendre iamais de repos que vous n’ayez recouuert ce que mon indiſcretion vous a fait perdre.	Je fais vœu, lui dit-il, de ne prendre jamais de repos que vous n’ayez recouvert ce que mon indiscrétion vous a fait perdre.
Polexandre le preſſant contre ſa iouë;	Polexandre le pressant contre sa joue;
Mon cher frere, luy reſpondit-il, ie ne refuſe pas ton aſſiſtance.	Mon cher frère, lui répondit-il, je ne refuse pas ton assistance.
Mais ie crains qu’elle ne me vienne trop tard.	Mais je crains qu’elle ne me vienne trop tard.
En diſant cela, il fit commandement que ſes vaiſſeaux allaſſent apres celui d’Alcidiane.	En disant cela, il fit commandement que ses vaisseaux allassent après celui d’Alcidiane.
Ils partirent tous en meſme temps;	Ils partirent tous en même temps;
& celuy d’Iphidamante auec les autres.	et celui d’Iphidamante avec les autres.
Cepandant Polexandre ayant tiré à part ſon frere, & celuy qui eſtoit entré en leur premiere conuerſation;	Cependant Polexandre ayant tiré à part son frère, et celui qui était entré en leur première conversation;
apprit toutes les fortunes que ce beau Prince auoit couruës à la Cour du Grand Seigneur, & l’occaſion qui l’auoit obligé d’abandonner vn Empire où il ne deuoit pas moins eſperer que la premiere place apres le Souuerain.	apprit toutes les fortunes que ce beau Prince avait courues à la Cour du Grand Seigneur, et l’occasion qui l’avait obligé d’abandonner un Empire où il ne devait pas moins espérer que la première place après le Souverain.
Tout à coup, l’impatiance & le deſplaiſir de Polexandre eſclattant;	Tout à coup, l’impatience et le déplaisir de Polexandre éclatant;
indubitablement, dit-il, nous perdrons le vaiſſeau d’Alcidiane.	indubitablement, dit-il, nous perdrons le vaisseau d’Alcidiane.
Faites vne choſe, qui poſſible reüſſira, adiouſta-t’il s’adreſſant à Iphidamante.	Faites une chose, qui possible réussira, ajouta-t-il s’adressant à Iphidamante.
Rentrez dans voſtre nauire, & allez ſeul apres Lyncée.	Rentrez dans votre navire, et allez seul après Lyncée.
Ie m’imagine que pour reconnoiſſance de la faueur qu’il a receuë de vous;	Je m’imagine que pour reconnaissance de la faveur qu’il a reçue de vous;
il vous attendra ſi vous venez à le deſcouurir.	il vous attendra si vous venez à le découvrir.
Ie ne le pourſuis que pour le rendre heureux auſſi bien que moy.	Je ne le poursuis que pour le rendre heureux aussi bien que moi.
Ie ne penſe pas que vous puiſſiez trouuer à redire a vn deſir ſi innocent.	Je ne pense pas que vous puissiez trouver à redire à un désir si innocent.
Iphidamante ayant conſenty à la volonté de Polexandre, r’entra dans ſon vaiſſeau;	Iphidamante ayant consenti à la volonté de Polexandre, rentra dans son vaisseau;
& rencontra le Muët qu’il auoit ſauué de la mer, qui luy fit entendre par ſignes, qu’il vouloit paſſer dans le vaiſſeau de Polexandre.	et rencontra le Muet qu’il avait sauvé de la mer, qui lui fit entendre par signes, qu’il voulait passer dans le vaisseau de Polexandre.
Il ne luy en demanda point la raiſon, pource que c’euſt eſté perdre ſon temps;	Il ne lui en demanda point la raison, pource que c’eût été perdre son temps;
& l’ayant contenté, prit le coſté de l’iſle de Fer qui regarde le Septentrion.	et l’ayant contenté, prit le côté de l’île de Fer qui regarde le Septentrion.
Polexandre ſingla de l’autre coſté; & comme il vouloit commander quelque choſe aux ſiens;	Polexandre singla de l’autre côté; et comme il voulait commander quelque chose aux siens;
il apperceut le Muët en l’action d’vn homme, que la cholere & la douleur tranſportent.	il aperçut le Muet en l’action d’un homme, que la colère et la douleur transportent.
Il luy demanda le ſujet de ſon agitation.	Il lui demanda le sujet de son agitation.
Mais le Muët tournant la teſte d’vn autre coſté, luy preſenta dédaigneuſement la plus petite de ſes riches boiſtes.	Mais le Muet tournant la tête d’un autre côté, lui présenta dédaigneusement la plus petite de ses riches boîtes.
Polexandre n’eut pas pluſtoſt regardé ceſte boiſte qu’il la reconnut;	Polexandre n’eut pas plus tôt regardé cette boîte qu’il la reconnut;
& la prenant auec ardeur, l’ouurit auec encore plus d'inquietude.	et la prenant avec ardeur, l’ouvrit avec encore plus d’inquiétude.
Si toſt quil y vit le beau pourtraict qui y eſtoit enfermé;	Sitôt qu'il y vit le beau portrait qui y était enfermé;
ô! vniques & glorieuſes reliques de mon bon-heur paſſé, dit-il, cher treſor, que ie recouure apres vne ſi longue perte, eſt-ce pour faire reuiure mes eſperances que le Ciel permet que ie vous reuoye?	ô! uniques et glorieuses reliques de mon bonheur passé, dit-il, cher trésor, que je recouvre après une si longue perte, est-ce pour faire revivre mes espérances que le Ciel permet que je vous revoie?
Il me ſemble, ô belle peinture, que vous me reſpondez que mes felicitez retournent auec vous.	Il me semble, ô belle peinture, que vous me répondez que mes félicités retournent avec vous.
Ie vous croy preſque auſſi fermement que ſi Alcidiane m’en aſſuroit de ſa bouche meſme;	Je vous crois presque aussi fermement que si Alcidiane m’en assurait de sa bouche même;
& vous veux conſulter deſormais, comme l’Ourſe fatale, par qui ie me promets de paruenir vn iour à l’iſle inacceſſible.	et vous veux consulter désormais, comme l’Ourse fatale, par qui je me promets de parvenir un jour à l’île inaccessible.
Apres auoir eſté fort long temps attaché ſur ce pourtraict, il repenſa aux moyens d’en recouurer l’original.	Après avoir été fort longtemps attaché sur ce portrait, il repensa aux moyens d’en recouvrer l’original.
Ayant donc fait de grands remerciemens au dédaigneux Muët;	Ayant donc fait de grands remerciements au dédaigneux Muet;
& fait prendre diverſes routes à ſes ſix vaiſſeaux, il demeura ſeul, & fut ſi heureux que le troiſieſme iour, il deſcouurit le nauire d’Alcidiane.	et fait prendre diverses routes à ses six vaisseaux, il demeura seul, et fut si heureux que le troisième jour, il découvrit le navire d’Alcidiane.
Il luy donna deux iours la chaſſe, & faillit à le ioindre entre l’iſle de Teneriffe & la grand' Canarie.	Il lui donna deux jours la chasse, et faillit à le joindre entre l’île de Ténériffe et la grande Canarie.
Mais le fameux Lyncée adiouſtant par ſon art vne nouuelle viſteſſe à ſon vaiſſeau qui eſtoit excellent voilier, eut touſiours de l'aduantage ſur le peſant nauire de Polexandre, & & à la faueur de la nuict & du vent, il ſe déroba tout à fait à ſa veuë.	Mais le fameux Lyncée ajoutant par son art une nouvelle vitesse à son vaisseau qui était excellent voilier, eut toujours de l’avantage sur le pesant navire de Polexandre, et et à la faveur de la nuit et du vent, il se déroba tout à fait à sa vue.
Polexandre deſeſperé de ce mauuais ſuccez, s’en print à la fortune, au vent, à la mer, & quelquefois meſme à Iphidamante.	Polexandre désespéré de ce mauvais succès, s’en prit à la fortune, au vent, à la mer, et quelquefois même à Iphidamante.
Mais eſtant tous quatre eſgalement ſours pour luy, ils ne reſpondoient ny à ſes iniures ny à ſes prieres.	Mais étant tous quatre également sourds pour lui, ils ne répondaient ni à ses injures ni à ses prières.
Il eſt vray qu’Iphidamante contribuoit tous ſes ſoins & tout ſon eſprit au contentement de ſon frere.	Il est vrai qu’Iphidamante contribuait tous ses soins et tout son esprit au contentement de son frère.
Il viſita les ports de toutes les Canaries, & emporté par ſon affection auſſi violemment que par l’orage;	Il visita les ports de toutes les Canaries, et emporté par son affection aussi violemment que par l’orage;
il courut iuſqu’à la veuë des coſtes de Maroc, & ne ſongea point aux ſuplices que l’on y auoit preparez pour luy & pour ſes cõpagnons.	il courut jusqu’à la vue des côtes de Maroc, et ne songea point aux supplices que l’on y avait préparés pour lui et pour ses compagnons.
Tandis qu’il s’oublie ainſi luy meſme, & ſemble meſpriſer vn threſor qui luy a touſiours eſté plus cher que la vie;	Tandis qu’il s’oublie ainsi lui même, et semble mépriser un trésor qui lui a toujours été plus cher que la vie;
ſes matelots découurent aſſez loin en mer cinq ou ſix carauelles, & l’aſſurent qu’infailliblement ce ſont des carauelles de Maroc.	ses matelots découvrent assez loin en mer cinq ou six caravelles, et l’assurent qu’infailliblement ce sont des caravelles de Maroc.
Ces vaiſſeaux vinrent à toutes voiles ſur luy;	Ces vaisseaux vinrent à toutes voiles sur lui;
& l’obligerent de ſortir des penſées qui l’auoient preſque touſiours occupé depuis qu’il auoit quitté Polexandre.	et l’obligèrent de sortir des pensées qui l’avaient presque toujours occupé depuis qu’il avait quitté Polexandre.
Il fit changer de route à ſon vaiſſeau pour contenter ceux qui s’eſtoient embarquez auecque luy;	Il fit changer de route à son vaisseau pour contenter ceux qui s’étaient embarqués avec lui;
& bien que ſon grand courage ne fuſt pas d’accord auecque ſa preuoyance;	et bien que son grand courage ne fût pas d’accord avec sa prévoyance;
il ayma toutefois mieux ſe donner en proye à cette honte ſecrette & à ce reproche interieur, que d'expoſer ſes compagnons au hazard de perdre la vie ou de ſouffrir vne ſeconde ſeruitude.	il aima toutefois mieux se donner en proie à cette honte secrète et à ce reproche intérieur, que d’exposer ses compagnons au hasard de perdre la vie ou de souffrir une seconde servitude.
Cependant il eſtoit arreſté par vn decret irreuocable qu’ils retomberoient encore vn coup entre les mains des Maures, & d’effet au point du iour, il ſe viret enuelopez de leurs vaiſſeaux.	Cependant il était arrêté par un décret irrévocable qu’ils retomberaient encore un coup entre les mains des Maures, et d’effet au point du jour, ils se virent enveloppés de leurs vaisseaux.
Les Maures s’approcherent d’eux ſans tirer, & monſtrerent par là ou qu’ils auoient peur de les perdre dans la fumée des canonnades, où pluſtoſt qu’ils auoient reſolu de les prendre vifs.	Les Maures s’approchèrent d’eux sans tirer, et montrèrent par là ou qu’ils avaient peur de les perdre dans la fumée des canonnades, où plutôt qu’ils avaient résolu de les prendre vifs.
Iphidamante eſſaya de r'aſſurer ſes ſoldats par vne ſeconde harangue, & voulut leur perſuader que cette nouuelle occaſion ne leur ſeroit pas plus perilleuſe que la première.	Iphidamante essaya de rassurer ses soldats par une seconde harangue, et voulut leur persuader que cette nouvelle occasion ne leur serait pas plus périlleuse que la première.
Mais eux qui ſe voyoient enfermez de toutes parts, & qui par tout oyoient retentir le nom d’Ennoramita, & ceux d’Abdelmelec, & de Mahomet;	Mais eux qui se voyaient enfermés de toutes parts, et qui partout oyaient retentir le nom d’Ennoramita, et ceux d’Abdelmélec, et de Mahomet;
ne l’écoutoient plus, & ne ſongeoient qu’aux moyens d’euiter par vne prompte mort, les longs & horribles ſupplices qui leur ſembloient inéuitabies.	ne l’écoutaient plus, et ne songeaient qu’aux moyens d’éviter par une prompte mort, les longs et horribles supplices qui leur semblaient inévitables.
Ils iugerent qu’il n’y en auoit point de meilleur que de ſe faire tous tüer dãs le combat, & pour cette ſeule raiſon ayans pris leurs armes & teſmoigné qu’ils vouloient ſe deffendre;	Ils jugèrent qu’il n’y en avait point de meilleur que de se faire tous tuer dans le combat, et pour cette seule raison ayant pris leurs armes et témoigné qu’ils voulaient se défendre;
ils firent par vn pur deſeſpoir ce que ny le ſentiment de l’honneur, ny l’eloquence de leur Capitaine n’euſſent iamais exigé de leur ames eſtonnées.	ils firent par un pur désespoir ce que ni le sentiment de l’honneur, ni l’éloquence de leur Capitaine n’eussent jamais exigé de leur âmes étonnées.
Cette reſolution priſe, les pilotes preſenterent aux Maures l'vn & l'autre coſté de leur vaiſſeau, & les canonniers firent leurs deſcharges auecque vn ſi grand effet que des premieres volées de canon, vne carauelle ennemie coula à fonds, & l’autre fut miſe hors de combat.	Cette résolution prise, les pilotes présentèrent aux Maures l’un et l’autre côté de leur vaisseau, et les canonniers firent leurs décharges avec un si grand effet que des premières volées de canon, une caravelle ennemie coula à fond, et l’autre fut mise hors de combat.
Ceux qui eſtoiẽt ſur les autres, ne voulans pas demeurer dans vne diſcretion qui leur eſtoit ſi deſauantageuſe; firent ouyr leur canon, & tous enſemble fondirent ſur le vaiſſeau d’Iphidamante.	Ceux qui étaient sur les autres, ne voulant pas demeurer dans une discrétion qui leur était si désavantageuse; firent ouïr leur canon, et tous ensemble fondirent sur le vaisseau d’Iphidamante.
Le combat fut long & ſanglant, & bien que ce ieune Heros portaſt la mort & l’effroy par tout où la cõſeruatiõ des ſiẽs l’appelloit;	Le combat fut long et sanglant, et bien que ce jeune Héros portât la mort et l’effroi partout où la conservation des siens l’appelait;
il fut toutefois cõtraint de ceder au nõbre;	il fut toutefois contraint de céder au nombre;
& de voir lier ce bras victorieux qui auoit rompu les cheſnes de tant d’eſclaues.	et de voir lier ce bras victorieux qui avait rompu les chaînes de tant d’esclaves.
Les belles paroles de ſes vainqueurs, & les aſſurances qu’ils luy donnerent des triomphes qu’on luy preparoit à Maroc;	Les belles paroles de ses vainqueurs, et les assurances qu’ils lui donnèrent des triomphes qu’on lui préparait à Maroc;
ne calmerent point cette hardie & genereuſe douleur auecque laquelle il ſe plaignoit de l’inconſtance de la Fortune.	ne calmèrent point cette hardie et généreuse douleur avec laquelle il se plaignait de l’inconstance de la Fortune.
Il ſe reſolut toutefois à ſouffrir les plus cruels ſupplices, & cõuia meſme les Maures de le mener le plus viſte qu’ils pourroient au Roy leur maiſtre.	Il se résolut toutefois à souffrir les plus cruels supplices, et convia même les Maures de le mener le plus vite qu’ils pourraient au Roi leur maître.
Ces Maures ne luy reſpondirent rien, pource qu’ils entendirent crier aux armes, & peu apres deſcouurirent vn grand vaiſſeau qui meſpriſant le nombre des ennemis venoit orgueilleuſement les attaquer.	Ces Maures ne lui répondirent rien, pource qu’ils entendirent crier aux armes, et peu après découvrirent un grand vaisseau qui méprisant le nombre des ennemis venait orgueilleusement les attaquer.
Si iamais voyageant en Afrique quelqu’vn a vû vne grande & furieuſe lyonne ſe ietter ſur des chaſſeurs, & apres en auoir mis vne partie en pieces, arracher d’entre les mains des autres le lyonçeau qu’ils luy auoient volé;	Si jamais voyageant en Afrique quelqu’un a vu une grande et furieuse lionne se jeter sur des chasseurs, et après en avoir mis une partie en pièces, arracher d’entre les mains des autres le lionceau qu’ils lui avaient volé;
il peut ſe repreſenter l’horreur & le ſuccez de ce dernier combat.	il peut se représenter l’horreur et le succès de ce dernier combat.
D'abord deux des quatres vaiſſeaux vainqueurs changent de deſtin.	D’abord deux des quatre vaisseaux vainqueurs changent de destin.
Le canon des derniers venus les met en pièces, & leur Capitaine ſautant de ſon nauire dans l’vn de ceux qui reſtoient aux Maures, renuerſe & tüe quicõque oze l’attendre.	Le canon des derniers venus les met en pièces, et leur Capitaine sautant de son navire dans l’un de ceux qui restaient aux Maures, renverse et tue quiconque ose l’attendre.
Il entaſſe les morts les vns ſur les autres, paſſe iuſqu’au vaiſſeau d’Iphidamante & le voyant lié & gardé par pluſieurs, eſcarte cette trouppe, en tuë vne partie, & contraint l’autre de ſe ietter dãs la mer.	Il entasse les morts les uns sur les autres, passe jusqu’au vaisseau d’Iphidamante et le voyant lié et gardé par plusieurs, écarte cette troupe, en tue une partie, et contraint l’autre de se jeter dans la mer.
Iphidamante ne voulut pas deuoir tout ſon ſalut à ce nouueau vainqueur.	Iphidamante ne voulut pas devoir tout son salut à ce nouveau vainqueur.
Si toſt qu’il ſe vit ſans gardes, il prit vne eſpée que quelqu’vn auoit laiſſée aupres de luy, & bien qu’il fuſt ſi eſtroittement lié qu’il ne pût ſe deffaire les mains, il ne laiſſa pas de frapper ſur les Maures.	Sitôt qu’il se vit sans gardes, il prit une épée que quelqu’un avait laissée auprès de lui, et bien qu’il fût si étroitement lié qu’il ne pût se défaire les mains, il ne laissa pas de frapper sur les Maures.
Son liberateur luy oſta ſes cordes & teſmoignant de l’impatience en ſa victoire; allons mon frere, luy dit-il, allõs chaſtier la temerité de ces barbares qui ſemblent n’eſtre armez que pour s'oppoſer à nos deſſeins.	Son libérateur lui ôta ses cordes et témoignant de l’impatience en sa victoire; allons mon frère, lui dit-il, allons châtier la témérité de ces barbares qui semblent n’être armés que pour s’opposer à nos desseins.
A ces paroles Iphidamante recognoiſſant la voix de Polexandre;	À ces paroles Iphidamante recognoissant la voix de Polexandre;
ie ſuy voſtre bon-heur & voſtre courage luy reſpondit-il, & puis que i'ay voſtre protection, ie defie toute la malice & toute la puiſſance de la Fortune.	je suis votre bonheur et votre courage lui répondit-il, et puisque j’ai votre protection, je défie toute la malice et toute la puissance de la Fortune.
En finiſſant ces paroles il ſe ietta parmy les ennemis pour imiter Polexandre, & non ſeulement les chaſſa de ſon nauire, mais les mena battant dans les leurs auecque vne telle ardeur, qu’il n’en demeura pas vn pour aller à Maroc porter les nouuelles de cette deffaite.	En finissant ces paroles il se jeta parmi les ennemis pour imiter Polexandre, et non seulement les chassa de son navire, mais les mena battant dans les leurs avec une telle ardeur, qu’il n’en demeura pas un pour aller à Maroc porter les nouvelles de cette défaite.
Apres que les deux freres eurẽt par des paroles Chreſtiennes recognû que leur victoire venoit du Ciel;	Après que les deux frères eurent par des paroles Chrétiennes reconnu que leur victoire venait du Ciel;
ils s’embraſſerent pluſieurs fois, & pour teſmoigner combien ils eſtoient dignes de commander, allerent apprendre le nombre de leurs morts & de leurs bleſſez.	ils s’embrassèrent plusieurs fois, et pour témoigner combien ils étaient dignes de commander, allèrent apprendre le nombre de leurs morts et de leurs blessés.
Polexandre en trouua peu des ſiens à dire.	Polexandre en trouva peu des siens à dire.
Son frere en auoit perdu beaucoup plus, mais il ſe conſola par cette raiſon de guerre, que l’on ne peut achetter vne victoire que par l’effuſion de beaucoup de ſang.	Son frère en avait perdu beaucoup plus, mais il se consola par cette raison de guerre, que l’on ne peut acheter une victoire que par l’effusion de beaucoup de sang.
Polexandre luy vouloit demander ce qu’il auoit fait depuis qu’ils s’eſtoient quittez;	Polexandre lui voulait demander ce qu’il avait fait depuis qu’ils s’étaient quittés;
lors que le Müet ſe preſenta deuant luy, non auecque ſa mine furieuſe & triſte comme la premiere fois;	lorsque le Muet se présenta devant lui, non avec sa mine furieuse et triste comme la première fois;
mais auecque vn viſage riant.	mais avec un visage riant.
Il luy monſtra deux grandes playes qu’il auoit au trauers du corps.	Il lui montra deux grandes plaies qu’il avait au travers du corps.
Noſtre Heros eut pitié de le voir en ce mauuais eſtat, & iugeant par ſes bleſſures auecque quel courage il s’eſtoit porté au combat;	Notre Héros eut pitié de le voir en ce mauvais état, et jugeant par ses blessures avec quel courage il s’était porté au combat;
commanda à ſon Chirurgien de le traitter comme luy meſme.	commanda à son Chirurgien de le traiter comme lui-même.
Le Müet ſouſrit oyãt ces paroles;	Le Muet sourit oyant ces paroles;
& au lieu de ſouffrir qu’on viſitaſt ſes playes, il mit aux pieds de Polexandre vn parchemin eſcrit, ſur ce parchemin le grand cœur de diamans dont i’ay deſia parlé:	et au lieu de souffrir qu’on visitât ses plaies, il mit aux pieds de Polexandre un parchemin écrit, sur ce parchemin le grand cœur de diamants dont j’ai déjà parlé:
& à l’inſtant meſme il rendit l’ame auec vne certaine gayeté qui ſembloit monſtrer combien la vie luy eſtoit odieuſe.	et à l’instant même il rendit l’âme avec une certaine gaieté qui semblait montrer combien la vie lui était odieuse.
Polexandre releua le cœur & le velin, & entra auecque ſon frere dans vne chambre tant pour s’eſlogner de l’obiet funeſte du Müet que pour s’entretenir & ſe delaſſer.	Polexandre releva le cœur et le vélin, et entra avec son frère dans une chambre tant pour s’éloigner de l’objet funeste du Muet que pour s’entretenir et se délasser.
Comme ils furent ſeuls Polexandre aprit à ſon frere le mauuais ſuccez de ſon voyage, & par quelle viſible oppoſition de la Fortune, il n’auoit pas arreſté le vaiſſeau de Lyncée.	Comme ils furent seuls Polexandre apprit à son frère le mauvais succès de son voyage, et par quelle visible opposition de la Fortune, il n’avait pas arrêté le vaisseau de Lyncée.
Mais mon cher Iphidamate, adiouſta-t’il, ie me pleins beaucoup moins de cette immortelle ennemye que ie n’auois reſolu, puis qu’en me fermant le lieu bien-heureux ou regne Alcidiane;	Mais mon cher Iphidamate, ajouta-t-il, je me pleins beaucoup moins de cette immortelle ennemie que je n’avais résolu, puisqu’en me fermant le lieu bienheureux où règne Alcidiane;
elle me conduit pour le moins en d’autres, où ie puis voir & ſeruir ce qui m’eſt le plus cher apres cette belle Princeſſe.	elle me conduit pour le moins en d’autres, où je puis voir et servir ce qui m’est le plus cher après cette belle Princesse.
Iphidamãte rẽdit conte à Polexandre, de ce qu’il auoit fait en toutes les Canaries, & luy apprit par quel hazard il eſtoit tombé entre les mains des ſubiets du Roy de Maroc.	Iphidamante rendit compte à Polexandre, de ce qu’il avait fait en toutes les Canaries, et lui apprit par quel hasard il était tombé entre les mains des sujets du Roi de Maroc.
Certes, continua-t’il, ſi vous ne fuſſiez arriué heureuſement pour moy comme vous auez fait;	Certes, continua-t-il, si vous ne fussiez arrivé heureusement pour moi comme vous avez fait;
ie perdois l’eſperance de ſortir iamais des priſons de ce Prince inſenſé.	je perdais l’espérance de sortir jamais des prisons de ce Prince insensé.
Quelque iour ie vous feray le diſcours de tous les ſuiets que ie luy ay donnez de me vouloir mal.	Quelque jour je vous ferai le discours de tous les sujets que je lui ai donnés de me vouloir mal.
A preſent nous penſerons à des choſes qui preſſent dauantage.	À présent nous penserons à des choses qui pressent davantage.
C’eſt bien dit, reprit Polexandre, nous irons donc ſi vous plaiſt, reioindre mes vaiſſeaux à qui i’ay donné rendez-vous à l'Iſle d’Alcidiane.	C’est bien dit, reprit Polexandre, nous irons donc si vous plaît, rejoindre mes vaisseaux à qui j’ai donné rendez-vous à l’Île d’Alcidiane.
I’ay ainſi nommé l’Iſle de Lancerotte depuis que ie l’ay conquiſe.	J’ai ainsi nommé l’Île de Lancerotte depuis que je l’ai conquise.
En meſme temps les deux incomparables freres, firent prendre ceſte route à leurs Pilotes, & eſtant pouſſez d’vn vent extremement fauorable, peu apres perdirent de veuë les coſtes d’Affrique.	En même temps les deux incomparables frères, firent prendre cette route à leurs Pilotes, et étant poussés d’un vent extrêmement favorable, peu après perdirent de vue les côtes d’Afrique.
Polexandre demeura plus de deux heures, comme enſeuely dans ſes reſueries, à la fin il reuint à ſoy;	Polexandre demeura plus de deux heures, comme enseveli dans ses rêveries, à la fin il revint à soi;
& ſe trouuant entre les mains, le cœur & l’eſcrit du Müet;	et se trouvant entre les mains, le cœur et l’écrit du Muet;
voyons, dit-il à Iphidamante, ce que ce pauure hõme m’a laiſſé en mourant.	voyons, dit-il à Iphidamante, ce que ce pauvre homme m’a laissé en mourant.
Il ouurit le parchemin & y lut ces paroles.	Il ouvrit le parchemin et y lut ces paroles.
