Ceux qui s’aduiſerent de donner vn Soleil pour deuiſe au Roy voſtre Pere, auec ce mot, Il n'a point d’Occident pour moy, firent plus qu’ils ne penſoient:	Ceux qui s’avisèrent de donner un Soleil pour devise au Roi votre Père, avec ce mot, Il n’a point d’Occident pour moi, firent plus qu’ils ne pensaient:
parce qu'en repreſentans ſa grandeur qui voit preſque touſiours ce Prince des Aſtres ſur quelqu'vne de ſes terres, ſans interuale de nuict;	parce qu’en représentant sa grandeur qui voit presque toujours ce Prince des Astres sur quelqu’une de ses terres, sans intervalle de nuit;
ils rendirent la deuiſe hereditaire en voſtre Majeſté, preſageans vos vertus, & de plus, la beatitude des François ſous voſtre Auguſte preſence.	ils rendirent la devise héréditaire en votre Majesté, présageant vos vertus, et de plus, la béatitude des Français sous votre Auguste présence.
C'eſt diſie chez voſtre Majeſté, Madame, que la lumiere des vertus n'aura point d’Occident ny cõſequemment l'heur & la felicité de nos Peuples qu'elles eſclairerõt.	C’est dis-je chez votre Majesté, Madame, que la lumière des vertus n’aura point d’Occident ni conséquemment l’heur et la félicité de nos Peuples qu’elles éclaireront.
Or comme vous eſtes en l’Orient de voſtre aage & de vos vertus enſemble, Madame, daigneZ prendre courage d'arriuer en meſme point au midy de luy & d’elles, ie dis de celles qui ne peuuent meurir que par temps & culture:	Or comme vous êtes en l’Orient de votre âge et de vos vertus ensemble, Madame, daignez prendre courage d’arriver en même point au midi de lui et d’elles, je dis de celles qui ne peuvent mûrir que par temps et culture:
car il en eſt quelques vnes des plus recommendables, entre autres la Religion, la charité vers les pauures, la chaſteté & l'amour coniugale, dont vous aueZ touché le midy dés le matin.	car il en est quelques unes des plus recommandables, entre autres la Religion, la charité vers les pauvres, la chasteté et l’amour conjugale, dont vous avez touché le midi dès le matin.
Mais certes il faut le courage requis à cet effort auſsi grand & puiſſant que voſtre Royauté, pour grande & puiſſante qu'elle ſoit:	Mais certes il faut le courage requis à cet effort aussi grand et puissant que votre Royauté, pour grande et puissante qu’elle soit:
les Roys eſtãt battus de ce malheur, que la peſte infernale des flatteurs qui ſe gliſſent dans les Palais, leur rend la vertu & la clair voyance ſa guide & ſa nourrice, d’vn accez infiniment plus difficile qu'aux inferieurs.	les Rois étant battus de ce malheur, que la peste infernale des flatteurs qui se glissent dans les Palais, leur rend la vertu et la clairvoyance sa guide et sa nourrice, d’un accès infiniment plus difficile qu’aux inférieurs.
Ie ne ſcay qu'vn ſeur moyen à vous faire eſperer, d’atteindre ces deux midys en meſme inſtant:	Je ne sais qu’un sûr moyen à vous faire espérer, d’atteindre ces deux midis en même instant:
c'eſt qu’il plaiſe à V.M. ſe ietter viuement ſur les bons liures de prudence & de mœurs:	c’est qu’il plaise à V.M. se jeter vivement sur les bons livres de prudence et de mœurs:
car außi toſt qu'vn Prince s'eſt releué l'eſprit par cet exercice, les flatteurs ſe trouuans les moins fins ne s'oſent plus iouër à luy.	car aussitôt qu’un Prince s’est relevé l’esprit par cet exercice, les flatteurs se trouvant les moins fins ne s’osent plus jouer à lui.
Et ne peuuent communemẽt les Puiſſans & les Roys receuoir inſtruction opportune que des mors:	Et ne peuvent communément les Puissants et les Rois recevoir instruction opportune que des mors:
parce que les viuans eſtans partis en deux bandes, les foux & meſchans, c'eſt à dire ces flateurs dont eſt queſtion ne ſçauent ny veulent bien dire pres d'eux;	parce que les vivants étant partis en deux bandes, les fous et méchants, c’est-à-dire ces flatteurs dont est question ne savent ni veulent bien dire près d’eux;
les ſages gens de bien peuuent & veulent, mais ils n'oſent.	les sages gens de bien peuvent et veulent, mais ils n’osent.
C'eſt en la vertu certes, MADAME, qu'il faut que les perſonnes de voſtre rang cherchent la vraye hauteſſe & la Couronne des Couronnes:	C’est en la vertu certes, MADAME, qu’il faut que les personnes de votre rang cherchent la vraie hautesse et la Couronne des Couronnes:
d'autant qu'ils ont puiſſance & non droit de violer les loix & l'equité, & qu'ils trouuent autant de peril & plus de honte que les autres hommes à faire ce coup.	d’autant qu’ils ont puissance et non droit de violer les lois et l’équité, et qu’ils trouvent autant de péril et plus de honte que les autres hommes à faire ce coup.
Außi nous apprend vn grand Roy luy meſme, que toute la gloire de la fille du Roy eſt par dedans.	Aussi nous apprend un grand Roi lui-même, que toute la gloire de la fille du Roi est par dedans.
Quelle eſt cependant ma ruſticité, tous autres abordent leurs Princes Roys en adorant & loüant, i'oſe aborder ma Reyne en preſchant?	Quelle est cependant ma rusticité, tous autres abordent leurs Princes Rois en adorant et louant, j’ose aborder ma Reine en prêchant?
Pardonnez neantmoins à mon Zele, MADAME, qui meurt d'enuie d’ouyr la France crier ce mot, auec applaudiſſement, La lumiere n'a point d’Occident pour moy, par tout ou paſſera voſtre MAIESTE' nouueau Soleil des vertus:	Pardonnez néanmoins à mon Zèle, MADAME, qui meurt d’envie d’ouïr la France crier ce mot, avec applaudissement, La lumière n’a point d’Occident pour moi, partout où passera votre MAJESTÉ nouveau Soleil des vertus:
& d’enuie encore de tirer d'elle, ainſi que i'espere de ſes dignes commencement, vne des plus fortes preuues du Traicté que i'offre à ſes pieds, pour maintenir l’egalité des hommes & des femmes.	et d’envie encore de tirer d’elle, ainsi que j’espère de ses dignes commencement, une des plus fortes preuves du Traité que j’offre à ses pieds, pour maintenir l’égalité des hommes et des femmes.
Et non ſeulement veu la grandeur vnique qui vous eſt acquiſe par naiſſance & par mariage, vous ſeruirez de miroir au ſexe & de ſuiet d’emulation aux hommes encore, en l'eſtẽduë de l'Vniuers, ſi vous vous esleueZ au prix & merite que ie vo9 propoſe:	Et non seulement vu la grandeur unique qui vous est acquise par naissance et par mariage, vous servirez de miroir au sexe et de sujet d’émulation aux hommes encore, en l’étendue de l’Univers, si vous vous élevez au prix et mérite que je vous propose:
mais außi toſt, MADAME, que vous aurez pris reſolution de vouloir luyre de ce bel & precieux eſclat, on croira que tout le meſme ſexe eſclaire en la ſplendeur de vos rayons.	mais aussitôt, MADAME, que vous aurez pris résolution de vouloir luire de ce bel et précieux éclat, on croira que tout le même sexe éclaire en la splendeur de vos rayons.
Ie ſuis de voſtre Maieſté	Je suis de votre Majesté
MADAME, Tres-humble & Tres-obeiſſante ſeruante & ſubjecte.	MADAME, Très humble et Très obéissante servante et sujette.
EGALITE' DES HOMMES ET DES FEMMES.	ÉGALITÉ DES HOMMES ET DES FEMMES.
LA pluſpart de ceux qui prennẽt la cauſe, des femmes, contre cette orgueilleuſe preferance que les hommes s’attribuent, leur rendent le change entier:	LA plupart de ceux qui prennent la cause, des femmes, contre cette orgueilleuse préférence que les hommes s’attribuent, leur rendent le change entier:
r’enuoyans la preferance vers elles.	renvoyant la préférence vers elles.
Moy qui fuys toutes extremitez, ie me contente de les eſgaler aux hommes:	Moi qui fuis toutes extrémités, je me contente de les égaler aux hommes:
la nature s’oppoſant pour ce regard autant à la ſuperiorité qu’à l’inferiorité.	la nature s’opposant pour ce regard autant à la supériorité qu’à l’infériorité.
Que diſ-je, il ne ſuffit pas à quelques gens de leur preferer le ſexe maſculin, s’ils ne les confinoient encores d’vn arreſt irrefragable & neceſſaire à la quenoüille, ouy meſme à la quenouille ſeule.	Que dis-je, il ne suffit pas à quelques gens de leur préférer le sexe masculin, s’ils ne les confinaient encore d’un arrêt irréfragable et nécessaire à la quenouille, oui même à la quenouille seule.
Mais ce qui les peut conſoler contre ce meſpris, c’eſt qu’il ne ſe faict que par ceux d’entre les hommes auſquels elles voudroient moins reſſembler:	Mais ce qui les peut consoler contre ce mépris, c’est qu’il ne se fait que par ceux d’entre les hommes auxquels elles voudraient moins ressembler:
perſonnes à donner vray ſemblance aux reproches qu’on pourroit voſmir ſur le ſexe feminin, s’ils en eſtoient, & qui ſentent en leur cœur ne ſe pouuoir recommãder que par le credit de l’autre.	personnes à donner vraisemblance aux reproches qu’on pourrait vomir sur le sexe féminin, s’ils en étaient, et qui sentent en leur cœur ne se pouvoir recommander que par le crédit de l’autre.
D’autant qu’ils ont ouy trompetter par les ruës, que les femmes manquent de dignité, manquent auſſi de ſuffiſance, voire du temperament & des organes pour arriuer à cette-cy, leur eloquence triomphe à preſcher ces maximes:	D’autant qu’ils ont ouï trompeter par les rues, que les femmes manquent de dignité, manquent aussi de suffisance, voire du tempérament et des organes pour arriver à celle-ci, leur éloquence triomphe à prêcher ces maximes:
& tant plus opulemment, de ce que, dignité, ſuffiſance, organes & temperament ſont beaux mots:	et tant plus opulemment, de ce que, dignité, suffisance, organes et tempérament sont beaux mots:
n’ayans pas appris d’autre part, que la premiere qualité d’vn mal habill’homme, c'eſt de cautionner les choſes ſoubs la foy populaire & par ouyr dire.	n’ayant pas appris d’autre part, que la première qualité d’un mal habile homme, c’est de cautionner les choses sous la foi populaire et par ouïr-dire.
Voyez tels eſprits comparer ces deux ſexes:	Voyez tels esprits comparer ces deux sexes:
la plus haute ſuffiſance à leur aduis où les femmes puiſſent arriuer, c’eſt de reſſembler le commun des hommes:	la plus haute suffisance à leur avis où les femmes puissent arriver, c’est de ressembler le commun des hommes:
autant eſlongnez d’imaginer, qu’vne grande femme ſe peuſt dire grandhomme, le ſexe chãge, que de conſentir qu’vn homme ſe peuſt eſleuer à l’eſtage d’vn Dieu.	autant éloigné d’imaginer, qu’une grande femme se pût dire grand homme, le sexe changé, que de consentir qu’un homme se pût élever à l’étage d’un Dieu.
Gens plus braues qu’Hercules vrayement, qui ne desfit que douze monſtres en douze combats;	Gens plus braves qu’Hercule vraiment, qui ne défit que douze monstres en douze combats;
tandis que d’vne ſeule parolle ils desfont la moitié du Monde.	tandis que d’une seule parole ils défont la moitié du Monde.
Qui croira cependant, que ceux qui ſe ueulent eſleuer & fortifier de la foibleſſe d’autruy, ſe puiſſent eſleuer ou fortifier de leur propre force?	Qui croira cependant, que ceux qui se veulent élever et fortifier de la faiblesse d’autrui, se puissent élever ou fortifier de leur propre force?
Et le bon eſt, qu’ils penſent eſtre quittes de leur effronterie à vilipender ce ſexe, vſants d’vne effronterie pareille à ſe loüer & ſe dorer eux meſmes, ie dis par fois en particulier comme en general, voire à quelque tort que ce ſoit:	Et le bon est, qu’ils pensent être quittes de leur effronterie à vilipender ce sexe, usant d’une effronterie pareille à se louer et se dorer eux-mêmes, je dis parfois en particulier comme en général, voire à quelque tort que ce soit:
comme ſi la verité de leur vãterie receuoit meſure & qualité de ſon impudence.	comme si la vérité de leur vanterie recevait mesure et qualité de son impudence.
Et Dieu ſçait ſi ie congnois de ces ioyeux vanteurs, & dont les vanteries ſont tantoſt paſſées en prouerbe, entre les plus eſchauffez au meſpris des femmes.	Et Dieu sait si je connais de ces joyeux vanteurs, et dont les vanteries sont tantôt passées en proverbe, entre les plus échauffés au mépris des femmes.
Mais quoy, s’ils prennent droict d’eſtre galans & ſuffiſans hommes, de ce qu’ils ſe déclarent tels cõme par Edict;	Mais quoi, s’ils prennent droit d’être galants et suffisants hommes, de ce qu’ils se déclarent tels comme par Édit;
pourquoy n’abeſtiront ils les femmes par le contrepied d’vn autre Edict?	pourquoi n’abêtiront-ils les femmes par le contrepied d’un autre Édit?
Et ſi ie iuge bien, ſoit de la dignité, ſoit de la capacité des dames, ie ne pretends pas à cette heure de le prouuer par raiſons, puiſque les opiniaſtres les pouroient debattre, ny par exemples, d’autant qu’ils ſont trop cõmuns;	Et si je juge bien, soit de la dignité, soit de la capacité des dames, je ne prétends pas à cette heure de le prouver par raisons, puisque les opiniâtres les pourraient débattre, ni par exemples, d’autant qu’ils sont trop communs;
ains ſeulement par l’aucthorité de Dieu meſme, des arcſboutans de ſon Egliſe & de ces grands hommes qui ont ſeruy de lumiere à l’Vniuers.	ains seulement par l’autorité de Dieu même, des arcs-boutants de son Église et de ces grands hommes qui ont servi de lumière à l’Univers.
Rengeons ces glorieux teſmoins en teſte, & reſeruons Dieu, puis les Saincts Peres de ſon Egliſe, au fonds, comme le treſor.	Rangeons ces glorieux témoins en tête, et réservons Dieu, puis les Saints Pères de son Église, au fond, comme le trésor.
Platon à qui nul n’a debattu le tiltre de diuin, & conſequemment Socrates ſon interprete & Protecole en ſes Eſcripts;	Platon à qui nul n’a débattu le titre de divin, et conséquemment Socrate son interprète et Protocole en ses Écrits;
(s’il n’eſt là meſme celuy de Socrates, ſon plus diuin Precepteur) leur aſſignent meſmes droicts, facultez & functions, en leurs Republiques & par tout ailleurs.	(s’il n’est là même celui de Socrate, son plus divin Précepteur) leur assignent mêmes droits, facultés et fonctions, en leurs Républiques et partout ailleurs.
Les maintiennent, en outre, auoir ſurpaſſé maintefois tous les hommes de leur Patrie:	Les maintiennent, en outre, avoir surpassé maintes fois tous les hommes de leur Patrie:
comme en effect elles ont inuenté partie des plus beaux arts, ont excellé, voire enſeigné cathedralement & ſouuerainement ſur tous les hommes en toutes ſortes de perfections & vertus, dans les plus fameuſes villes antiques entre autres Alexandrie, premiere de l’Empire apres Rome.	comme en effet elles ont inventé partie des plus beaux arts, ont excellé, voire enseigné cathédralement et souverainement sur tous les hommes en toutes sortes de perfections et vertus, dans les plus fameuses villes antiques entre autres Alexandrie, première de l’Empire après Rome.
Dont il eſt arriué que ces deux Philoſophes, miracles de Nature, ont creu dõner plus de luſtre à des diſcours de grand poix, s’ils les prononçoient en leurs liures par la bouche de Diotime & d’Aſpaſie:	Dont il est arrivé que ces deux Philosophes, miracles de Nature, ont cru donner plus de lustre à des discours de grand poids, s’ils les prononçaient en leurs livres par la bouche de Diotime et d’Aspasie:
Diotime que ce dernierne craint point d’appeller ſa maiſtreſſe & Preceptrice, en quelques vnes des plus hautes ſciences, luy Precepteur & maiſtre du genre humain.	Diotime que ce dernier ne craint point d’appeler sa maîtresse et Préceptrice, en quelques unes des plus hautes sciences, lui Précepteur et maître du genre humain.
Ce que Theodoret releue ſi volontiers en l’Oraiſon de la Foy, ce me ſemble;	Ce que Théodoret relève si volontiers en l’Oraison de la Foi, ce me semble;
qu’il paroiſt bien que l’opinion fauorable au ſexe luy eſtoit fort plauſible.	qu’il paraît bien que l’opinion favorable au sexe lui était fort plausible.
Apres tous ces teſmoignages de Socrates, ſur le faict des dames;	Après tous ces témoignages de Socrate, sur le fait des dames;
on void aſſez que s’il lache quelque mot au Sympoſe de Xenophon contre leur prudence, à comparaiſon de celle des hommes, il les regarde ſelon l’ignorance & l’inexperience où elles ſont nourries, ou bien au pis aller en general, laisſant lieu frequent & ſpatieux aux exceptions:	on voit assez que s’il lâche quelque mot au Sympose de Xénophon contre leur prudence, à comparaison de celle des hommes, il les regarde selon l’ignorance et l’inexpérience où elles sont nourries, ou bien au pis aller en général, laissant lieu fréquent et spacieux aux exceptions:
à quoy les deuiſeurs dont eſt queſtion ne s’entendent point.	à quoi les deviseurs dont est question ne s’entendent point.
Que ſi les dames arriuẽt moins ſouuẽt que les hõmes, aux degrez d’excellence, c’eſt merueille que le deffaut de bonne inſtructiõ, voire l’affluẽce de la mauuaiſe expreſſe & profeſſoire ne face pis, les gardant d’y pouuoir arriuer du tout.	Que si les dames arrivent moins souvent que les hommes, aux degrés d’excellence, c’est merveille que le défaut de bonne instruction, voire l’affluence de la mauvaise expresse et professoire ne fasse pis, les gardant d’y pouvoir arriver du tout.
Se trouue til plus de difference des hommes à elles que d’elles à elles meſmes, ſelon l’inſtitution qu’elles ont prinſe, ſelon qu’elles ſont eſleuées en ville où village, ou ſelon les Nations?	Se trouve-t-il plus de différence des hommes à elles que d’elles à elles-mêmes, selon l’institution qu’elles ont prise, selon qu’elles sont élevées en ville ou village, ou selon les Nations?
Et pourquoy leur inſtitution ou nourriture aux affaires & Lettres à l’égal des hommes, ne rempliroit elle ce vuide, qui paroiſt ordinairement entre les teſtes des meſmes hommes & les leurs:	Et pourquoi leur institution ou nourriture aux affaires et Lettres à l’égal des hommes, ne remplirait-elle ce vide, qui paraît ordinairement entre les têtes des mêmes hommes et les leurs:
puis que la nourriture eſt de telle importance qu’vn de ſes membres ſeulement, c’eſt à dire le commerce du monde, abondant aux Françoiſes & aux Angloiſes, & manquant aux Italiennes, celles cy ſont de gros en gros de ſi loing ſurpaſſées par celles là?	puisque la nourriture est de telle importance qu’un de ses membres seulement, c’est-à-dire le commerce du monde, abondant aux Françaises et aux Anglaises, et manquant aux Italiennes, celles-ci sont de gros en gros de si loin surpassées par celles-là?
Ie dis de gros en gros, car en detail les dames d’Italie triumphent par fois:	Je dis de gros en gros, car en détail les dames d’Italie triomphent parfois:
& nous en auons tiré deux Reynes à la prudence deſquelles la France a trop d’obligation.	et nous en avons tiré deux Reines à la prudence desquelles la France a trop d’obligation.
Pourquoy vrayment la nourriture ne frapperoit elle ce coup, de remplir la diſtance qui ſe void entre les entendemens des hommes & des femmes;	Pourquoi vraiment la nourriture ne frapperait-elle ce coup, de remplir la distance qui se voit entre les entendements des hommes et des femmes;
veu qu'en cet exemple icy le moins ſurmonte le plus, par l’aſſiſtance d’vne ſeule de ſes parcelles, ie dis ce cõmerce & conuerſatiõ:	vu qu’en cet exemple ici le moins surmonte le plus, par l’assistance d’une seule de ses parcelles, je dis ce commerce et conversation:
l’air des Italiẽnes eſtant plus ſubtil & propre à ſubtilizer les eſprits, comme il paroiſt en ceux de leurs hommes, confrontez communement contre ceux là des François & des Anglois?	l’air des Italiennes étant plus subtil et propre à subtiliser les esprits, comme il paraît en ceux de leurs hommes, confrontés communément contre ceux-là des Français et des Anglais?
Plutarque au Traicté des vertueux faicts des femmes maintient;	Plutarque au Traité des vertueux faits des femmes maintient;
que la vertu de l’homme & de la femme eſt meſme choſe.	que la vertu de l’homme et de la femme est même chose.
Seneque d’autre part publie aux Conſolations;	Sénèque d’autre part publie aux Consolations;
qu’il faut croire que la Nature n’a point traicté les dames ingratement, ou reſtrainct & racourcy leurs vertus & leurs eſprits, plus que les vertus & les eſprits des hõmes:	qu’il faut croire que la Nature n’a point traité les dames ingratement, ou restreint et raccourci leurs vertus et leurs esprits, plus que les vertus et les esprits des hommes:
mais qu’elle les a doüées de pareille vigueur & de pareille faculté à toute choſe honeſte & loüable.	mais qu’elle les a douées de pareille vigueur et de pareille faculté à toute chose honnête et louable.
Voyons ce qu’en iuge apres ces deux, le tiers chef du Triũuirat de la ſageſſe humaine & morale en ſes Eſſais.	Voyons ce qu’en juge après ces deux, le tiers chef du Triumvirat de la sagesse humaine et morale en ses Essais.
Il luy ſemble, dit il, & ſi ne ſçait pourquoy, qu’il ſe trouue rarement des femmes dignes de commander aux hommes.	Il lui semble, dit-il, et si ne sait pourquoi, qu’il se trouve rarement des femmes dignes de commander aux hommes.
N'eſt ce pas les mettre en particulier à l'egale contrebalance des hommes, & confeſſer, que s’il ne les y met en general il craint d’auoir tort:	N’est ce pas les mettre en particulier à l’égale contrebalance des hommes, et confesser, que s’il ne les y met en général il craint d’avoir tort:
bien qu’il peuſt excuſer ſa reſtrinction, ſur la pauure & diſgraciée nourriture de ce ſexe.	bien qu’il pût excuser sa restriction, sur la pauvre et disgraciée nourriture de ce sexe.
N’oubliant pas au reſte d’alleguer & releuer en autre lieu de ſon meſme liure, cette authorité que Platon leur depart en ſa Republique:	N’oubliant pas au reste d’alléguer et relever en autre lieu de son même livre, cette autorité que Platon leur départ en sa République:
& qu’Anthiſtenes nioit toute difference au talent & en la vertu des deux ſexes.	et qu’Anthistène niait toute différence au talent et en la vertu des deux sexes.
Quant au Philoſophe Ariſtote, puiſque remuant Ciel & terre, il n’a point contredit en gros, que ie ſcache, l’opinion qui fauoriſe les dames, il l’a confirmée:	Quant au Philosophe Aristote, puisque remuant Ciel et terre, il n’a point contredit en gros, que je sache, l’opinion qui favorise les dames, il l’a confirmée:
s'en rapportant, sans doubte, aux ſentences de ſon pere & grand pere ſpirituels, Socrates & Platõ, comme à choſe conſtante & fixe ſoubs le credit de tels perſonnages:	s’en rapportant, sans doute, aux sentences de son père et grand-père spirituels, Socrate et Platon, comme à chose constante et fixe sous le crédit de tels personnages:
par la bouche deſquels il faut aduoüer que le genre humain tout entier, & la raiſon meſme, ont prononcé leur arreſt.	par la bouche desquels il faut avouer que le genre humain tout entier, et la raison même, ont prononcé leur arrêt.
Eſt il beſoing d’alleguer infinis autres anciens & modernes de nom illuſtre, ou parmy ces derniers, Eraſme, Politien, Agripa, ny cet honneſte & pertinent Precepteur des courtizans:	Est-il besoin d’alléguer infinis autres anciens et modernes de nom illustre, ou parmi ces derniers, Érasme, Politien, Agrippa, ni cet honnête et pertinent Précepteur des courtisans:
outre tant de fameux Poëtes ſi contrepoinctez tous enſemble aux meſpriſeurs du ſexe feminin, & ſi partiſans de ſes aduantages aptitude & diſpoſition à tout office tout exercice loüable & digne?	outre tant de fameux Poètes si contrepointés tous ensemble aux mépriseurs du sexe féminin, et si partisans de ses avantages aptitude et disposition à tout office tout exercice louable et digne?
Les dames en verité ſe conſolent, que ces deſcrieurs de leur merite ne ſe peuuent prouuer habiles gens, ſi tous ces eſprits le ſont:	Les dames en vérité se consolent, que ces décrieurs de leur mérite ne se peuvent prouver habiles gens, si tous ces esprits le sont:
& qu'vn homme fin ne dira pas, encores qu’il le creuſt, que le merite & paſſedroit du ſexe feminin tire court, pres celuy du maſculin;	et qu’un homme fin ne dira pas, encore qu’il le crût, que le mérite et passe-droit du sexe féminin tire court, près celui du masculin;
iuſques à ce que par arreſt il ait faict declarer tous ceux là buffles, affin d’infirmer leur teſmoignage ſi contraire à tel decry.	jusqu’à ce que par arrêt il ait fait déclarer tous ceux-là buffles, afin d’infirmer leur témoignage si contraire à tel décri.
Et buffles faudroit il encores declarer des Peuples entiers & des plus ſublins, entre autres ceux de Smyrne en Tacitus: qui pour obtenir iadis à Rome preſſeãce de nobleſſe ſur leurs voiſins, allegoient eſtre deſcendus, ou de Tantalus fils de Iupiter ou de Theſeus petit fils de Neptune ou d’vne Amazone, laquelle par ce moyen ils contrepeſoient à ces Dieux.	Et buffles faudrait-il encore déclarer des Peuples entiers et des plus sublins, entre autres ceux de Smyrne en Tacite: qui pour obtenir jadis à Rome préséance de noblesse sur leurs voisins, alléguaient être descendus, ou de Tantale fils de Jupiter ou de Thésée petit-fils de Neptune ou d’une Amazone, laquelle par ce moyen ils contrepesaient à ces Dieux.
Pour le regard de la loy Salique, qui priue les femmes de la couronne, elle n’a lieu qu’en France.	Pour le regard de la loi Salique, qui prive les femmes de la couronne, elle n’a lieu qu’en France.
Et fut inuẽtée au temps de Pharamond, pour la ſeulle conſideration des guerres contre l’Empire duquel nos Peres ſecoüoient le ioug:	Et fut inventée au temps de Pharamond, pour la seule considération des guerres contre l’Empire duquel nos Pères secouaient le joug:
le ſexe feminin eſtant vray ſemblablement d’vn corps moins propre aux armes, par la neceſſité du port & nourriture des enfans.	le sexe féminin étant vraisemblablement d’un corps moins propre aux armes, par la nécessité du port et nourriture des enfants.
Il faut rémarquer encores neantmoins, que les Pairs de France ayans eſté créez en premiere intention comme vne eſpece de perſonniers des Roys, ainſi que leur nom le declare:	Il faut remarquer encore néanmoins, que les Pairs de France ayant été créés en première intention comme une espèce de parçonniers des Rois, ainsi que leur nom le déclare:
les dames Pairaiſſes de leur chef ont ſeance, priuilege & voix deliberatiue par tout où les Pairs en ont & de meſme eſtenduë.	les dames Pairesses de leur chef ont séance, privilège et voix délibérative partout où les Pairs en ont et de même étendue.
Comme auſſi les Lacedemoniens ce braue & genereux Peuple, conſultoit de toutes affaires priuées & publiques auec ſes femmes.	Comme aussi les Lacédémoniens ce brave et généreux Peuple, consultait de toutes affaires privées et publiques avec ses femmes.
Bien a ſeruy cependant aux François, de trouuer l’inuention des Regentes, pour vn equiualent des Roys;	Bien a servi cependant aux Français, de trouver l’invention des Régentes, pour un équivalent des Rois;
car ſans cela combien y a il que leur Eſtat fuſt par terre?	car sans cela combien y a-t-il que leur État fût par terre?
Nous ſçaurions bien dire auiourd’huy par eſpreuue, quelle neceſſité les minoritez des Roys ont de cette recepte.	Nous saurions bien dire aujourd’hui par épreuve, quelle nécessité les minorités des Rois ont de cette recette.
Les Germains ces belliqueux Peuples, dit Tacitus, qui apres plus de deux cens ans de guerre, furent pluſtoſt triumphéz que vaincus;	Les Germains ces belliqueux Peuples, dit Tacitus, qui après plus de deux cents ans de guerre, furent plutôt triomphés que vaincus;
portoient dot à leurs femmes, non au rebours.	portaient dot à leurs femmes, non au rebours.
Ils auoient au ſurplus des Nations, qui n’eſtoient iamais regies que par ce ſexe.	Ils avaient au surplus des Nations, qui n’étaient jamais régies que par ce sexe.
Et quand Ænée preſente à Didon le ſceptre d’Ilione, les ſcoliaſtes diſent, que cela prouient, de ce que les dames filles aiſnées, telle qu’eſtoit cette Princeſſe, regnoient anciennement aux maiſons Royalles.	Et quand Énée présente à Didon le sceptre d’Ilion, les scholiastes disent, que cela provient, de ce que les dames filles aînées, telle qu’était cette Princesse, régnaient anciennement aux maisons Royales.
Veult-on deux plus beaux enuers à la loy Salique, ſi deux enuers elle peut ſouffrir?	Veut-on deux plus beaux envers à la loi Salique, si deux envers elle peut souffrir?
Si ne meſpriſoient pas les femmes nos anciens Gaulois, ny les Carthaginois auſſi;	Si ne méprisaient pas les femmes nos anciens Gaulois, ni les Carthaginois aussi;
lors qu’eſtans vnis en l’armée d’Hanibal pour paſſer les Alpes, ils eſtablirent les dames Gauloiſes arbitres de leurs differends.	lors qu’étant unis en l’armée d’Hannibal pour passer les Alpes, ils établirent les dames Gauloises arbitres de leurs différends.
Et quand les hommes deſroberoient à ce ſexe en pluſieurs lieux, part aux meilleurs aduantages;	Et quand les hommes déroberaient à ce sexe en plusieurs lieux, part aux meilleurs avantages;
l’inegalité des forces corporelles plus que des ſpirituelles, ou du merite, peut facilement eſtre cauſe du larrecin & de ſa ſouffrance:	l’inégalité des forces corporelles plus que des spirituelles, ou du mérite, peut facilement être cause du larcin et de sa souffrance:
forces corporelles, qui ſont vertus ſi baſſes, que la beſte en tient plus par deſſus l’homme, que l’homme par deſſus la femme.	forces corporelles, qui sont vertus si basses, que la bête en tient plus par-dessus l’homme, que l’homme par-dessus la femme.
Et ſi ce meſme Hiſtoriographe Latin nous apprend, qu’où la force regne, l'equité, la probité, la modeſtie meſme, ſont les attributs du vainqueur; s’eſtonnera-on, que la ſuffiſance & les merites en general, ſoient ceux de nos hommes, priuatiuement aux femmes.	Et si ce même Historiographe Latin nous apprend, qu’où la force règne, l’équité, la probité, la modestie même, sont les attributs du vainqueur; s’étonnera-t-on, que la suffisance et les mérites en général, soient ceux de nos hommes, privativement aux femmes.
Au ſurplus l’animal humain n'eſt homme ny femme, à le bien prendre, les ſexes eſtants faicts non ſimplement, mais ſecundum quid, comme parle l’Eſchole:	Au surplus l’animal humain n’est homme ni femme, à le bien prendre, les sexes étant faits non simplement, mais secundum quid, comme parle l’École:
c’eſt à dire pour la ſeule propagation.	c’est à dire pour la seule propagation.
L’vnique forme & difference de cet animal, ne conſiſte qu’en l’ame humaine.	L’unique forme et différence de cet animal, ne consiste qu’en l’âme humaine.
Et s’il eſt permis de rire en paſſãt, le quolibet ne ſera pas hors de ſaisõ, nous apprenant;	Et s’il est permis de rire en passant, le quolibet ne sera pas hors de saison, nous apprenant;
qu’il n’eſt rien plus ſemblable au chat ſur vne feneſtre, que la chatte.	qu’il n’est rien plus semblable au chat sur une fenêtre, que la chatte.
L’homme & la femme ſont tellement vns, que ſi l’homme eſt plus que la femme, la femme eſt plus que l’homme.	L’homme et la femme sont tellement uns, que si l’homme est plus que la femme, la femme est plus que l’homme.
L’homme fut créé maſle & femelle, dit l’Eſcriture, ne comptant ces deux que pour vn.	L’homme fut créé mâle et femelle, dit l’Écriture, ne comptant ces deux que pour un.
Dont Ieſus-Chriſt eſt appellé fils de l’homme, bien qu’il ne le ſoit que de la femme.	Dont Jésus-Christ est appelé fils de l’homme, bien qu’il ne le soit que de la femme.
Ainſi parle apres le grãd Sainct Baſile:	Ainsi parle après le grand Saint Basile:
La vertu de l’homme & de la femme eſt meſme choſe, puis que Dieu leur a decerné meſme creation & meſme honneur:	La vertu de l’homme et de la femme est même chose, puisque Dieu leur a décerné même création et même honneur:
maſculum & fœmininam fecit eos.	masculum et fœmininam fecit eos.
Or en ceux de qui la Nature eſt vne & meſme, il faut que les actions auſſi le ſoient, & que l’eſtime & loyer en ſuitte ſoient pareils, où les œuures ſont pareilles.	Or en ceux de qui la Nature est une et même, il faut que les actions aussi le soient, et que l’estime et loyer ensuite soient pareils, où les œuvres sont pareilles.
Voila donc la depoſition de ce puiſſant pilier, & venerable teſmoing de l’Egliſe, Il n'eſt pas mauuais de ſe ſouuenir ſur ce poinct, que certains ergotiſtes anciens, ont paſſé iuſques à cette niaiſe arrogance, de debattre au ſexe feminin l’image de Dieu a difference de l’homme:	Voilà donc la déposition de ce puissant pilier, et vénérable témoin de l’Église, Il n’est pas mauvais de se souvenir sur ce point, que certains ergotistes anciens, ont passé jusqu’à cette niaise arrogance, de débattre au sexe féminin l’image de Dieu à différence de l’homme:
laquelle image ils deuoient, ſelon ce calcul attacher à la barbe.	laquelle image ils devaient, selon ce calcul attacher à la barbe.
Il failloit de plus & par conſequent, deſnier aux femmes l’image de l’homme, ne pouuant luy reſſembler, ſans qu’elles reſſemblaſſent à celuy auquel il reſſemble.	Il fallait de plus et par conséquent, dénier aux femmes l’image de l’homme, ne pouvant lui ressembler, sans qu’elles ressemblassent à celui auquel il ressemble.
Dieu meſme leur à departy les dons de Prophetie indifferamment auec les hommes, les ayant eſtablies auſſi pour Iuges, inſtructrices & conductrices de ſon Peuple fidelle en paix & en guerre:	Dieu même leur a départi les dons de Prophétie indifféremment avec les hommes, les ayant établies aussi pour Juges, instructrices et conductrices de son Peuple fidèle en paix et en guerre:
& qui plus eſt, rendu triumphantes auec luy des hautes victoires, qu’elles ont auſſi maintefois emportées & arborées en diuers lieux du Monde:	et qui plus est, rendu triomphantes avec lui des hautes victoires, qu’elles ont aussi maintes fois emportées et arborées en divers lieux du Monde:
mais ſur quelles gens, à voſtre aduis?	mais sur quelles gens, à votre avis?
Cyrus & Theſeus:	Cyrus et Thésée:
à ces deux on adiouſte Hercules, lequel elles ont ſinon vaincu, du moins bien battu.	à ces deux on ajoute Hercule, lequel elles ont sinon vaincu, du moins bien battu.
Auſſi fut la cheute de Pentaſilée, couronnemẽt de la gloire d’Achilles:	Aussi fut la chute de Pentasilée, couronnement de la gloire d’Achille:
oyez Seneque & Ronſard parlans de luy.	oyez Sénèque et Ronsard parlant de lui.
Ont elles au ſurplus, (ce mot par occaſion) moins excellé de foy, qui comprend toutes les vertus principales, que de ſuffiſance & de force magnanime & guerriere?	Ont elles au surplus, (ce mot par occasion) moins excellé de foi, qui comprend toutes les vertus principales, que de suffisance et de force magnanime et guerrière?
Paterculus nous apprend, qu’aux proſcription Romaines, la fidelité des enfãs fut nulle, des affranchis legere, des femmes treſgrande.	Paterculus nous apprend, qu’aux proscription Romaines, la fidélité des enfants fut nulle, des affranchis légère, des femmes très grande.
Que ſi Sainct Paul, ſuyuãt ma route des teſmoignages ſaincts, leur deffend le miniſtere & leur commande le ſilence en l’Egliſe:	Que si Saint Paul, suivant ma route des témoignages saints, leur défend le ministère et leur commande le silence en l’Église:
il eſt euident que ce n’eſt point par aucun meſpris:	il est évident que ce n’est point par aucun mépris:
ouy bien ſeulement, de crainte qu’elles n’eſmeuuent les tentations, par cette montre ſi claire & publique qu’il faudroit faire en miniſtrant & preſchant, de ce qu’elles ont de grace & de beauté plus que les hommes.	oui bien seulement, de crainte qu’elles n’émeuvent les tentations, par cette montre si claire et publique qu’il faudrait faire en ministrant et prêchant, de ce qu’elles ont de grâce et de beauté plus que les hommes.
Ie dis que l’exemption de meſpris eſt euidente, puiſque cet Apoſtre parle de Theſbé comme de ſa coadiutrice en l’œuure de noſtre Seigneur, ſans toucher le grand credit de Saincte Petronille vers ſainct Pierre:	Je dis que l’exemption de mépris est évidente, puisque cet Apôtre parle de Thesbé comme de sa coadjutrice en l’œuvre de notre Seigneur, sans toucher le grand crédit de Sainte Pétronille vers saint Pierre:
& puis auſſi que la Magdeleine eſt nommée en l’Egliſe égale aux Apoſtres, par Apoſtolis.	et puis aussi que la Madeleine est nommée en l’Église égale aux Apôtres, par Apostolis.
Entre autres au Calendrier des Grecs, publié par Genebrard.	Entre autres au Calendrier des Grecs, publié par Génébrard.
Voire que l’Egliſe & eux-meſmes ont permis vne exception de ceſte reigle de ſilence pour elle, qui preſcha trente ans en la Baume de Marſeille au rapport de toute la Prouence.	Voire que l’Église et eux-mêmes ont permis une exception de cette règle de silence pour elle, qui prêcha trente ans en la Baume de Marseille au rapport de toute la Provence.
Et ſi quelqu'vn impugne ce teſmoignage de predications, on luy demandera que faiſoient les Sibyles, ſinon preſcher l'Vniuers par diuine inſpiration, ſur l’euenement futur de Ieſus-Chriſt?	Et si quelqu’un impugne ce témoignage de prédications, on lui demandera que faisaient les Sibylles, sinon prêcher l’Univers par divine inspiration, sur l’événement futur de Jésus-Christ?
Toutes les anciennes Nations cõcedoient la Preſtriſe aux femes, indifféremment auec les hommes.	Toutes les anciennes Nations concédaient la Prêtrise aux femmes, indifféremment avec les hommes.
Et les Chreſtiens ſont au moins forcez de conſentir, qu’elles ſoyent capables d’appliquer le Sacrement de Bapteſme: mais quelle faculté de diſtribuer les autres leur peut eſtre iuſtement deniée;	Et les Chrétiens sont au moins forcés de consentir, qu’elles soient capables d’appliquer le Sacrement de Baptême: mais quelle faculté de distribuer les autres leur peut être justement déniée;
ſi celle de diſtribuer ceſtuy-là, leur eſt iuſtement accordé De dire que la neceſſité des petits enfãs mourãs, ait forcé les Peres anciens d’eſtablir cet vſage en deſpit d’eux:	si celle de distribuer celui-là, leur est justement accordé? De dire que la nécessité des petits enfants mourants, ait forcé les Pères anciens d’établir cet usage en dépit d’eux:
il eſt certain qu’ils n’auroient iamais creu que la neceſſité les peuſt diſpenſer de mal faire, iuſques aux termes de permettre violer & diffamer l’application d’vn Sacrement.	il est certain qu’ils n’auraient jamais cru que la nécessité les pût dispenser de mal faire, jusqu’aux termes de permettre violer et diffamer l’application d’un Sacrement.
Et partant concedans ceſte faculté de diſtribution aux femmes, on void à clair qu’ils ne les ont interdites de diſtribuer les autres Sacremẽs, que pour maintenir touſiours plus entiere l’auctorité des hommes;	Et partant concédant cette faculté de distribution aux femmes, on voit à clair qu’ils ne les ont interdites de distribuer les autres Sacrements, que pour maintenir toujours plus entière l’autorité des hommes;
ſoit pour eſtre de leur ſexe, ſoit afin qu’à droit ou à tort, la paix fuſt plus aſſeurée entre les deux ſexes, par la foibleſſe & rauallement de l’vn.	soit pour être de leur sexe, soit afin qu’à droit ou à tort, la paix fût plus assurée entre les deux sexes, par la faiblesse et ravalement de l’un.
Certes ſainct Ieroſme eſcrit ſagement à noſtre propos; qu’en matiere du ſeruice de Dieu, l’eſprit & la doctrine doiuent eſtre conſiderez, non le ſexe.	Certes saint Jérôme écrit sagement à notre propos; qu’en matière du service de Dieu, l’esprit et la doctrine doivent être considérés, non le sexe.
Sentence qu’on doit generaliſer, pour permettre aux Dames à plus forte raiſon, toute action & ſciẽce honneſte:	Sentence qu’on doit généraliser, pour permettre aux Dames à plus forte raison, toute action et science honnête:
& cela ſuyuant auſſi les intentions du meſme ſainct, qui de ſa part honnore & auctoriſe bien fort leur ſexe.	et cela suivant aussi les intentions du même saint, qui de sa part honore et autorise bien fort leur sexe.
Dauantage ſainct Iean l’Aigle & le plus chery des Euangeliſtes, ne meſpriſoit pas les fẽmes, non plus que ſainct Pierre, ſainct Paul & ces deux Peres, i’entends ſaint Baſile & ſainct Ieroſme;	Davantage saint Jean l’Aigle et le plus chéri des Évangélistes, ne méprisait pas les femmes, non plus que saint Pierre, saint Paul et ces deux Pères, j’entends saint Basile et saint Jérôme;
puis qu’il leur addreſſe ſes Epiſtres particulieremẽt:	puisqu’il leur adresse ses Épîtres particulièrement:
ſans parler d’infinis autres Ss: ou Peres, qui ſont pareille addreſſe de leurs Eſcrits.	sans parler d’infinis autres Saints ou Pères, qui font pareille adresse de leurs Écrits.
Quand au faict de Iudith ie n’en daignerois faire mention s’il eſtoit particulier, cela s'appelle dependant du mouuement & volonté de ſon auctrice:	Quant au fait de Judith je n’en daignerais faire mention s’il était particulier, cela s’appelle dépendant du mouvement et volonté de son autrice:
non plus que ie ne parle des autres de ce qualibre;	non plus que je ne parle des autres de ce calibre;
bien qu’ils ſoient immenſes en quantité, comme ils ſont autant heroiques en qualité de toutes ſortes, que ceux qui couronnent les plus illuſtres hommes.	bien qu’ils soient immenses en quantité, comme ils sont autant héroïques en qualité de toutes sortes, que ceux qui couronnent les plus illustres hommes.
Ie n’enregiſtre point les faicts priuez, de crainte qu’ils ſemblent, non aduantages & dons du ſexe, ains boüillons d’vne vigueur priuée & ſpecialle.	Je n’enregistre point les faits privés, de crainte qu’ils semblent, non avantages et dons du sexe, ains bouillons d’une vigueur privée et spéciale.
Mais celuy de Iudith merite place en ce lieu, parce qu’il eſt bien vray, que ſon deſſein tombant au cœur d’vne ieune dame, entre tant d’hommes laſches & faillis de cœur, à tel beſoing, en ſi haulte & ſi difficile entrepriſe, & pour tel fruict, que le ſalut d’vn Peuple & d’vne Cité fidelle à Dieu: ſemble pluſtoſt eſtre vne inſpiration & prerogatiue diuine vers les femmes, qu'vn traict purement voluntaire.	Mais celui de Judith mérite place en ce lieu, parce qu’il est bien vrai, que son dessein tombant au cœur d’une jeune dame, entre tant d’hommes lâches et faillis de cœur, à tel besoin, en si haute et si difficile entreprise, et pour tel fruit, que le salut d’un Peuple et d’une Cité fidèle à Dieu: semble plutôt être une inspiration et prérogative divine vers les femmes, qu’un trait purement volontaire.
Comme auſſi le ſemble eſtre celuy de la Pucelle d’Orleans, accompagné de meſmes circonſtances enuiron, mais de plus ample & large vtilité, s’eſtendant iuſques au ſalut d’vn grand Royaume & de ſon Prince.	Comme aussi le semble être celui de la Pucelle d’Orléans, accompagné de mêmes circonstances environ, mais de plus ample et large utilité, s’étendant jusqu’au salut d’un grand Royaume et de son Prince.
Adjouſtons que la Magdelene eſt la ſeule ame, à qui le Redempteur ait iamais prononcé ce mot, & promis cette auguſte grace:	Ajoutons que la Madeleine est la seule âme, à qui le Rédempteur ait jamais prononcé ce mot, et promis cette auguste grâce:
En tous lieux où ſe preſchera l’Euangile il ſera parlé de toy.	En tous lieux où se prêchera l’Évangile il sera parlé de toi.
Ieſus-Chriſt d’autrepart, declara ſa tres heureuſe & tres glorieuſe reſurrection aux dames les premieres, affin de les rẽdre, dit vn venerable Pere ancien, Apoſtreſſes aux propres Apoſtres:	Jésus-Christ d’autre part, déclara sa très heureuse et très glorieuse résurrection aux dames les premières, afin de les rendre, dit un vénérable Père ancien, Apôtresses aux propres Apôtres:
cela, cõme lon ſçait, auec miſſion expreſſe:	cela, comme l'on sait, avec mission expresse:
Va, dit il, à cette cy meſme, & recite aux Apoſtres & à Pierre ce que tu as veu.	Va, dit-il, à celle-ci même, et récite aux Apôtres et à Pierre ce que tu as vu.
Surquoy il faut notter, qu’il manifeſta ſa nouuelle naiſſance eſgalement aux femmes qu’aux hommes, en la perſonne d’Anne fille de Phanuel, qui le recongneut en meſme inſtant, que le bon vieillard Sainct Simeon.	Sur quoi il faut noter, qu’il manifesta sa nouvelle naissance également aux femmes qu’aux hommes, en la personne d’Anne fille de Phanuel, qui le reconnut en même instant, que le bon vieillard Saint Siméon.
Laquelle naiſſance, d’abondant, les Sybilles nommées, ont predite ſeules entre les Gentils, excellent priuilege du ſexe feminin. Quel honneur faict aux femmes auſſi, ce ſonge ſuruenu chez Pilate;	Laquelle naissance, d’abondant, les Sibylles nommées, ont prédite seules entre les Gentils, excellent privilège du sexe féminin. Quel honneur fait aux femmes aussi, ce songe survenu chez Pilate;
s’addreſſant à l’vne d’elles priuatiuement à tous les hommes, & en telle & ſi haulte occaſion.	s’adressant à l’une d’elles privativement à tous les hommes, et en telle et si haute occasion.
Et ſi les hommes ſe vantent, que Ieſus-Chriſt ſoit nay de leur ſexe, on reſpond, qu’il le failloit par neceſſaire bien ſceance, ne ſe pouuant pas ſans ſcandale, meſler ieune & à toutes les heures du iour & de la nuict parmy les preſſes, aux fins de conuertir, ſecourir & ſauuer le genre humain, s’il euſt eſté du ſexe des femmes:	Et si les hommes se vantent, que Jésus-Christ soit né de leur sexe, on répond, qu’il le fallait par nécessaire bienséance, ne se pouvant pas sans scandale, mêler jeune et à toutes les heures du jour et de la nuit parmi les presses, aux fins de convertir, secourir et sauver le genre humain, s’il eût été du sexe des femmes:
notamment en face de la malignité des Iuifs.	notamment en face de la malignité des Juifs.
Que ſi quelqu’vn au reſte eſt ſi fade;	Que si quelqu’un au reste est si fade;
d’imaginer maſculin ou feminin en Dieu, bien que ſon nom ſemble ſonner le maſculin, ny conſequemment beſoin d’acception d’vn ſexe pluſtoſt que de l’autre, pour honnorer l’incarnation de ſon fils;	d’imaginer masculin ou féminin en Dieu, bien que son nom semble sonner le masculin, ni conséquemment besoin d’acception d’un sexe plutôt que de l’autre, pour honorer l’incarnation de son fils;
cettuy cy monſtre à plein iour, qu’il eſt auſſi mauuais Philoſophe que Theologien.	celui-ci montre à plein jour, qu’il est aussi mauvais Philosophe que Théologien.
D’ailleurs, l'aduantage qu’ont les hommes par ſon incarnation en leur ſexe; (s’ils en peuuent tirer vn aduantage, veu cette neceſſité remarquée) eſt cõpenſé par ſa conception tres precieuſe au corps d’vne femme, par l’entiere perfection de cette femme, vnique à porter nom de parfaicte entre toutes les creatures purement humaines, depuis la cheute de nos premiers parens, & par ſon aſſumption vnique en ſuiect humain auſſi.	D’ailleurs, l’avantage qu’ont les hommes par son incarnation en leur sexe; (s’ils en peuvent tirer un avantage, vu cette nécessité remarquée) est compensé par sa conception très précieuse au corps d’une femme, par l’entière perfection de cette femme, unique à porter nom de parfaite entre toutes les créatures purement humaines, depuis la chute de nos premiers parents, et par son assomption unique en sujet humain aussi.
Finalement ſi l’Eſcripture a declaré le mary, chef de la femme, la plus grande ſottiſe que l’homme peuſt faire, c’eſt de prendre cela pour paſſedroict de dignité.	Finalement si l’Écriture a déclaré le mari, chef de la femme, la plus grande sottise que l’homme pût faire, c’est de prendre cela pour passe-droit de dignité.
Car veu les exemples, aucthoritez & raiſons nottées en ce diſcours, par où l’égalité des graces & faueurs de Dieu vers les deux eſpeces ou ſexes eſt prouuée, voire leur vnité meſme, & veu que Dieu prononce:	Car vu les exemples, autorités et raisons notées en ce discours, par où l’égalité des grâces et faveurs de Dieu vers les deux espèces ou sexes est prouvée, voire leur unité même, et vu que Dieu prononce:
Les deux ne ſeront qu’vn:	Les deux ne seront qu’un:
& prononcé encores:	et prononcé encore:
L’hõme quittera pere & mere pour ſuiure ſa femme;	L’homme quittera père et mère pour suivre sa femme;
il paroiſt que cette déclaration n’eſt faicte que par le beſoin expres de nourrir paix en mariage.	il paraît que cette déclaration n’est faite que par le besoin exprès de nourrir paix en mariage.
Lequel beſoin requeroit, ſans doubte, qu’vne des parties cédaſt à l’autre, & la preſtance des forces du maſle ne pouuoit pas ſouffrir que la ſoubmiſſiõ veĩt de ſa part.	Lequel besoin requérait, sans doute, qu’une des parties cédât à l’autre, et la prestance des forces du mâle ne pouvait pas souffrir que la soumission vint de sa part.
Et quand bien il ſeroit veritable, ſelon que quelques vns maintiennent, que cette ſoubmiſſion fut imposée à la femme pour chaſtiement du peché de la pomme:	Et quand bien il serait véritable, selon que quelques uns maintiennent, que cette soumission fut imposée à la femme pour châtiment du péché de la pomme:
cela encores eſt bien eſloigné de conclure à la pretendue preferance de dignité en l’homme.	cela encore est bien éloigné de conclure à la prétendue préférence de dignité en l’homme.
Si lon croioit que l’Eſcripture luy commendaſt de ceder à l’homme, comme indigne de le contrecarrer, voyez l’abſurdité qui ſuiuroit:	Si l'on croyait que l’Écriture lui commandât de céder à l’homme, comme indigne de le contrecarrer, voyez l’absurdité qui suivrait:
la femme ſe treuueroit digne d’eſtre faicte à l’image du Createur, de iouyr de la treſſaincte Eucariſtie, des myſteres de la Redemptiõ, du Paradis & de la viſion voire poſſeſſion de Dieu, non pas des aduantages et priuileges de l’homme:	la femme se trouverait digne d’être faite à l’image du Créateur, de jouir de la très sainte Eucharistie, des mystères de la Rédemption, du Paradis et de la vision voire possession de Dieu, non pas des avantages et privilèges de l’homme:
ſeroit ce pas déclarer l’homme plus precieux & releué que telles choſes, & partant commettre le plus grief des blaſphemes?	serait-ce pas déclarer l’homme plus précieux et relevé que telles choses, et partant commettre le plus grief des blasphèmes?
L’IMPRIMEVR A RANGE' ces vers icy pour emplir le reſte de la feuille.	L’IMPRIMEUR A RANGÉ ces vers ici pour emplir le reste de la feuille.
