LECTEVR ſi la Fortune auoit ſoin de ma vie,	LECTEUR si la Fortune avait soin de ma vie,
Au lieu qu'elle eſt touſiours contraire aux beaux eſprits;	Au lieu qu’elle est toujours contraire aux beaux esprits;
Il m'importeroit peu ſi les dents de l'Enuie	Il m’importerait peu si les dents de l’Envie
Oſoient inſolemment déchirer mes eſcrits.	Osaient insolemment déchirer mes écrits.
Pourtant, à ton abord vn doux eſpoir me flate,	Pourtant, à ton abord un doux espoir me flatte,
I'ay fort peu de ſçauoir, auec vn mal de rate;	J’ai fort peu de savoir, avec un mal de rate;
Et par là i'ay beſoin d'oüyr tes ſentimens.	Et par là j’ai besoin d’ouïr tes sentiments.
Car ſelon ton merite, ou ton inſufiſance,	Car selon ton mérite, ou ton insuffisance,
Ou ie profiteray de tes enſeignemens,	Ou je profiterai de tes enseignements,
Ou du moins ie riray de ton impertinance.	Ou du moins je rirai de ton impertinence.
CHRISANTE, ils ſont deffaits, & C'eſt noſtre deſtin	CHRISANTE, ils sont défaits, et C’est notre destin
De reuenir chargeZ d'honneur & de butin,	De revenir chargés d’honneur et de butin,
Apres auoir dompté cette iniuſte Puiſſance	Après avoir dompté cette injuste Puissance
Qui veut inſolemment opprimer l'innocence.	Qui veut insolemment opprimer l’innocence.
Les Dieux que ce deſordre auoit mis en couroux,	Les Dieux que ce désordre avait mis en courroux,
Ont monſtré clairement qu'ils combattent pour nous,	Ont montré clairement qu’ils combattent pour nous,
Et font leur propre fait des armes legitimes,	Et font leur propre fait des armes légitimes,
Qu'on nous void employer au chaſtiment des crimes.	Qu’on nous voit employer au châtiment des crimes.
Les Perſes en effet ont paru plus qu'humains,	Les Perses en effet ont paru plus qu’humains,
Lors qu'auec ces grands cris ils ſont venus aux mains:	Lorsqu’avec ces grands cris ils sont venus aux mains:
Par tout les ennemis troubleZ de cette audace	Partout les ennemis troublés de cette audace
Ont pris chacun de nous pour le Dieu de la Thrace.	Ont pris chacun de nous pour le Dieu de la Thrace.
Ils ſe ſont esbranlez en nous voyant marcher,	Ils se sont ébranlés en nous voyant marcher,
Et des traicts infinis qu'ils ont peu decocher	Et des traits infinis qu’ils ont pu décocher
Comme ils ſe renuerſoient les vns deſſus les autres;	Comme ils se renversaient les uns dessus les autres;
Ce n'eſt que par hazard qu'ils ont bleſſé des noſtres.	Ce n'est que par hasard qu’ils ont blessé des nôtres.
Que leur Caualerie a plié laſchement	Que leur Cavalerie a plié lâchement
Nous voyant auanceZ dans leur retranchement:	Nous voyant avancés dans leur retranchement:
Dans la confuſion que l'eſpouuante apporte,	Dans la confusion que l’épouvante apporte,
Les ſoldats & les chefs ſe ſont troubleZ de ſorte,	Les soldats et les chefs se sont troublés de sorte,
Qu'ils ſe ſont ſepareZ dés lors également	Qu’ils se sont séparés dès lors également
Et de l'obeïſſance & du commandement.	Et de l’obéissance et du commandement.
S'ils ſe fuſſent battus auec plus de courage,	S’ils se fussent battus avec plus de courage,
Ils en euſſent receu moins de deſaduantage:	Ils en eussent reçu moins de désavantage:
Car dans cette deſroute on peut bien faire eſtat	Car dans cette déroute on peut bien faire état
Qu'il en eſt mort vingt fois plus que dans le combat.	Qu’il en est mort vingt fois plus que dans le combat.
Deux Roys à noſtre abord combatans en perſonne	Deux Rois à notre abord combattant en personne
Ont ſeruy par malheur de victime à Bellonne:	Ont servi par malheur de victime à Bellonne:
Et cet autre Tyran qui me penſoit brauer	Et cet autre Tyran qui me pensait braver
S'eſt veu honteuſement reduit à ſe ſauuer.	S’est vu honteusement réduit à se sauver.
Sire, cette tournée eſt vrayment memorable,	Sire, cette tournée est vraiment mémorable,
Et ce dernier ſuccés ſe peut dire admirable.	Et ce dernier succès se peut dire admirable.
Mais außi l'on peut dire auecque verité,	Mais aussi l’on peut dire avec vérité,
Qu'on en doit tout l'honneur à voſtre Maieſté;	Qu’on en doit tout l’honneur à votre Majesté;
Elle a fait le deuoir, & pris toute ta peine,	Elle a fait le devoir, et pris toute ta peine,
Et d'vn braue Soldat & d'vn grand Capitaine:	Et d’un brave Soldat et d’un grand Capitaine:
Elle a couru par tout ou le danger eſtoit,	Elle a couru par tout où le danger était,
Et forcé tous les pas que l'on nous diſputoit.	Et forcé tous les pas que l’on nous disputait.
Que le vieux Aſtiage en receura de ioye!	Que le vieux Astyage en recevra de joie!
Il mourra de plaiſir s'il faut qu'il me reuoye.	Il mourra de plaisir s’il faut qu’il me revoie.
Mais pour luy teſmoigner parauant ce bon-heur	Mais pour lui témoigner par avant ce bonheur
Combien nos combatans ce ſont acquis d'honneur;	Combien nos combattants ce sont acquis d’honneur;
Les Lettres que i'eſcris, s'en vont accompagnees	Les Lettres que j’écris, s’en vont accompagnées
De Tiares froiſſeZ d'Enſeignes gagnees,	De Tiares froissés d’Enseignes gagnées,
Afin que de ma part en ſuperbe appareil	Afin que de ma part en superbe appareil
Où en dreſſe vn Trophee au Temple du Soleil,	Où en dresse un Trophée au Temple du Soleil,
Et que la Perſe voye auec quelle furie	Et que la Perse voie avec quelle furie
Nous auons attaqué les Tyrans d'Aßirie.	Nous avons attaqué les Tyrans d’Assyrie.
Mais nous n'auons rien fait de battre l'ennemy,	Mais nous n’avons rien fait de battre l’ennemi,
Si cet embraſement n'eſt eſteint qu'à demy.	Si cet embrasement n’est éteint qu’à demi.
Iuſqu'icy noſtre peine eſt vne peine ingrate,	Jusqu’ici notre peine est une peine ingrate,
Si portans la terreur iuſqu aux bords de l'Eufrate	Si portant la terreur jusqu'aux bords de l’Euphrate
Nous n'alons eſcheler ces murs audacieux	Nous n’allons écheler ces murs audacieux
Que l'orgueil de Nembrot eſleua iuſqu'aux Cieux.	Que l’orgueil de Nembrod éleva jusqu’aux Cieux.
CHRISANTE.	CHRISANTE.
Sire, dans le bon-heur, ie tiens que la prudence	Sire, dans le bonheur, je tiens que la prudence
Doit meſler ſagement la crainte à l'eſperance,	Doit mêler sagement la crainte à l’espérance,
Reſpecter la Fortune & ne s'engager pas	Respecter la Fortune et ne s’engager pas
Sans quelque deffiance à ſuiure ſes appas.	Sans quelque défiance à suivre ses appas.
Cette aueugle Deeſſe eſt touſiours infidelle,	Cette aveugle Déesse est toujours infidèle,
On eſt ſouuent trompé quand on s'aſſeure en elle;	On est souvent trompé quand on s’assure en elle;
Elle a l'eſprit leger & le gouſt depraué,	Elle a l’esprit léger et le goût dépravé,
Et laiſſe choir ſouuent ce qu'elle a releué.	Et laisse choir souvent ce qu’elle a relevé.
Que voſtre Maieſté dans ſes deſſeins regarde	Que votre Majesté dans ses desseins regarde
Au ſalut important du Corps qu'elle haZarde.	Au salut important du Corps qu’elle hasarde.
C'eſt la fleur de l'Aſie: & ſi par vn malheur	C’est la fleur de l’Asie: et si par un malheur
La force & le grand nombre accabloient la valeur,	La force et le grand nombre accablaient la valeur,
On verroit außi toſt la Perſe & la Medie	On verrait aussitôt la Perse et la Médie
Languir d'vne faſcheuſe & longue maladie;	Languir d’une fâcheuse et longue maladie;
Et des fers outrageux nous viendroient meſtriſer,	Et des fers outrageux nous viendraient maîtriser,
Que ſans quelque miracle on ne pourroit briſer.	Que sans quelque miracle on ne pourrait briser.
Ie ſers trop bien les Dieux pour craindre ces diſgraces;	Je sers trop bien les Dieux pour craindre ces disgrâces;
I'imite leurs bonteZ, ie marche ſur leurs traces:	J’imite leurs bontés, je marche sur leurs traces:
C'eſt leur ſecret conſeil qui me fait mettre aux chams,	C’est leur secret conseil qui me fait mettre aux champs,
Pour conſeruer les bons & perdre les meſchans.	Pour conserver les bons et perdre les méchants.
La Fortune en ſon cours ſuit leur ſainte ordonnance,	La Fortune en son cours suit leur sainte ordonnance,
Et ſelon leurs decrets regle ſon inconſtance.	Et selon leurs décrets règle son inconstance.
Cette Diuinité qui marche ſur les flos,	Cette Divinité qui marche sur les flots,
N'eſt que l'occaſion priſe bien à propos	N’est que l’occasion prise bien à propos
Lors qu'auec hardieſſe on fait vne entrepriſe,	Lors qu’avec hardiesse on fait une entreprise,
Et que pour quelque bien le Ciel la fauoriſe.	Et que pour quelque bien le Ciel la favorise.
Il eſt bien mal-aiſé qu'on ne ſoit pas heureux	Il est bien malaisé qu’on ne soit pas heureux
Quand on fait des deſſeins iuſtes & genereux:	Quand on fait des desseins justes et généreux:
Car lors qu'à nos ſouhaits le Ciel n'eſt pas propice,	Car lorsqu’à nos souhaits le Ciel n’est pas propice,
Cet obſtacle ne vient que de noſtre iniuſtice.	Cet obstacle ne vient que de notre injustice.
De moy, ie ne ſuis point vn inſolent vainqueur,	De moi, je ne suis point un insolent vainqueur,
Ie redonne les biens pour acquerir le cœur;	Je redonne les biens pour acquérir le cœur;
Et fay voir clairement que ie ne fay la guerre	Et fais voir clairement que je ne fais la guerre
Que pour mieux eſtablir la paix deſſus la Terre:	Que pour mieux établir la paix dessus la Terre:
Je ne m'attaque point à qui vit iuſtement;	Je ne m’attaque point à qui vit justement;
Et quand ie peux punir ie pardonne aiſément.	Et quand je peux punir je pardonne aisément.
Ie ne veux de teſmoin que le Roy d'Armenie:	Ie ne veux de témoin que le Roi d’Arménie:
Si i'impoſe des loix auecque tyrannie,	Si j’impose des lois avec tyrannie,
I'ay triomphé deux fois de ce Prince indompté,	J’ai triomphé deux fois de ce Prince indompté,
L'vne par ma valeur, l'autre par ma bonté:	L’une par ma valeur, l’autre par ma bonté:
Mes bien-faits l'ont eſtreint d'vne cheine eternelle,	Mes bienfaits l’ont étreint d’une chaîne éternelle,
Changeant la vieille hayne en amitié nouuelle.	Changeant la vieille haine en amitié nouvelle.
Et ie fais à Panthee vn ſi doux traictement,	Et je fais à Panthée un si doux traitement,
Qu'Abradate en aura quelque reſſentiment:	Qu’Abradate en aura quelque ressentiment:
Pour peu que ſa Vertu reſponde à ſa naiſſance,	Pour peu que sa Vertu réponde à sa naissance,
Il m'en teſmoignera de la recognoiſſance;	Il m’en témoignera de la reconnaissance;
En quelqu'autre rencontre il s'en reſſentira,	En quelqu’autre rencontre il s’en ressentira,
Et cheZ les eſtrangers ce traict me ſeruira.	Et chez les étrangers ce trait me servira.
Quand on vous amena cette belle captiue,	Quand on vous amena cette belle captive,
Elle eſtoit ſans mentir außi morte que viue:	Elle était sans mentir aussi morte que vive:
En ſon viſage paſle on n'aperçeuoit pas	En son visage pâle on n’apercevait pas
Ce qu'il a maintenant de graces & d'apas:	Ce qu’il a maintenant de grâces et d’appas:
Mais dans cet accident ſa peur l'auoit trompée,	Mais dans cet accident sa peur l’avait trompée,
Et par voſtre bonté ſa crainte ef dißipée.	Et par votre bonté sa crainte est dissipée.
O Dieux! quelle s'en louë.	O Dieux! quelle s’en loue.
Hidaſpe, c'eſt ainſi	Hidaspe, c’est ainsi
Que nous deuons traicter: Mais que veut cétuy-cy?	Que nous devons traiter: Mais que veut celui-ci?
Ceſt la Reyne eſtrangere.	C’est la Reine étrangère.
Allons au deuant d'elle;	Allons au devant d’elle;
Araſpe en m'en parlant me la depeint ſi belle,	Araspe en m’en parlant me la dépeint si belle,
Que ie croirois faillir & beaucoup haZarder	Que je croirais faillir et beaucoup hasarder
Si dans cet entretien i'oſois la regarder:	Si dans cet entretien j’osais la regarder:
Ie crains que le plaiſir qu'on treuue en ſa preſence,	Je crains que le plaisir qu’on trouve en sa présence,
Ne face negliger les choſes d'importance.	Ne face négliger les choses d’importance.
QVE fait voſtre Empereur, ne peut-on pas le voir?	QUE fait votre Empereur, ne peut-on pas le voir?
Madame, le voicy qui vient vous receuoir.	Madame, le voici qui vient vous recevoir.
Ne vous affligez pas belle & chaſte Panthee,	Ne vous affligez pas belle et chaste Panthée,
C'eſt en femme de Roy que vous ſereZ traictee,	C’est en femme de Roi que vous serez traitée,
Et le terme abſolu de voſtre liberté	Et le terme absolu de votre liberté
Dependra deſormais de voſtre volonté;	Dépendra désormais de votre volonté;
Si toſt que d'Abradate on aura des nouuelles,	Sitôt que d'Abradate on aura des nouvelles,
Ie vous feray guider par des troupes fidelles,	Je vous ferai guider par des troupes fidèles,
Dont l'aſſeuré conuoy ne vous quittera pas	Dont l’assuré convoi ne vous quittera pas
Qu'il ne vous ait du camp remiſe entre ſes bras.	Qu’il ne vous ait du camp remise entre ses bras.
Cirus ayant ſceu vaincre emportera la gloire	Cyrus ayant su vaincre emportera la gloire
D'auoir ſceu noblement vſer de la victoire;	D’avoir su noblement user de la victoire;
En vous rendant l'honneur & la ciuilité	En vous rendant l’honneur et la civilité
Que veulent voſtre ſexe & voſtre qualité.	Que veulent votre sexe et votre qualité.
Delices de l'Aſie & l'honneur des Monarques,	Délices de l’Asie et l’honneur des Monarques,
En qui l'on void des Dieux tant d'immortelles marques:	En qui l'on voit des Dieux tant d’immortelles marques:
Prince qu'on peut nommer le plus grãd des humains,	Prince qu’on peut nommer le plus grand des humains,
Ie benis ma diſgrace eſtant entre vos mains;	Je bénis ma disgrâce étant entre vos mains;
Et ce trait de malheur ſi doucement s'efface,	Et ce trait de malheur si doucement s’efface,
Que ie penſe faillir en l'appellant diſgrace:	Que je pense faillir en l’appelant disgrâce:
Selon que vos bontés me le font eſprouuer,	Selon que vos bontés me le font éprouver,
C'eſt le plus grand bon-heur qui me peuſt arriuer	C’est le plus grand bonheur qui me peut arriver
L'accident eſt bien doux qui me fait reconnaiſtre	L’accident est bien doux qui me fait reconnaître
Celuy que mon Seigneur doit choiſir pour ſon maiſtre;	Celui que mon Seigneur doit choisir pour son maître;
Et de qui le merite eſt ſi grand, qu'aujourd'huy	Et de qui le mérite est si grand, qu’aujourd’huy
Tout l'Vniuers encor doit releuer de luy.	Tout l’Univers encor doit relever de lui.
Madame, auec excez voſtre bonté me flatte.	Madame, avec excès votre bonté me flatte.
Seigneur, voſtre bonté s'eſt acquiſe Abradate;	Seigneur, votre bonté s’est acquise Abradate;
I'ay depeſché des miens pour luy faire ſçauoir	J’ai dépêché des miens pour lui faire savoir
Qu'elles ſont vos vertus, & quel eſt ſon deuoir:	Qu’elles sont vos vertus, et quel est son devoir:
S'il n'a changé d’eſprit i'oſe bien me promettre	S’il n’a changé d’esprit j’ose bien me promettre
Qu'il viendra vous treuuer ayant receu ma lettre,	Qu’il viendra vous trouver ayant reçu ma lettre,
Et qu'il vous ſeruira s'il eſt autant heureux	Et qu’il vous servira s’il est autant heureux
Qu'il a touſiours eſté fidelle & genereux.	Qu’il a toujours été fidèle et généreux.
Madame, ie n'ay point merité cette grace.	Madame, je n’ai point mérité cette grâce.
Mais pourroit-il quitter le party qu'il embraſſe,	Mais pourrait-il quitter le parti qu’il embrasse,
Et laiſſer des voiſins pour ſuiure vn Eſtranger?	Et laisser des voisins pour suivre un Étranger?
Sa reputation y courroit du danger;	Sa réputation y courrait du danger;
Ie donne à vos propos vne entiere creance:	Je donne à vos propos une entière créance:
Mais ces grandes faueurs paſſent mon eſperance.	Mais ces grandes faveurs passent mon espérance.
Si le Roy d'Aßirie eſtoit encor viuant,	Si le Roi d’Assyrie était encor vivant,
Ce diſcours pourroit eſtre vn propos deceuant:	Ce discours pourrait être un propos décevant:
De luy, ſon alliance eſtoit fort ſouhaitable,	De lui, son alliance était fort souhaitable,
Ce Prince eſtoit deuot, genereux, equitable,	Ce Prince était dévot, généreux, équitable,
Tenoit exactement ce qu'il auoit promis,	Tenait exactement ce qu’il avait promis,
Et meritoit par là d'auoir beaucoup d'Amis.	Et méritait par là d’avoir beaucoup d’Amis.
Mais ce nouueau Tyran, laſche & cruel enſemble,	Mais ce nouveau Tyran, lâche et cruel ensemble,
Encor qu'il ſoit ſon fils, n'a rien qui luy reſſemble,	Encor qu’il soit son fils, n’a rien qui lui ressemble,
Il eſt impie, iniuſte, inſolent & trompeur,	Il est impie, injuste, insolent et trompeur,
Il ne ſe fait ſeruir qu'en donnant de la peur;	Il ne se fait servir qu’en donnant de la peur;
Son ame dans le crime eſt touſiours occupee,	Son âme dans le crime est toujours occupée,
Ce n'eſt que de la bouë en du ſang détrempee.	Ce n’est que de la boue en du sang détrempée.
On ne peut l'aßiſter ſans quelque laſcheté,	On ne peut l’assister sans quelque lâcheté,
Et l'on peut le quitter par generoſité.	Et l'on peut le quitter par générosité.
Seigneur, tout à loiſir vous pourrez vous inſtruire	Seigneur, tout à loisir vous pourrez vous instruire
Des ſoings malicieux qu'il a pris pour me nuire.	Des soins malicieux qu’il a pris pour me nuire.
Pour vous nuire, Madame, & de quelle façon?	Pour vous nuire, Madame, et de quelle façon?
Mettant de mon amour Abradate en ſoupçon:	Mettant de mon amour Abradate en soupçon:
N'ayant peu m'acquerir par douceur ny par force,	N’ayant pu m’acquérir par douceur ni par force,
Il s'en voulut vanger en cauſant ce diuorce.	Il s’en voulut venger en causant ce divorce.
Cet acte, ſans mentir, fait horreur & pitié,	Cet acte, sans mentir, fait horreur et pitié,
Vn moindre coup peut rompre vne grande amitié:	Un moindre coup peut rompre une grande amitié:
I'ay ſceu d'vn Gouuerneur d’vne de ces Prouinces,	J’ai su d’un Gouverneur d’une de ces Provinces,
Qu'on le pourroit compter entre les mauuais Princes.	Qu’on le pourrait compter entre les mauvais Princes.
Ie me doute à peu pres quel eſt ce Gouuerneur,	Je me doute à peu près quel est ce Gouverneur,
C'eſt vn pere affligé:	C’est un père affligé:
Ie le connoy, Seigneur,	Je le connais, Seigneur,
Il n'auoit qu'vn ſeul fils dont il plaint la diſgrace;	Il n’avait qu’un seul fils dont il plaint la disgrâce;
Ce Monarque brutal le menant à la chaſſe,	Ce Monarque brutal le menant à la chasse,
Le trauerſa d'vn dard, par vn jaloux ennuy	Le traversa d’un dard, par un jaloux ennui
De le voir plus diſpos & plus adroit que luy.	De le voir plus dispos et plus adroit que lui.
C'eſt cettuy-là, Madame, & ie ne pouuois croire	C’est celui-là, Madame, et je ne pouvais croire
Qu'vn Prince euſt peu commettre vne action ſi noire;	Qu’un Prince eût peu commettre une action si noire;
Vn Roy doit s'appliquer à de meilleurs objets,	Un Roi doit s’appliquer à de meilleurs objets,
Gouuerner ſon eſprit ainſi que ſes ſujets;	Gouverner son esprit ainsi que ses sujets;
Et meſlant la iuſtice a des bonteZ extremes,	Et mêlant la justice a des bontés extrêmes,
En commandant autruy, ſe commander ſoy-meſme.	En commandant autrui, se commander soi-même.
Ie me treuue poſſible außi grand terrien	Je me trouve possible aussi grand terrien
Que le Roy de Lydie & que l'Aßirien:	Que le Roi de Lydie et que l’Assyrien:
Mais dans vne grandeur aſſeZ conſiderable,	Mais dans une grandeur assez considérable,
Ie ne fay vanité que d'eſtre raiſonnable;	Je ne fais vanité que d’être raisonnable;
De reuerer les Dieux, d’aimer mes alliez,	De révérer les Dieux, d’aimer mes alliés,
De pardonner à ceux qui ſe ſont oubliez,	De pardonner à ceux qui se sont oubliés,
Et donner à mon peuple vn aſſeZ beau modelle	Et donner à mon peuple un assez beau modèle
Pour ſe rendre deuot, vaillant, ſage & fidelle.	Pour se rendre dévot, vaillant, sage et fidèle.
Ie connoy la vertu du Roy voſtre mary;	Je connais la vertu du Roi votre mari;
Et l'eſtimant beaucoup, ie ſerois bien marry	Et l’estimant beaucoup, je serais bien marri
Si nous deuions vn iour deuenir freres d'armes,	Si nous devions un jour devenir frères d’armes,
Que vous eußiez iamais de matieres de larmes;	Que vous eussiez jamais de matières de larmes;
Ie vous aſſeurerois de ne pas negliger	Je vous assurerais de ne pas négliger
Les ſoings de vous ſeruir de vous proteger.	Les soins de vous servir de vous protéger.
Mais croyez-vous en fin cauſer cette alliance?	Mais croyez-vous enfin causer cette alliance?
I'en attends la nouuelle auec impatience:	J’en attends la nouvelle avec impatience:
Les Cieux de cet effet, par mes vœux ſont preſſez,	Les Cieux de cet effet, par mes vœux sont pressés,
Et de ſi iuſtes vœux ſont poßible exaucez.	Et de si justes vœux sont possible exaucés.
Mais dans les grands emplois d'vne valeur ſi rare,	Mais dans les grands emplois d’une valeur si rare,
Seigneur, de voſtre temps vous deuez eſtre auare.	Seigneur, de votre temps vous devez être avare.
Außi ie ne dois pas en diſcours ennuyeux	Aussi je ne dois pas en discours ennuyeux
Faire en vain conſumer des momens precieux.	Faire en vain consumer des moments précieux.
Madame, vos vertus, comme voſtre naiſſance,	Madame, vos vertus, comme votre naissance,
Vous donnent où ie ſuis vne entiere puiſſance:	Vous donnent où je suis une entière puissance:
Commandez à mes gens tout ce qu'il vous plaira,	Commandez à mes gens tout ce qu’il vous plaira,
Icy comme dans SuZe on vous obeira.	Ici comme dans Suze on vous obéira.
Araſpe, fay touſiours auec vn ſoing extreme	Araspe, fais toujours avec un soin extrême
Qu'on reſpecte Madame à l'egal de moy-meſme.	Qu’on respecte Madame à l’égal de moi-même.
Sire, on ne ſçauroit voir ce miracle des Cieux	Sire, on ne saurait voir ce miracle des Cieux
Sans luy rendre auſſi toſt l'honneur qu'on doit aux Dieux.	Sans lui rendre aussitôt l’honneur qu’on doit aux Dieux.
IL en peut bien parler auec beaucoup d'eſtime,	IL en peut bien parler avec beaucoup d’estime,
Céte grande loüange eſt vrayment legitime.	Cette grande louange est vraiment légitime.
Nom ne fiſmes iamais vn plus riche butin	Nom ne fîmes jamais un plus riche butin
S'il faut que ſon mary ſuiue noſtre deſtin;	S’il faut que son mari suive notre destin;
Nom y rencontrerions l'vtile & l’honorable;	Nom y rencontrerions l’utile et l’honorable;
Et ce ſeroit pour faire vn progrez admirable.	Et ce serait pour faire un progrès admirable.
Mais ie ne puis penſer qu'eſtant homme de cœur,	Mais je ne puis penser qu’étant homme de cœur,
Il quitte le vaincu pour ſuiure le vainqueur:	Il quitte le vaincu pour suivre le vainqueur:
En cette occaſion, ce ſeroit la penſee,	En cette occasion, ce serait la pensée,
D’vne ame fort legere, ou fort intereſſee,	D’une âme fort légère, ou fort intéressée,
Quelque raiſon qu'on ait, on eſt dans le meſpris	Quelque raison qu'on ait, on est dans le mépris
Lors que lon abandonne vn party qu'on a pris.	Lorsque l'on abandonne un parti qu’on a pris.
Sire, quand le deſpit s'empare de noſtre ame,	Sire, quand le dépit s’empare de notre âme,
Nous mettons en oubly la loüange & le blaſme;	Nous mettons en oubli la louange et le blâme;
Et ſans aucun égard de honte ou de danger,	Et sans aucun égard de honte ou de danger,
Dons nos raiſonnemens tendent à nous vanger,	Dons nos raisonnements tendent à nous venger,
Abradate offencé par cet indigne Prince,	Abradate offensé par cet indigne Prince,
Qui d’vn joug tyrannique oprime ſa Prouince,	Qui d’un joug tyrannique opprime sa Province,
Croit peut-eſtre auiourd'huy s'en pouuoir ſeparer	Croit peut-être aujourd’hui s’en pouvoir séparer
Sans courre de haZard de ſe deshonorer.	Sans courre de hasard de se déshonorer.
Hidaſpe, il ſe peut faire, & des Dieux bons & ſages	Hidaspe, il se peut faire, et des Dieux bons et sages
Nous pouuons eſperer de plus grands aduantages.	Nous pouvons espérer de plus grands avantages.
Mais alons voir le camp de l'vn à l'autre bout,	Mais allons voir le camp de l’un à l’autre bout,
Viſiter les cartiers, & donner ordre à tout.	Visiter les quartiers, et donner ordre à tout.
POVR voir le plus grand Roy que le Ciel ait fait naiſtre,	POUR voir le plus grand Roi que le Ciel ait fait naître,
Il faut porter les yeux, ſur le Roy noſtre maiſtre;	Il faut porter les yeux, sur le Roi notre maître;
De tous ceux que l'on tient pour images des Dieux,	De tous ceux que l'on tient pour images des Dieux,
C'eſt le viuant portraict qui reſſemble le mieux.	C’est le vivant portrait qui ressemble le mieux.
Et pour voir vne Reyne en vertus ſans pareille,	Et pour voir une Reine en vertus sans pareille,
Qu'on peut auec raiſon nommer vne merueille:	Qu’on peut avec raison nommer une merveille:
Pour l'excellent eſprit & la rare beauté	Pour l’excellent esprit et la rare beauté
Il faut porter les yeux ſur voſtre Maieſté.	Il faut porter les yeux sur votre Majesté.
Cette comparaiſon aſſeZ mal aſſortie,	Cette comparaison assez mal assortie,
Bleſſant la verité choque ma modeſtie:	Blessant la vérité choque ma modestie:
Cirus eſt vn miracle en rares qualiteZ,	Cirus est un miracle en rares qualités,
Qu'on ne doit comparer qu'à des Diuinitez.	Qu’on ne doit comparer qu’à des Divinités.
Madame, dans ce rang vous pourriez prendre place	Madame, dans ce rang vous pourriez prendre place
Vous voulez me flattant adoucir ma diſgrace,	Vous voulez me flattant adoucir ma disgrâce,
C'eſt en continuant vos ſoings accouſtumez,	C’est en continuant vos soins accoutumés,
Auec beaucoup deſprit monſtrer que vous m'aymez.	Avec beaucoup d'esprit montrer que vous m’aimez.
On ne peut rien aymer qui ſoit plus adorable.	On ne peut rien aimer qui soit plus adorable.
De cette affection ie vous ſuis redeuable;	De cette affection je vous suis redevable;
Cirus n'euſt peu me faire vn traitement ſi doux,	Cirus n’eût pu me faire un traitement si doux,
En me donnant en garde à tout autre qu'à vous.	En me donnant en garde à tout autre qu’à vous.
Mais touſiours vos reſpects, vos ſoins, & voſtre addreſſe,	Mais toujours vos respects, vos soins, et votre adresse,
Ne deſguiſant mes maux conſolent ma triſteſſe;	Ne déguisant mes maux consolent ma tristesse;
Aucun autre des ſiens n'auroit eu la bonté	Aucun autre des siens n’aurait eu la bonté
De me laiſſer ſi libre en ma captiuité.	De me laisser si libre en ma captivité.
Hé! Madame, ceſſeZ.	Hé! Madame, cessez.
Si i'en ay la puiſſance,	Si j’en ai la puissance,
Vous ne vous plaindreZ pas de ma reconnoiſſance,	Vous ne vous plaindrez pas de ma reconnaissance,
Vous pourrez employer Abradate.	Vous pourrez employer Abradate.
O grands Dieux!	Ô grands Dieux!
Que ce nom m'eſt fatal, & qu'il m'eſt odieux!	Que ce nom m’est fatal, et qu’il m’est odieux!
Quel accident ſoudain change noſtre viſage?	Quel accident soudain change notre visage?
C'eſt de quelque recheute vn aſſeuré preſage;	C’est de quelque rechute un assuré présage;
Apres auoir eſté malade extremement,	Après avoir été malade extrêmement,
Vous ne deuieZ iamais ſortir ſi promptement.	Vous ne deviez jamais sortir si promptement.
La mort s'en va bien toſt punir mon imprudence!	La mort s’en va bientôt punir mon imprudence!
Charis, qu'on le ſecoure, il tombe en defaillance:	Charis, qu’on le secoure, il tombe en défaillance:
Ie ne puis voir ſon mal ſans en auoir pitié.	Je ne puis voir son mal sans en avoir pitié.
O traict, pour mon malheur, trop doux de la moitié!	Ô trait, pour mon malheur, trop doux de la moitié!
Le cœur vous fait-il mal?	Le cœur vous fait-il mal?
Roxane, c'eſt ma peine:	Roxane, c’est ma peine:
Ie demeure auec luy, ſuiuez vn peu la Reyne,	Je demeure avec lui, suivez un peu la Reine,
Et renuoyeZ quelqu'vn pour en auoir du ſoin.	Et renvoyez quelqu’un pour en avoir du soin.
N'en preneZ pas la peine, il n'en eſt plus beſoin:	N’en prenez pas la peine, il n’en est plus besoin:
Où pourroit-on trouuer deux compagnes fidelles,	Où pourrait-on trouver deux compagnes fidèles,
Qui fuſſent plus que vous, ny courtoiſes, ny belles?	Qui fussent plus que vous, ni courtoises, ni belles?
Les Graces dans le Ciel ſont vn moindre ornement,	Les Grâces dans le Ciel sont un moindre ornement,
Et vous ne leur cedeZ qu'en nombre ſeulement.	Et vous ne leur cédez qu’en nombre seulement.
Außi le Sort vous mit aupres d'vne maiſtreſſe,	Aussi le Sort vous mit auprès d’une maîtresse,
Qu'on ne peut eſtimer moindre qu'vne Deeſſe;	Qu’on ne peut estimer moindre qu’une Déesse;
Que ſes yeux ont d'eſclat, que ſon viſage eſt doux:	Que ses yeux ont d’éclat, que son visage est doux:
O Dieux qu'elle a d’appas!	Ô Dieux qu’elle a d’appas!
Elle en a trop pour vous:	Elle en a trop pour vous:
Vn vermeillon ſe meſle à voſtre couleur bleſme,	Un vermillon se mêle à votre couleur blême,
Vous pourrieZ l'aymer.	Vous pourriez l’aimer.
Il eſt vray que ie l’ayme;	Il est vrai que je l’aime;
Celuy qui la peut voir ſans auoir de l'amour,	Celui qui la peut voir sans avoir de l’amour,
Eſt indigne de voir la lumiere du iour,	Est indigne de voir la lumière du jour,
Sous vn viſage d'homme il porte vn cœur de marbre,	Sous un visage d’homme il porte un cœur de marbre,
Et n'a pas plus de ſens qu'vn rocher ou qu'vn arbre.	Et n’a pas plus de sens qu’un rocher ou qu’un arbre.
Enfin vous l’aymez, donc y il faut le confeſſer?	Enfin vous l’aimez, donc y il faut le confesser?
Ouy, mais c'eſt d'vn amour qui ne peut l'offencer:	Oui, mais c’est d’un amour qui ne peut l’offenser:
C'eſt d'vne ſaincte ardeur, bien quelle ſoit extreme,	C’est d’une sainte ardeur, bien quelle soit extrême,
Qui ne ſera iamais nuiſible qu'à moy-meſme.	Qui ne sera jamais nuisible qu’à moi-même.
I'ay regret de vous voir dans cette paßion;	J’ai regret de vous voir dans cette passion;
AſſeureZ-vous par là de ma diſcretion.	Assurez-vous par là de ma discrétion.
S'il faut que la Nature en l'air d'vn beau viſage,	S’il faut que la Nature en l’air d’un beau visage,
De la grandeur de l'ame exprime vn teſmoignage,	De la grandeur de l’âme exprime un témoignage,
Qu'on puiſſe du dedans iuger par le dehors,	Qu’on puisse du dedans juger par le dehors,
Et qu'vn Eſprit bien fait n'habite qu'vn beau corps	Et qu’un Esprit bien fait n’habite qu’un beau corps
Charis eſt vne noble & diuine perſonne,	Charis est une noble et divine personne,
Elle a des ſentimens dignes d’vne Couronne;	Elle a des sentiments dignes d’une Couronne;
Et ce que la Fortune a de proſperitez	Et ce que la Fortune a de prospérités
Ne ſçauroit eſgaller ſes rares qualitéZ.	Ne saurait égaler ses rares qualités.
Ie croy que pour tout l'or des Princes de Lydie,	Je crois que pour tout l’or des Princes de Lydie,
Vous ne commettriez pas la moindre perfidie:	Vous ne commettriez pas la moindre perfidie:
Que c’eſt ſans intereſt lors que vous obligeZ,	Que c’est sans intérêt lorsque vous obligez,
Et que voſtre faueur eſt pour les affligez.	Et que votre faveur est pour les affligés.
C'eſt à vous ſeule außi que ie fay confidence,	C’est à vous seule aussi que je fais confidence,
Et de mon infortune, & de mon imprudence.	Et de mon infortune, et de mon imprudence.
Araſpe pour auoir plus de contentement,	Araspe pour avoir plus de contentement,
Ne vous obſtineZ pas d'aymer ſi hautement,	Ne vous obstinez pas d’aimer si hautement,
Il faut regler ſon vol: car lors que l'on s’égare	Il faut régler son vol: car lorsque l’on s’égare
On a le plus ſouuent la fortune d’Icare,	On a le plus souvent la fortune d’Icare,
On ne peut ſans peril approcher d'vn Soleil.	On ne peut sans péril approcher d’un Soleil.
Helas! ie ne ſçaurois ſuiure voſtre conſeil,	Hélas! je ne saurais suivre votre conseil,
Vn deſtin tout-puiſſant, vne inuincible Eſtoile	Un destin tout-puissant, une invincible Étoile
Aux yeux de ma Raiſon attache vn ſombre voile,	Aux yeux de ma Raison attache un sombre voile,
Ie ſçay bien que ie ſers vne ingrate Beauté,	Je sais bien que je sers une ingrate Beauté,
Et qu'aymant ſans eſpoir i'ay des feux ſans clarté.	Et qu’aimant sans espoir j’ai des feux sans clarté.
Ah! le cœur me ſouleue en penſant à ſes charmes;	Ah! le cœur me soulève en pensant à ses charmes;
Permettez que ie donne vn cours libre à mes larmes,	Permettez que je donne un cours libre à mes larmes,
Et cognoiſſant le mal qui cauſe mon treſpas,	Et connaissant le mal qui cause mon trépas,
En plaignant mon malheur ne le diuulguez pas.	En plaignant mon malheur ne le divulguez pas.
N'en ayez point de peur, ie plains voſtre auanture,	N’en ayez point de peur, je plains votre aventure,
Et veux auecques, vous cacher voſtre bleſſure.	Et veux avec, vous cacher votre blessure.
Suiuez vos ſentimens;	Suivez vos sentiments;
Ils ſont trop genereux,	Ils sont trop généreux,
Pour me faire attacher au ſort d'vn malheureux.	Pour me faire attacher au sort d’un malheureux.
Mais a qui vous eſtime, il ſeroit deſirable	Mais à qui vous estime, il serait désirable
Que ce mal ſi cruel ne fuſt pas incurable.	Que ce mal si cruel ne fût pas incurable.
HOSTES du ſilence & de l'ombre,	HÔTES du silence et de l’ombre,
Où l'air eſt ſi frais & ſi ſombre:	Où l’air est si frais et si sombre:
Arbres qui cognoiſſez l'eſtat de ma langueur,	Arbres qui connaissez l’état de ma langueur,
Soyez, les confidents des peines que i'endure,	Soyez, les confidents des peines que j’endure,
Et ſouffreZ que ie graue en voſtre eſcorce dure	Et souffrez que je grave en votre écorce dure
Le beau nom que l'Amour a graué dans mon cœur,	Le beau nom que l’Amour a gravé dans mon cœur,
Amour, ce Conſeiller perfide,	Amour, ce Conseiller perfide,
Ce ieune aueugle qui me guide,	Ce jeune aveugle qui me guide,
A cauſé tous les maux qui me font ſoûpirer;	A causé tous les maux qui me font soupirer;
Il a porté mon Ame à ſuiure ſes caprices,	Il a porté mon Âme à suivre ses caprices,
Et la conduite en fin parmy des precipices,	Et la conduite enfin parmi des précipices,
D'où iamais ma raiſon ne peût la retirer.	D’où jamais ma raison ne put la retirer.
Il m'a fait obſeruer les charmes	Il m'a fait observer les charmes
D'vne Reyne fondante en larmes.	D’une Reine fondante en larmes.
Et qui pourroit du Ciel tous les Decrets changer.	Et qui pourrait du Ciel tous les Décrets changer.
O quelle eſt redoutable encore qu'elle pleure!	Ô quelle est redoutable encore qu'elle pleure!
Qui peut voir ſes beaux yeux ſans mourir tout à l'heure,	Qui peut voir ses beaux yeux sans mourir tout à l’heure,
Peut voir des Baſilics ſans crainte & ſans danger.	Peut voir des Basilics sans crainte et sans danger.
Ses yeux, ces lumieres fatales.	Ses yeux, ces lumières fatales.
Sont des Planettes ſans égales,	Sont des Planètes sans égales,
Qui peuuent à leur gré diſpoſer de mon ſort.	Qui peuvent à leur gré disposer de mon sort.
Mais ô ſimplicité qui n'a point de ſeconde!	Mais ô simplicité qui n’a point de seconde!
En nommãt ſes beaux yeux les plus beaux du mõde,	En nommant ses beaux yeux les plus beaux du monde,
Ie louë innocemment les Autheurs de ma mort.	Je loue innocemment les Auteurs de ma mort.
Helas! ie ſuis ſi miſerable	Hélas! je suis si misérable
En l'eſtat triſte & deplorable	En l’état triste et déplorable
Où d'abord m'a reduit l'eſclat de ſes beaux yeux;	Où d’abord m'a réduit l’éclat de ses beaux yeux;
Et tant d'ennuis ſecrets me font touſiours la guerre,	Et tant d’ennuis secrets me font toujours la guerre,
Que le temps qui me reſte à viure ſur la Terre	Que le temps qui me reste à vivre sur la Terre
Ne me ſçauroit ſuffire à me plaindre des Cieux	Ne me saurait suffire à me plaindre des Cieux
Depuis la fatale iournée	Depuis la fatale journée
Que l'Amour & la Deſtinée	Que l’Amour et la Destinée
Offrirent à ma veuë vn chef d'œuure ſi beau,	Offrirent à ma vue un chef d’œuvre si beau,
I'ay touſiours ſoûpiré d'vn mal inconſolable;	J’ai toujours soupiré d’un mal inconsolable;
Et n'ay peu conceuoir de penſer raiſonnable	Et n’ai peu concevoir de penser raisonnable
Qui ne m'ait conſeillé de courir au Tombeau.	Qui ne m’ait conseillé de courir au Tombeau.
O qu'elle eſt ingrate & cruelle,	Ô qu'elle est ingrate et cruelle,
A l'heure que i'eus pitié d'elle,	À l’heure que j’eus pitié d’elle,
Voyant ſes bras captifs ſous de honteux liens,	Voyant ses bras captifs sous de honteux liens,
I'alay tarir ſes pleurs; elle me mit en flame;	J’allai tarir ses pleurs; elle me mit en flamme;
Ie raſſuray ſon cœur, elle troubla mon ame,	Je rassurai son cœur, elle troubla mon âme,
Et me donna des fers quand ie rompis les ſiens.	Et me donna des fers quand je rompis les siens.
Mes ſoins, ny ma perſeuerance,	Mes soins, ni ma persévérance,
Ne me donnent point d'eſperance	Ne me donnent point d’espérance
Que iamais ſa pitié recompenſe ma foy:	Que jamais sa pitié récompense ma foi:
Mais quel bien manqueroit au bon-heur de ma vie;	Mais quel bien manquerait au bonheur de ma vie;
Et quels Roys glorieux me pourroient faire enuie,	Et quels Rois glorieux me pourraient faire envie,
Si ce diuin Objet auoit pitié de moy?	Si ce divin Objet avait pitié de moi?
O friuoles diſcours, paroles inſenſées,	Ô frivoles discours, paroles insensées,
Abradate eſt l'objet de toutes ſes penſées:	Abradate est l’objet de toutes ses pensées:
C'eſt luy que la Fortune auec trop de rigueur	C’est lui que la Fortune avec trop de rigueur
A placé dans ſon lict, & graué dans ſon cœur:	A placé dans son lit, et gravé dans son cœur:
C'eſt ſon eſloignement qui la rend triſte & bleſme;	C’est son éloignement qui la rend triste et blême;
C'eſt luy qui la poſſede en ſon abſence meſme:	C’est lui qui la possède en son absence même:
Et c'eſt la ſeule amour que ſon cœur conſeruera;	Et c’est la seule amour que son cœur conservera;
Au moins autant de temps qu'Abradate viura.	Au moins autant de temps qu’Abradate vivra.
Ennemy de mon bien, obſtacle de ma joye,	Ennemi de mon bien, obstacle de ma joie,
Que le Sort enrichit d’vne ſi belle proye,	Que le Sort enrichit d’une si belle proie,
Où te retire-tu? ie veux t'aller chercher,	Où te retires-tu? je veux t’aller chercher,
Et l'eſpée à la main te la faire laſcher:	Et l’épée à la main te la faire lâcher:
Ie ne puis encourir de honte ny de blaſme,	Je ne puis encourir de honte ni de blâme,
Si i'arrache le cœur a qui vole mon ame;	Si j’arrache le cœur à qui vole mon âme;
Aura-t'il ſans peril mis ma vie en danger?	Aura-t-il sans péril mis ma vie en danger?
Et faut-il que ie meure ainſi ſans me vanger?	Et faut-il que je meure ainsi sans me venger?
Mais ô dereglement du mal qui me tourmente!	Mais ô dérèglement du mal qui me tourmente!
Panthée eſt a la fois ſa femme & ſon Amante,	Panthée est à la fois sa femme et son Amante,
Et penſant par ſa mort adoucir mon ennuy,	Et pensant par sa mort adoucir mon ennui,
I'attenterois ſur elle entreprenant ſur luy;	J’attenterais sur elle entreprenant sur lui;
Ie me perdrois moy-meſme, & i'yrois par les armes	Je me perdrais moi-même, et j’irais par les armes
Confondre en ce malheur mon ſang auec ſes larmes.	Confondre en ce malheur mon sang avec ses larmes.
Si l'Hymen ſeulement s'opoſoit à mon bien,	Si l’Hymen seulement s’opposait à mon bien,
Il me ſeroit aiſé de rompre ſon lien;	Il me serait aisé de rompre son lien;
Mais l'inuincible Amour qui joint leurs cœurs enſemble,	Mais l’invincible Amour qui joint leurs cœurs ensemble,
Ne permettra iamais que rien les deſ-aſſemble.	Ne permettra jamais que rien les désassemble.
Dieux! ie la voy venir auec tous mes plaiſirs,	Dieux! je la vois venir avec tous mes plaisirs,
Cet objet dans mon cœur redouble mes deſirs,	Cet objet dans mon cœur redouble mes désirs,
Amour, diuin Autheur de mes impatiences,	Amour, divin Auteur de mes impatiences,
Toy qui paſſes pour Maiſtre en toutes les ſciences,	Toi qui passes pour Maître en toutes les sciences,
Inſpire moy de grace, & me fais inuenter	Inspire moi de grâce, et me fais inventer
Vn ſecret pour luy plaire & pour me contenter,	Un secret pour lui plaire et pour me contenter,
Voicy dequoy produire vn ſubtil artifice,	Voici de quoi produire un subtil artifice,
Amour, il vient de toy, fay donc qu'il reüßiſſe.	Amour, il vient de toi, fais donc qu’il réussisse.
CHaris, conſole moy dans mes ſecrets tourmens,	CHaris, console-moi dans mes secrets tourments,
Et ne me cele point quels ſont tes ſentimens;	Et ne me cèle point quels sont tes sentiments;
Penſe-tu qu'auiourd'huy mon Arbradate arriue?	Penses-tu qu’aujourd’hui mon Arbradate arrive?
Et s'il ſejourne plus, penſe-tu que ie viue?	Et s’il séjourne plus, penses-tu que je vive?
Madame, il ne ſçauroit retarder plus d'vn iour.	Madame, il ne saurait retarder plus d’un jour.
Tu dis vn iour Charis? c'eſt trop pour mon amour	Tu dis un jour Charis? c’est trop pour mon amour
Tu ſçais qu'auec excez le Ciel me perſecute	Tu sais qu’avec excès le Ciel me persécute
Quand i'en ſuis ſeparee vne ſeule minutte,	Quand j’en suis séparée une seule minute,
Et tu me dis vn iour? Ah! tu ne penſe pas	Et tu me dis un jour? Ah! tu ne penses pas
De combien cette abſence auance mon treſpas,	De combien cette absence avance mon trépas,
Et qu'infailliblement il faudra que ie meure,	Et qu’infailliblement il faudra que je meure,
Si pour me conſoler il ne vient dans vne heure.	Si pour me consoler il ne vient dans une heure.
O Dieux! ſi tu ſçauois ce que c'eſt que d’aymer,	Ô Dieux! si tu savais ce que c’est que d’aimer,
Quand d'vn feu legitime on ſe ſent enflamer,	Quand d’un feu légitime on se sent enflammer,
Et que la raiſon ſuit l'inſtinc de la Nature;	Et que la raison suit l’instinct de la Nature;
Tu cognoiſtrois bien mieux la peine que i'endure.	Tu connaîtrais bien mieux la peine que j’endure.
Tu ſçaurois ſi le Sort afflige au dernier point	Tu saurais si le Sort afflige au dernier point
Lors qu'on ayme vn objet, & qu'on ne le void point;	Lorsqu’on aime un objet, et qu’on ne le voit point;
Et blaſmerois bien fort les dures tirannies	Et blâmerais bien fort les dures tyrannies
Qui ſeparent les corps de deux Ames vnies.	Qui séparent les corps de deux Ames unies.
Madame, ſi mes vœux pouuoient eſtre exaucez,	Madame, si mes vœux pouvaient être exaucés,
I'eſpargnerois beaucoup des pleurs que vous verſez,	J’épargnerais beaucoup des pleurs que vous versez,
Exempte des ennuis que le Ciel vous enuoye,	Exempte des ennuis que le Ciel vous envoie,
Vous n'en reſpendriez plus ſi ce n'eſtoit de joye.	Vous n’en répandriez plus si ce n’était de joie.
Mais voſtre Majeſté deuroit moins s'affliger	Mais votre Majesté devrait moins s’affliger
Ayant auec tant d'heur ſurmonté le danger:	Ayant avec tant d’heur surmonté le danger:
Elle offence les Dieux auec ſes deffiances,	Elle offense les Dieux avec ses défiances,
Et nuit à ſa ſanté par ſes impatiences.	Et nuit à sa santé par ses impatiences.
La triſteſſe & la peur troublent les matelots	La tristesse et la peur troublent les matelots
Quand les vents mutinez font ſouſleuer les flots,	Quand les vents mutinés font soulever les flots,
Et que malgré leur art, les vagues orgueilleuſes	Et que malgré leur art, les vagues orgueilleuses
Font prendre à leurs vaiſſeaux des routes perilleuſes:	Font prendre à leurs vaisseaux des routes périlleuses:
Mais ſi toſt que Neptune eſmeu du mauuais temps,	Mais sitôt que Neptune ému du mauvais temps,
Remet en leur deuoir ſes ſubjets inconſtans,	Remet en leur devoir ses sujets inconstants,
Dés lors des nauigeans qui craignaient le naufrage,	Dès lors des navigants qui craignaient le naufrage,
La frayeur ſe dißipe außi toſt que l'orage.	La frayeur se dissipe aussitôt que l’orage.
Vous ſeule hors du peril craignez, le mauuais ſort.	Vous seule hors du péril craignez, le mauvais sort.
Charis, le plus ſouuent on fait naufrage au port.	Charis, le plus souvent on fait naufrage au port.
Et l'aueugle fortune auecque trop d'empire:	Et l’aveugle fortune avec trop d’empire:
Preſide ſur l'eſtat du bon-heur où i'aſpire.	Préside sur l’état du bonheur où j’aspire.
Puis i'apprehende fort les maux que me predit	Puis j’appréhende fort les maux que me prédit
Vn ſonge dont l'effroy rend mon ſens interdit.	Un songe dont l’effroi rend mon sens interdit.
Le Soleil pourſuiuant la nuict aux voiles ſombres,	Le Soleil poursuivant la nuit aux voiles sombres,
A coups de traits doreZ auoit chaßé les ombres;	À coups de traits dorés avait chassé les ombres;
Et les petits oyſeaux que reueille l'amour	Et les petits oiseaux que réveille l’amour
Celebroient en chantant la naiſſance du iour	Célébraient en chantant la naissance du jour
Lors que ce ſonge affreux dont l'horreur m'eſpouuãte	Lorsque ce songe affreux dont l’horreur m’épouvante
M'a fait voir d'Abradate vne image viuante.	M'a fait voir d’Abradate une image vivante.
De ſes vaines couleurs il me l'a ſi bien peint,	De ses vaines couleurs il me l'a si bien peint,
Que i'ay creu voir ſa taille & ſes yeux & ſon teint,	Que j’ai cru voir sa taille et ses yeux et son teint,
Le vray ton de ſa voix a frapé mon oreille,	Le vrai ton de sa voix a frappé mon oreille,
Son viſage eſtoit gay, ſa bouche eſtoit vermeille,	Son visage était gai, sa bouche était vermeille,
Du bien de me reuoir il rendoit graces aux Dieux,	Du bien de me revoir il rendait grâces aux Dieux,
Et ſon contentement ſe liſoit dans ſes yeux.	Et son contentement se lisait dans ses yeux.
Mais comme ie gouſtois cette douceur extreme,	Mais comme je goûtais cette douceur extrême,
Ie l'ay veu tout à coup triſte, ſanglant, & bleſme,	Je l’ai vu tout à coup triste, sanglant, et blême,
Le harnois éclatant qu'il auoit endoßé	Le harnais éclatant qu’il avait endossé
De mille eſtranges coups me ſembloit tout percé;	De mille étranges coups me semblait tout percé;
D'vne voix languiſſante, & d'vne bouche morte,	D’une voix languissante, et d’une bouche morte,
Cette ombre de mon bien m'a parlé de la ſorte.	Cette ombre de mon bien m’a parlé de la sorte.
„Ceſſe de te flatter d'vn eſpoir deceuant;	„Cesse de te flatter d’un espoir décevant;
„Mes iours ſont acheueZ, ie ne ſuis plus viuant,	„Mes jours sont achevés, je ne suis plus vivant,
„Et ton ame occupee à tant de ſacrifices,	„Et ton âme occupée à tant de sacrifices,
„Ne peut pour mon ſalut rendre les Dieux propices.	„Ne peut pour mon salut rendre les Dieux propices.
„Mars qui dans les combats enuioit ma valeur,	„Mars qui dans les combats enviait ma valeur,
„M'offrit par jalouſie en victime au malheur.	„M’offrit par jalousie en victime au malheur.
„Mais puis que ie ſuis mort auec aſſez de gloire,	„Mais puisque je suis mort avec assez de gloire,
„Fay que touſiours au moins ie viue en ta memoire.	„Fais que toujours au moins je vive en ta mémoire.
Lors le cœur tout tranſi i'ay couru l'embraſſer,	Lors le cœur tout transi j’ai couru l’embrasser,
Mais d'vn baiſer ſi froid il m'eſt venu glacer,	Mais d’un baiser si froid il m’est venu glacer,
Que par vn grand effort i'ay rompu tous ces charmes,	Que par un grand effort j’ai rompu tous ces charmes,
M'éueillant en ſurſaut les yeux couuerts de larmes.	M’éveillant en sursaut les yeux couverts de larmes.
C'eſt ce qui m'inquiete, & qui me vient troubler,	C’est ce qui m'inquiète, et qui me vient troubler,
Qui cauſe mes ſouſpirs, & qui me fais trembler:	Qui cause mes soupirs, et qui me fais trembler:
Mais Charis, que dis-tu de ce funeſte ſonge?	Mais Charis, que dis-tu de ce funeste songe?
Ie dis que ce n'eſt rien qu'vn deſplaiſant menſonge.	Je dis que ce n’est rien qu’un déplaisant mensonge.
Madame, voſtre eſprit s'entretient tout le iour	Madame, votre esprit s’entretient tout le jour
Des malheurs que peut craindre vne fidelle amour	Des malheurs que peut craindre une fidèle amour
Lors qu'aymant vn objet auecque violence,	Lors qu’aimant un objet avec violence,
On ſouffre pour long-temps les rigueurs de l'abſence.	On souffre pour longtemps les rigueurs de l’absence.
C'eſt la malignité de ces impreßions	C’est la malignité de ces impressions
Qui vous a fait auoir ces noires viſions:	Qui vous a fait avoir ces noires visions:
Mais ne vous troubleZ point de ces triſtes menfonges;	Mais ne vous troublez point de ces tristes mensonges;
Et pour n'auoir la nuict que d'agreables ſonges,	Et pour n’avoir la nuit que d’agréables songes,
Baniſſant la triſteſſe, ordonner à vos ſens	Bannissant la tristesse, ordonner à vos sens
De vous entretenir d'objets diuertiſſans;	De vous entretenir d’objets divertissants;
S'en eſt le vray ſecret:	S’en est le vrai secret:
Charis, ie te veux croire:	Charis, je te veux croire:
Mais quoy, touſiours ce ſonge occupe ma memoire.	Mais quoi, toujours ce songe occupe ma mémoire.
Vous plaiſt-il de tourner vers ces arbres couuers	Vous plaît-il de tourner vers ces arbres couverts
Qui gardent la fraiſcheur ſous leurs feüillages vers?	Qui gardent la fraîcheur sous leurs feuillages verts?
Allons:	Allons:
Ie voy par terre vn homme qui repoſe.	Je vois par terre un homme qui repose.
Il ne repoſe point, il eſcrit quelque choſe.	Il ne repose point, il écrit quelque chose.
Madame, c'eſt Araſpe, ou mon œil me deçoit:	Madame, c’est Araspe, ou mon œil me déçoit:
Paſſons derriere luy: mais il nous apperçoit.	Passons derrière lui: mais il nous aperçoit.
QV'eſt-ce qu'eſcrit Araſpe en cette ſolitude?	QU’est-ce qu’écrit Araspe en cette solitude?
Madame, c'eſt vn lieu dont ie fais mon eſtude;	Madame, c’est un lieu dont je fais mon étude;
I'y viens de compoſer en faueur d'un Amant	J’y viens de composer en faveur d’un Amant
De qui la paßion me touche tendrement.	De qui la passion me touche tendrement.
C'eſt vn Amant poßible abſent de ſa Maiſtreſſe?	C’est un Amant possible absent de sa Maîtresse?
C'eſt vn homme accablé de l'ennuy qui le preſſe;	C’est un homme accablé de l’ennui qui le presse;
Il adore vn objet außi beau que le iour,	Il adore un objet aussi beau que le jour,
Et n'a iamais oſé luy dire ſon amour.	Et n’a jamais osé lui dire son amour.
Sans doute ce reſpect le rendra plus aymable:	Sans doute ce respect le rendra plus aimable:
Madame, ce reſpect l'a rendu miſerable,	Madame, ce respect la rendu misérable,
Et c'eſt ſur ce ſubiet que i'ay fait vn diſcours,	Et c’est sur ce sujet que j’ai fait un discours,
Dont les raiſonnemens viennent a ſon ſecours,	Dont les raisonnements viennent à son secours,
Repreſentans l'ardeur de ſes flames ſecrettes:	Représentant l’ardeur de ses flammes secrètes:
Ie vous l'ay veu tantoſt eſcrire en ces Tablettes;	Je vous l’ai vu tantôt écrire en ces Tablettes;
Ie ne veux pas pourtant demander à les voir.	Je ne veux pas pourtant demander à les voir.
Madame, commandeZ, vous aueZ tout pouuoir:	Madame, commandez, vous avez tout pouvoir:
Mais icy i'ay tracé d'vn mauuais caractere	Mais ici j’ai tracé d’un mauvais caractère
Et fort confuſément, cet amoureux myſtere.	Et fort confusément, cet amoureux mystère.
Il eſt vray que par cœur i'ay peu le retenir.	Il est vrai que par cœur j’ai pu le retenir.
Vous auriez trop de peine à vous en ſouuenir.	Vous auriez trop de peine à vous en souvenir.
Madame, nullement: mais puis que l'Eloquence	Madame, nullement: mais puisque l’Éloquence
A beaucoup d’ornemens qui ſont de conſequence,	A beaucoup d’ornements qui sont de conséquence,
Afin que ce diſcours face mieux ſon effet,	Afin que ce discours face mieux son effet,
Ie le vay reciter ainſi que ie l'ay fait.	Je le vais réciter ainsi que je l’ai fait.
Vous ſçauez que pour rendre vn diſcours agreable,	Vous savez que pour rendre un discours agréable,
Auec le ton de voix le geſte eſt deſirable.	Avec le ton de voix le geste est désirable.
Mais ie ſeray contraint le recitant trop bas.	Mais je serai contraint le récitant trop bas.
Nullement, parlez haut, Charis n'eſcoute pas.	Nullement, parlez haut, Charis n’écoute pas.
Je ne celeray plus l'extreme violence	Je ne cèlerai plus l’extrême violence
Qui paroiſt en mes yeux, & parle en mon ſilence,	Qui paraît en mes yeux, et parle en mon silence,
Que le cours de mes pleurs vous a peu figurer,	Que le cours de mes pleurs vous a pu figurer,
Et dont mes longs ſouſpirs vous doiuent aſſeurer.	Et dont mes longs soupirs vous doivent assurer.
Madame, ie vous ayme; ô Cieux! le teint vous change	Madame, je vous aime; ô Cieux! le teint vous change
A la confeßion de cette erreur eſtrange,	À la confession de cette erreur étrange,
Et l'inſolent aueu d'vn crime ſans pareil,	Et l’insolent aveu d’un crime sans pareil,
Pour ma confuſion fait rougir vn Soleil	Pour ma confusion fait rougir un Soleil
