CE Livre doit avoir dequoy plaire à tout le monde, à cause de la diversité des matieres dont il est remply :	CE Livre doit avoir de quoi plaire à tout le monde, à cause de la diversité des matières dont il est rempli:
Ceux qui aiment que les Romans, y trouveront des Histoires divertissantes.	Ceux qui aiment que les Romans, y trouveront des Histoires divertissantes.
Les Curieux des Nouvelles, & les Provinciaux & les Etrangers, qui n’ont aucune connoissance de plusieurs Personnes d’une grande naissance, ou d’un grand mérite, dont ils entendent souvent parler, apprendront dans ce Volume & dans les suivans, par où ils sont recommandables, & ce qui les fait estimer.	Les Curieux des Nouvelles, et les Provinciaux et les Etrangers, qui n’ont aucune connaissance de plusieurs Personnes d’une grande naissance, ou d’un grand mérite, dont ils entendent souvent parler, apprendront dans ce Volume et dans les suivants, par où ils sont recommandables, et ce qui les fait estimer.
Lors qu’on voudra connoître quelqu’un, on n’aura qu’à le chercher dans Le Mercure Galant, si l’on veut estre bientost éclaircy de ce qu’on souhaitera d’apprendre.	Lorsqu’on voudra connaître quelqu’un, on n’aura qu’à le chercher dans Le Mercure Galant, si l’on veut être bientôt éclairci de ce qu’on souhaitera d’apprendre.
On en donnera tous les trois Mois un Volume, & dans le second on marquera les temps ausquels on les devra donner, afin que le Public les ait dorenavant à jour nommé.	On en donnera tous les trois Mois un Volume, et dans le second on marquera les temps auxquels on les devra donner, afin que le Public les ait dorénavant à jour nommé.
On y parlera à l’avenir des Provinces & des Cours Etrangères.	On y parlera à l’avenir des Provinces et des Cours Étrangères.
L’Autheur ne commence qu’à établir des correspondances, & former des habitudes d’où qu’il puisse tirer des secours considérables, afin qu’il n’arrive rien de nouveau dans le Monde dont il ne parle dans ses Lettres.	L’Auteur ne commence qu’à établir des correspondances, et former des habitudes d’où qu’il puisse tirer des secours considérables, afin qu’il n’arrive rien de nouveau dans le Monde dont il ne parle dans ses Lettres.
On ne doit regarder celles-cy que comme des Essays, & par ce qu’elles sont, on doit les juger de ce que celles qui les suivront pouront estre.	On ne doit regarder celles-ci que comme des Essais, et par ce qu’elles sont, on doit les juger de ce que celles qui les suivront pourront être.
Ainsi l’on ne doit considérer ce Volume que comme le dessein d’un Ouvrage auquel on peut adjouter beaucoup, & non comme un Ouvrage achevé.	Ainsi l’on ne doit considérer ce Volume que comme le dessein d’un Ouvrage auquel on peut ajouter beaucoup, et non comme un Ouvrage achevé.
Ceux qui auront quelques Galanteries, & quelque chose de curieux, qui méritera d’estre sçeu, pourront me l’apporter, & je feray en sorte que l’Autheur en entretienne la Personne à qui il s’adresse dans ses Lettres.	Ceux qui auront quelques Galanteries, et quelque chose de curieux, qui méritera d’être su, pourront me l’apporter, et je ferai en sorte que l’Auteur en entretienne la Personne à qui il s’adresse dans ses Lettres.
"Je crois estre encor obligé de vous avertir que ce Livre n’a rien qui ressemble au <hi rend=""i"">Journal des Sçavans</hi> :"	Je crois être encor obligé de vous avertir que ce Livre n’a rien qui ressemble au Journal des Savants:
Il ne parle que des Livres de Sciences qu’on imprime ;	Il ne parle que des Livres de Sciences qu’on imprime;
& l’on en parle icy que d’Histoires amoureuses, & que du mérite des Personnes qui en ont beaucoup, quand mesme leur plume ne produiroit aucun Ouvrage.	et l’on en parle ici que d’Histoires amoureuses, et que du mérite des Personnes qui en ont beaucoup, quand même leur plume ne produirait aucun Ouvrage.
Il n’est pas toûjours necessaire d’écrire pour avoir de l’esprit, & l’on a souvent veu des preuves du contraire.	Il n’est pas toujours nécessaire d’écrire pour avoir de l’esprit, et l’on a souvent vu des preuves du contraire.
Je dois adjoûter à tout cela, que si l’on parle icy de quelques Livres, ce n’est que de Livres de Galanteries, dont le Journal ne dit jamais rien ;	Je dois ajouter à tout cela, que si l’on parle ici de quelques Livres, ce n’est que de Livres de Galanteries, dont le Journal ne dit jamais rien;
& qu’il n’y a pas dans ce Volume trente lignes sur cette matiere.	et qu’il n’y a pas dans ce Volume trente lignes sur cette matière.
Il n’estoit pas besoin de me faire souvenir que lors que vous partîtes de Paris, je vous promis de vous mander souvent des nouvelles capables de nourrir la curiosité des plus illustres de la Province qui doit avoir le bonheur de vous posseder si long-temps.	Il n’était pas besoin de me faire souvenir que lors que vous partîtes de Paris, je vous promis de vous mander souvent des nouvelles capables de nourrir la curiosité des plus illustres de la Province qui doit avoir le bonheur de vous posséder si longtemps.
Quand on songe souvent à une Personne, on n’oublie pas facilement ce qu’on luy promet.	Quand on songe souvent à une Personne, on n’oublie pas facilement ce qu’on lui promet.
Je croy, Madame, que vous entendez bien ce que cela veut dire, & qu’il n’est pas necessaire que je m’explique davantage.	Je crois, Madame, que vous entendez bien ce que cela veut dire, et qu’il n’est pas nécessaire que je m’explique davantage.
Passons donc aux nouvelles, ou plutost à l’ordre que j’ay résolu de tenir pour vous en apprendre.	Passons donc aux nouvelles, ou plutôt à l’ordre que j’ai résolu de tenir pour vous en apprendre.
Je vous écriray tous les huit jours une fois, & vous feray un long et curieux détail de tout ce que j’auray appris pendant la Semaine.	Je vous écrirai tous les huit jours une fois, et vous ferai un long et curieux détail de tout ce que j’aurai appris pendant la Semaine.
Je vous manderay des choses que les Gazettes ne vous apprendront point, ou du moins qu’elles ne vous feront pas sçavoir avec tant de particularitez.	Je vous manderai des choses que les Gazettes ne vous apprendront point, ou du moins qu’elles ne vous feront pas savoir avec tant de particularités.
Les moindres choses qui se passeront icy, n’échaperont pas à ma plume ;	Les moindres choses qui se passeront ici, n’échapperont pas à ma plume;
Vous sçaurez les Morts & les Mariages de conséquence, avec des circonstances qui pouront quelque fois vous donner des plaisirs que ces sortes de nouvelles n’ont pas d’elles-mesmes.	Vous saurez les Morts et les Mariages de conséquence, avec des circonstances qui pourront quelque fois vous donner des plaisirs que ces sortes de nouvelles n’ont pas d’elles-mêmes.
Je tâcheray de déveloper la verité de belles actions de ceux dont la valeur se fera remarquer dans les Armées, & vous éclairciray souvent des choses dont la Renommée est toûjours mal instruite, parce qu’elle n’attend jamais pour partir qu’elle soit bien éclaircie, & que les premiers bruits qu’elle seme ne se trouvent que rarement véritables.	Je tâcherai de développer la vérité de belles actions de ceux dont la valeur se fera remarquer dans les Armées, et vous éclaircirai souvent des choses dont la Renommée est toujours mal instruite, parce qu’elle n’attend jamais pour partir qu’elle soit bien éclaircie, et que les premiers bruits qu’elle sème ne se trouvent que rarement véritables.
Je n’oubliray pas à vous parler de tous ceux qui recevront quelques bienfaits de notre Grand Monarque :	Je n’oublierai pas à vous parler de tous ceux qui recevront quelques bienfaits de notre Grand Monarque:
Il donne de si bonne grace, que bien que ses présens soient considerables, on est plus charmé d’entendre le recit de la maniere dont il les fait, que ceux qui les reçoivent ne sont ravis de la magnificence de ses dons.	Il donne de si bonne grâce, que bien que ses présents soient considérables, on est plus charmé d’entendre le récit de la manière dont il les fait, que ceux qui les reçoivent ne sont ravis de la magnificence de ses dons.
Comme on entend de temps en temps parler de Procés si extraordinaire, & si remplis d’avantures, que les romans les plus surprenans n’ont rien qui en approche, je ne manqueray pas de vous en divertir, & de vous en mander les veritables circonstances, qui ne sont jamais bien sçeuës que de ceux qui se donnent la peine de les rechercher avec soin.	Comme on entend de temps en temps parler de Procès si extraordinaire, et si remplis d’aventures, que les romans les plus surprenants n’ont rien qui en approche, je ne manquerai pas de vous en divertir, et de vous en mander les véritables circonstances, qui ne sont jamais bien sues que de ceux qui se donnent la peine de les rechercher avec soin.
La curiosité attirant à Paris non seulement quantité des plus Illustres de toutes les Provinces de France, mais encor de plusieurs Estrangers, je vous instruiray du mérite extraordinaire de ceux qui se feront admirer.	La curiosité attirant à Paris non seulement quantité des plus Illustres de toutes les Provinces de France, mais encor de plusieurs Étrangers, je vous instruirai du mérite extraordinaire de ceux qui se feront admirer.
Je vous envoyeray toutes les Pieces galantes qui auront de la reputation, comme Sonnets, Madrigaux, & autres Ouvrages semblables.	Je vous enverrai toutes les Pièces galantes qui auront de la réputation, comme Sonnets, Madrigaux, et autres Ouvrages semblables.
Je vous manderay le jugement qu’on fera de toutes les Comedies nouvelles & de tous les livres de galanterie qui s’imprimeront ;	Je vous manderai le jugement qu’on fera de toutes les Comédies nouvelles et de tous les livres de galanterie qui s’imprimeront;
je dis galanterie, parce que je ne prétens point parler de ceux qui regardent les Arts & Sciences, à cause que je ne m’en pourois si dignement acquiter que ceux qui prennent le soin d’en donner tous les quinze jours des Memoires.	je dis galanterie, parce que je ne prétends point parler de ceux qui regardent les Arts et Sciences, à cause que je ne m’en pourrais si dignement acquitter que ceux qui prennent le soin d’en donner tous les quinze jours des Mémoires.
Je feray pourtant plus que je ne vous ay promis, & j’espere vous écrire souvent quelques Avantures nouvelles en forme d’Histoires.	Je ferai pourtant plus que je ne vous ai promis, et j’espère vous écrire souvent quelques Aventures nouvelles en forme d’Histoires.
Paris est assez grand pour m’en fournir ;	Paris est assez grand pour m’en fournir;
il y arrive chaque jour des choses assez considérables ;	il y arrive chaque jour des choses assez considérables;
& ceux qui voyent un peu le Monde, apprenent souvent des avantures extraordinaires, & en sont de mesme quelquefois les témoins ;	et ceux qui voient un peu le Monde, apprennent souvent des aventures extraordinaires, et en sont de même quelquefois les témoins;
& je ne doute point que je ne puisse vous faire part presque chaque Semaine d’une Histoire nouvelle.	et je ne doute point que je ne puisse vous faire part presque chaque Semaine d’une Histoire nouvelle.
Quand Paris n’en fourniroit pas toûjours la matiere, je ne puis manquer d’en apprendre du grand nombre d’Etrangers qui sont dans cette grande Ville.	Quand Paris n’en fournirait pas toujours la matière, je ne puis manquer d’en apprendre du grand nombre d’Étrangers qui sont dans cette grande Ville.
J’adjoûteray à toutes ces choses toutes les nouvelles des Ruelles les plus galantes, & vous manderay jusques aux Modes nouvelles :	J’ajouterai à toutes ces choses toutes les nouvelles des Ruelles les plus galantes, et vous manderai jusques aux Modes nouvelles:
On est ravy en Province de les apprendre ;	On est ravi en Province de les apprendre;
& de tout ce que l’on peut mander, rien n’est souhaité avec plus de passion.	et de tout ce que l’on peut mander, rien n’est souhaité avec plus de passion.
Vous croyez bien que les Coquettes de Paris me fourniront assez dequoy vous écrire sur ce sujet, & que toutes les choses que je vous viens de promettre me fourniront separément dequoy vous entretenir d’un nombre infiny de nouvelles.	Vous croyez bien que les Coquettes de Paris me fourniront assez de quoi vous écrire sur ce sujet, et que toutes les choses que je vous viens de promettre me fourniront séparément de quoi vous entretenir d’un nombre infini de nouvelles.
Je ne vous en manderay pas beaucoup d’étrangeres, ny d’Etat ;	Je ne vous en manderai pas beaucoup d’étrangères, ni d’État;
& je vous parleray seulement de ces grandes nouvelles publiques dont s’entretiennent ceux-mesmes qui ne font point profession d’en sçavoir.	et je vous parlerai seulement de ces grandes nouvelles publiques dont s’entretiennent ceux-mêmes qui ne font point profession d’en savoir.
Comme il n’y a point de nouvelle si publique qui n’ait quelque chose de particulier, & qui n’est pas sçeu de tout le monde, je vous informeray de ce qu’en croiront ceux qui devront les mieux sçavoir que les autres.	Comme il n’y a point de nouvelle si publique qui n’ait quelque chose de particulier, et qui n’est pas su de tout le monde, je vous informerai de ce qu’en croiront ceux qui devront les mieux savoir que les autres.
Si je puis venir à bout de mon dessein, & que vous conserviez mes Lettres, elles pouront dans l’avenir servir de Memoires aux Curieux, & l’on y trouvera beaucoup de choses qui ne pourront se rencontrer ailleurs, à cause de la diversité des matieres dont elles seront remplies ;	Si je puis venir à bout de mon dessein, et que vous conserviez mes Lettres, elles pourront dans l’avenir servir de Mémoires aux Curieux, et l’on y trouvera beaucoup de choses qui ne pourront se rencontrer ailleurs, à cause de la diversité des matières dont elles seront remplies;
mais il m’importe peu qu’elles soient utiles à d’autres, pourveu qu’elles vous divertissent :	mais il m’importe peu qu’elles soient utiles à d’autres, pourvu qu’elles vous divertissent:
c’est mon unique but, & c’est pourquoi je commence par une Histoire avant que d’entrer dans le détail des nouvelles de la Semaine.	c’est mon unique but, et c’est pourquoi je commence par une Histoire avant que d’entrer dans le détail des nouvelles de la Semaine.
c’est pourquoy je commence par une Histoire, avant que d’entrer dans le détail des nouvelles de cette Semaine.	c’est pourquoi je commence par une Histoire, avant que d’entrer dans le détail des nouvelles de cette Semaine.
Un jeune Homme estant ces jours passez chez une belle Personne dont il n’estoit amoureux que par galanterie, ou plutost pour entretenir la conversation, (c’est une chose assez ordinaire, & si la pluspart de nos jeunes Gens ne parloient d’amour aux Dames & ne loüoient leurs beautez, ils n’auroient souvent rien à dire.	Un jeune Homme étant ces jours passés chez une belle Personne dont il n’était amoureux que par galanterie, ou plutôt pour entretenir la conversation, (c’est une chose assez ordinaire, et si la plupart de nos jeunes Gens ne parlaient d’amour aux Dames et ne louaient leurs beautés, ils n’auraient souvent rien à dire.
) Celuy dont je vous vais conter l’avanture, ayant loüé en gros & en détail tous les charmes de la jeune Beauté qu’il estoit venu voir, & ne sçachant plus de quoy l’entretenir, cette charmante Personne ennuyée d’entendre toûjours la mesme chose, s’assoupit un peu, & s’endormit enfin tout-à-fait, quoy qu’elle n’en eut pas dessein :	) Celui dont je vous vais conter l’aventure, ayant loué en gros et en détail tous les charmes de la jeune Beauté qu’il était venu voir, et ne sachant plus de quoi l’entretenir, cette charmante Personne ennuyée d’entendre toujours la même chose, s’assoupit un peu, et s’endormit enfin tout-à-fait, quoi qu’elle n’en eut pas dessein:
mais comme elle avoit couru le Bal la nuit precedente, & qu’elle estoit beaucoup fatiguée, & que d’ailleurs elle estoit mal divertie par celuy qui l’entretenoit, elle ne pût resister aux charmes du Sommeil.	mais comme elle avait couru le Bal la nuit précédente, et qu’elle était beaucoup fatiguée, et que d’ailleurs elle était mal divertie par celui qui l’entretenait, elle ne pût résister aux charmes du Sommeil.
Le Galant n’en fit pas de mesme ;	Le Galant n’en fit pas de même;
la beauté de cette Belle endormie, & le mouvement de son sein soûpirant, réveillerent ses sens ;	la beauté de cette Belle endormie, et le mouvement de son sein soupirant, réveillèrent ses sens;
il la regarda avec des yeux passionnez, & son cœur luy dit plusieurs fois qu’il devoit profiter de l’occasion.	il la regarda avec des yeux passionnés, et son cœur lui dit plusieurs fois qu’il devait profiter de l’occasion.
Il ne sçavoit à quoy se resoudre, lorsqu’il jetta les yeux sur un Collier de vingt mille livres qu’elle avoit à son col, & dont le ruban qui le lioit se trouva dénoüé.	Il ne savait à quoi se résoudre, lorsqu’il jeta les yeux sur un Collier de vingt mille livres qu’elle avait à son col, et dont le ruban qui le liait se trouva dénoué.
Cet Amant dont je cacheray le nom sous celuy de Cleonte, sentit tout-à-coup des mouvemens bien contraires à ceux qu’il avoit eus un moment auparavant.	Cet Amant dont je cacherai le nom sous celui de Cléonte, sentit tout-à-coup des mouvements bien contraires à ceux qu’il avait eus un moment auparavant.
Il n’y avoit pas deux jours qu’il avoit perdu son argent au jeu ;	Il n’y avait pas deux jours qu’il avait perdu son argent au jeu;
il aimoit la dépense ;	il aimait la dépense;
il ne trouvoit plus de crédit, parce qu’il devoit beaucoup ;	il ne trouvait plus de crédit, parce qu’il devait beaucoup;
& de plus, il estoit jeune & un peu fripon de son naturel.	et de plus, il était jeune et un peu fripon de son naturel.
Toutes ces choses jointes à une occasion si favorable, le firent entrer dans une tentation bien contraire à la premiere, & ses regards ne s’attacherent plus qu’au Collier.	Toutes ces choses jointes à une occasion si favorable, le firent entrer dans une tentation bien contraire à la première, et ses regards ne s’attachèrent plus qu’au Collier.
Apres l’avoir bien regardé, il tourna sa veuë du costé de la porte.	Après l’avoir bien regardé, il tourna sa vue du côté de la porte.
Il fit plus, il se leva, fit quelques tours dans la Chambre, & fut mesmes jusques sur le degré pour voir si personne ne venoit.	Il fit plus, il se leva, fit quelques tours dans la Chambre, et fut mêmes jusques sur le degré pour voir si personne ne venait.
Il trouva toutes choses favorables à son dessein, & revint auprès de Belise, (c’est ainsi que je nommeray cette Belle dans le reste de cette Histoire.	Il trouva toutes choses favorables à son dessein, et revint auprès de Bélise, (c’est ainsi que je nommerai cette Belle dans le reste de cette Histoire.
) Il ne fut pas plutost aupres d’elle, qu’il demeura immobile, & qu’il se mit à faire des reflexions.	) Il ne fut pas plutôt auprès d’elle, qu’il demeura immobile, et qu’il se mit à faire des réflexions.
Je suis seul icy, dit il en luy-mesme, & l’on ne pourra accuser que moy d’avoir pris ce Collier.	Je suis seul ici, dit il en lui-même, et l’on ne pourra accuser que moi d’avoir pris ce Collier.
Si je sors sans rien dire, je me rendray criminel ;	Si je sors sans rien dire, je me rendrai criminel;
& si je demeure après l’avoir pris, on le cherchera par tout, & l’on ne manquera pas de le trouver sur moy quelque chose que je fasse pour le bien cacher.	et si je demeure après l’avoir pris, on le cherchera par tout, et l’on ne manquera pas de le trouver sur moi quelque chose que je fasse pour le bien cacher.
Il vaut mieux que j’abandonne ce dessein.	Il vaut mieux que j’abandonne ce dessein.
Si je l’abandonne, reprit il aussi-tost en luy-mesme, je seray indigne que la Fortune fasse jamais rien pour moy, & vingt mille francs accommoderont bien mes affaires.	Si je l’abandonne, reprit il aussitôt en lui-même, je serai indigne que la Fortune fasse jamais rien pour moi, et vingt mille francs accommoderont bien mes affaires.
Il fit alors dans sa teste un memoire de toutes les choses à quoy il employeroit ces vingt mille livres.	Il fit alors dans sa teste un mémoire de toutes les choses à quoi il emploierait ces vingt mille livres.
Il en paya peu de debtes, mais en récompense il se fit une Caleche & des Habits bien magnifiques :	Il en paya peu de dettes, mais en récompense il se fit une Calèche et des Habits bien magnifiques:
Il en mit beaucoup en Point, & habilla son Train des plus belles Livrées du Monde ;	Il en mit beaucoup en Point, et habilla son Train des plus belles Livrées du Monde;
& sur cet ajustement il se tint seûr de la conqueste du cœur d’une douzaine de ces Femmes qui n’aiment que les Gens du bel air, qui se rendent à l’éclat plutost qu’au mérite, & qui croyent que l’on ne peut estre honneste Homme avec un ajustement modeste & un train ;	et sur cet ajustement il se tint sûr de la conquête du cœur d’une douzaine de ces Femmes qui n’aiment que les Gens du bel air, qui se rendent à l’éclat plutôt qu’au mérite, et qui croient que l’on ne peut être honnête Homme avec un ajustement modeste et un train;
mediocre.	médiocre.
Les vingt mille livres ainsi distribuées dans la teste de Cleonte, il prit le Collier ;	Les vingt mille livres ainsi distribuées dans la teste de Cléonte, il prit le Collier;
mais il n’en fut pas plutost maistre, qu’il sentit un tremblement par tout son corps ;	mais il n’en fut pas plutôt maître, qu’il sentit un tremblement par tout son corps;
& la peur d’en estre trouvé saisi l’ayant pris, il résolut de le remettre.	et la peur d’en être trouvé saisi l’ayant pris, il résolut de le remettre.
Il estoit sur le point de faire ce que ce repentir secret luy conseilloit, lors qu’il s’avisa d’avaler ce Collier qui estoit de trente-deux perles.	Il était sur le point de faire ce que ce repentir secret lui conseillait, lors qu’il s’avisa d’avaler ce Collier qui était de trente-deux perles.
C’estoit assez d’affaire, mais le desir d’avoir de l’argent l’en fit venir à bout.	C’était assez d’affaire, mais le désir d’avoir de l’argent l’en fit venir à bout.
Quand il eut avalé la derniere perle, il se trouva embarassé du ruban ;	Quand il eut avalé la dernière perle, il se trouva embarrassé du ruban;
il rêva quelque temps à ce qu’il en devoit faire, puis il s’avisa de le couper, ce qu’il fit en morceaux si menus, qu’ils estoient imperceptibles.	il rêva quelque temps à ce qu’il en devait faire, puis il s’avisa de le couper, ce qu’il fit en morceaux si menus, qu’ils étaient imperceptibles.
Comme il falut beaucoup de temps pour toutes ces choses, il est aisé de s’imaginer que Belise s’éveilla bien-tost apres.	Comme il fallut beaucoup de temps pour toutes ces choses, il est aisé de s’imaginer que Bélise s’éveilla bientôt après.
Elle demanda aussi-tost son Collier.	Elle demanda aussitôt son Collier.
Cleonte se defendit de l’avoir pris.	Cléonte se défendit de l’avoir pris.
Elle crût qu’il avoit dessein de le luy faire chercher, & tourna d’abord la chose fort galamment ;	Elle crût qu’il avait dessein de le lui faire chercher, et tourna d’abord la chose fort galamment;
mais elle fut bien surprise, lors qu’elle vit qu’il se defendoit avec tout le sérieux d’un Homme qui veut faire croire que ce qu’il dit est veritable.	mais elle fut bien surprise, lors qu’elle vit qu’il se défendait avec tout le sérieux d’un Homme qui veut faire croire que ce qu’il dit est véritable.
Si vous voulez, luy dit-il, me faire donner un autre Habit, je le mettray en presence de ceux que vous ordonnerez, & je laisseray le mien ;	Si vous voulez, lui dit-il, me faire donner un autre Habit, je le mettrai en présence de ceux que vous ordonnerez, et je laisserai le mien;
je me dépoüilleray tout nud ;	je me dépouillerai tout nu;
& je changeray mesme de linge.	et je changerai même de linge.
Belise se trouva dans un embaras inconcevable :	Bélise se trouva dans un embarras inconcevable:
Elle estoit assurée qu’elle avoit son Collier avant que de s’endormir, & Cleonte estoit le seul qui fut entré dans sa Chambre, & cependant son Colier ne se trouvoit point, quoy qu’elle eut fait une recherche aussi exacte que sa peine estoit grande.	Elle était assurée qu’elle avait son Collier avant que de s’endormir, et Cléonte était le seul qui fut entré dans sa Chambre, et cependant son Collier ne se trouvait point, quoi qu’elle eut fait une recherche aussi exacte que sa peine était grande.
Cleonte la pressa de foüiller dans ses poches :	Cléonte la pressa de fouiller dans ses poches:
Elle crût que puis qu’il l’en pressoit tant, qu’elle l’y trouveroit, &amp;	Elle crût que puis qu’il l’en pressait tant, qu’elle l’y trouverait, et
qu’il n’avoit voulu que l’embarasser ;	qu’il n’avait voulu que l’embarrasser;
ce qui fut cause qu’elle se résolut de le satisfaire :	ce qui fut cause qu’elle se résolut de le satisfaire:
mais justement dans le temps qu’elle y mettoit la main, Clidamant entra dans la Chambre, & crût qu’elle l’embrassoit.	mais justement dans le temps qu’elle y mettait la main, Clidamant entra dans la Chambre, et crût qu’elle l’embrassait.
"Ce Clidamant avoit le privilege qu’ont tous les Amans, que l’on nomme <hi rend=""i"">les Tenans</hi> ;"	Ce Clidamant avait le privilège qu’ont tous les Amans, que l’on nomme les Tenants;
il entroit de plein pied, sans faire dire qu’il estoit à la porte.	il entrait de plein pied, sans faire dire qu’il était à la porte.
Vous ne vous étonnerez pas apres cela, Madame, d’aprendre qu’il fit tout ce que les Jaloux emportez ont coûtume de faire quand ils croyent qu’on leur manque de foy :	Vous ne vous étonnerez pas après cela, Madame, d’apprendre qu’il fit tout ce que les Jaloux emportez ont coutume de faire quand ils croient qu’on leur manque de foi:
Il ne pût retenir ses transports ;	Il ne pût retenir ses transports;
Cleonte en fut ravy, au lieu d’en paroistre affligé :	Cléonte en fut ravi, au lieu d’en paraître affligé:
il crût que ce bruit feroit cesser de parler du Collier ;	il crût que ce bruit ferait cesser de parler du Collier;
& comme il avoit de la bravoure (car pour du cœur on ne peut dire qu’il en eut apres les trente-deux pilulles qu’il avoit avalées) il dit à Clidamant qu’il l’alloit attendre dehors pour vuider leur differend.	et comme il avait de la bravoure (car pour du cœur on ne peut dire qu’il en eut après les trente-deux pilules qu’il avait avalées) il dit à Clidamant qu’il l’allait attendre dehors pour vider leur different.
Ce Jaloux se preparoit à le suivre, lors que Belise les arresta tous deux, & raconta l’avanture qui venoit d’arriver.	Ce Jaloux se préparait à le suivre, lors que Bélise les arrêta tous deux, et raconta l’aventure qui venait d’arriver.
Clidamant la trouva si extraordinaire, qu’il n’y pût d’abord adjoûter foy, & sa jalousie fut cause qu’il se résolut de mettre tout en usage pour découvrir si Belise luy avoit dit vray.	Clidamant la trouva si extraordinaire, qu’il n’y pût d’abord ajouter foi, et sa jalousie fut cause qu’il se résolut de mettre tout en usage pour découvrir si Bélise lui avait dit vrai.
Il rêvoit aux moyens de venir à bout de son dessein, lors que deux ou trois Amis de cette Belle affligée, & qui l’estoient aussi de Clidamant, entrerent dans la Chambre.	Il rêvait aux moyens de venir à bout de son dessein, lors que deux ou trois Amis de cette Belle affligée, et qui l’étaient aussi de Clidamant, entrèrent dans la Chambre.
Ils n’y furent pas longtemps sans apprendre ce qui venoit d’arriver :	Ils n’y furent pas longtemps sans apprendre ce qui venait d’arriver:
Leur étonnement fut grand, mais il le fut encore plus lors qu’ils virent que rien ne pouvoit faire dire à Cleonte ce qu’estoit devenu le Collier.	Leur étonnement fut grand, mais il le fut encore plus lors qu’ils virent que rien ne pouvait faire dire à Cléonte ce qu’était devenu le Collier.
Les prieres & les menaces furent employées, mais ce fut toûjours inutilement, & l’apresdînée se passa sans qu’on pût rien découvrir.	Les prières et les menaces furent employées, mais ce fut toujours inutilement, et l’après-dînée se passa sans qu’on pût rien découvrir.
Le dépit que Belise avoit de la perte de son Collier augmenta à mesure qu’elle perdit l’esperance de le revoir ;	Le dépit que Bélise avait de la perte de son Collier augmenta à mesure qu’elle perdit l’espérance de le revoir;
ce qui fut cause qu’elle assura que Cleonte l’avait volé, & que c’estoit luy qui l’avoit mis où il estoit ;	ce qui fut cause qu’elle assura que Cléonte l’avait volé, et que c’était lui qui l’avait mis où il était;
qu’il falloit ou qu’il l’eut caché, ou qu’il l’eut jetté à quelqu’un par la fenestre.	qu’il fallait ou qu’il l’eut caché, ou qu’il l’eut jeté à quelqu’un par la fenêtre.
La maniere dont Belise parla, fit croire à ces Messieurs qu’il estoit vray ;	La manière dont Bélise parla, fit croire à ces Messieurs qu’il était vrai;
ce qui les obligea quand la nuit fut tout-à-fait venuë, d’envoyer quérir un Sac.	ce qui les obligea quand la nuit fut tout-à-fait venue, d’envoyer quérir un Sac.
Ils ne l’eurent pas plutost, qu’ils prirent Cleonte à quatre, & se mirent par force dedans ;	Ils ne l’eurent pas plutôt, qu’ils prirent Cléonte à quatre, et se mirent par force dedans;
& l’ayant bien lié, il se porterent sur la fenestre.	et l’ayant bien lié, il se portèrent sur la fenêtre.
Cette fenestre estoit au second étage, & donnoit dans une Court remplie de pierre de taille, parce que on y bâtissoit.	Cette fenêtre était au second étage, et donnait dans une Court remplie de pierre de taille, parce que on y bâtissait.
Dés qu’il fut sur cette fenestre, ils le menacerent de le jetter en bas, s’il n’avoüoit ce qu’il avoit fait du Collier.	Dés qu’il fut sur cette fenêtre, ils le menacèrent de le jeter en bas, s’il n’avouait ce qu’il avait fait du Collier.
Ils luy firent tant de peur, qu’il demeura d’accord qu’il l’avoit.	Ils lui firent tant de peur, qu’il demeura d’accord qu’il l’avait.
Il promit de le rendre, mais il demanda du temps :	Il promit de le rendre, mais il demanda du temps:
on luy en donna, mais ce ne fut qu’à condition qu’il diroit ce qu’il en avoit fait.	on lui en donna, mais ce ne fut qu’à condition qu’il dirait ce qu’il en avait fait.
Il s’en défendit quelque temps ;	Il s’en défendit quelque temps;
mais se voyant pressé de trop près, il avoüa la vérité.	mais se voyant pressé de trop près, il avoua la vérité.
On le mit au mesme instant hors du Sac ;	On le mit au même instant hors du Sac;
on le deshabilla malgré luy, & on le coucha dans un Lit magnifique.	on le déshabilla malgré lui, et on le coucha dans un Lit magnifique.
Un de ces Meilleurs se donna apres la peine d’aller quérir une Medecine ;	Un de ces Meilleurs se donna après la peine d’aller quérir une Médecine;
il eut soin qu’elle fut tres-forte, &amp;	il eut soin qu’elle fut très forte, et
l’opération qu’elle fit le va bien faire connoistre.	l’opération qu’elle fit le va bien faire connaître.
Cleonte resista longtemps avant que de la prendre ;	Cléonte résista longtemps avant que de la prendre;
mais à la fin il s’y résolut, de peur de scandale ;	mais à la fin il s’y résolut, de peur de scandale;
car on le menaça de le mener en prison, s’il ne la prenoit, & de publier par tout qu’il estoit un Voleur.	car on le menaça de le mener en prison, s’il ne la prenait, et de publier par tout qu’il était un Voleur.
Ses tranchées furent grandes, & il souffroit beaucoup, mais enfin il rendit à plusieurs fois trente-une perles :	Ses tranchées furent grandes, et il souffrait beaucoup, mais enfin il rendit à plusieurs fois trente-une perles:
Il en restoit une, il offrit de la payer plus qu’elle ne valoit ;	Il en restait une, il offrit de la payer plus qu’elle ne valait;
mais Clidamant voulut qu’il prit encor une Medecine :	mais Clidamant voulut qu’il prit encor une Médecine:
Elle le fit beaucoup souffrir avant que de luy faite rendre la trente-deuxiéme perle ;	Elle le fit beaucoup souffrir avant que de lui faite rendre la trente-deuxième perle;
mais enfin elle vint, & l’on donna congé à ce pauvre infortuné.	mais enfin elle vint, et l’on donna congé à ce pauvre infortuné.
Il s’en retourna purgé pour sa vie, & plus abattu qu’il n’auroit esté apres une maladie de six mois.	Il s’en retourna purgé pour sa vie, et plus abattu qu’il n’aurait été après une maladie de six mois.
Voila, Madame, une Avanture arrivée depuis quelques jours, & qui n’est encor connue que de tres-peu de personnes :	Voila, Madame, une Aventure arrivée depuis quelques jours, et qui n’est encor connue que de très peu de personnes:
Elle a quelque chose de si nouveau, que je ne croy pas que vous ayez jamais rien lû de semblable.	Elle a quelque chose de si nouveau, que je ne crois pas que vous ayez jamais rien lu de semblable.
Passons à des nouvelles qui sont plus publiques.	Passons à des nouvelles qui sont plus publiques.
