NOn, ce n’eſt point un choix, qui pour ces deux Amans,	Non, ce n'est point un choix, qui pour ces deux Amants,
Sceut régler de mon cœur les ſecrets ſentimens;	Sut régler de mon cœur les secrets sentiments;
Et le Prince n’a point dans tout ce qu’il peut étre:	Et le Prince n'a point dans tout ce qu'il peut être:
Ce qui fit preferer l’amour qu'il fait paroître.	Ce qui fit préférer l'amour qu'il fait paraître.
D. Sylve comme lui fit briller à mes yeux	D. Sylve comme lui, fit briller à mes yeux
Toutes les qualitez d’un Heros glorieux;	Toutes les qualités d'un Héros glorieux;
Même éclat de vertus, joint à même naiſſance,	Même éclat de vertus, joint à même naissance,
Me parloit en tous deux pour cette preference;	Me parlait en tous deux pour cette préférence;
Et je ſerois encor à nommer le vainqueur,	Et je serais encore à nommer le vainqueur,
Si le merite ſeul prenoit droit ſur un cœur.	Si le mérite seul prenait droit sur un cœur.
Mais ces chaînes du Ciel, qui tombent ſur nos ames,	Mais ces chaînes du Ciel qui tombent sur nos âmes,
Deciderent en moi le deſtin de leurs flâmes;	Décidèrent en moi le destin de leurs flammes;
Et toute mon eſtime égale entre les deux,	Et toute mon estime, égale entre les deux,
Laiſſa vers D. Garcie entraîner tous mes voeux.	Laissa vers D. Garcie entraîner tous mes vœux.
Cet amour que pour lui vôtre aſtre vous inſpire,	Cet amour que pour lui votre astre vous inspire,
N’a ſur vos actions pris que bien peu d’empire;	N'a sur vos actions pris que bien peu d'empire;
Puiſque nos yeux. Madame, ont pû long-tems douter	Puisque nos yeux, Madame, ont pu longtemps douter
Qui de ces deux Amans vous vouliez mieux traiter.	Qui de ces deux Amants vous vouliez mieux traiter.
De ces nobles Rivaux l’amoureuſe pourſuite,	De ces nobles Rivaux l'amoureuse poursuite,
A de fâcheux combats, Eliſe, m’a reduite.	À de fâcheux combats, Élise, m'a réduite.
Quand je regardois l’un, rien ne me reprochoit	Quand je regardais l'un, rien ne me reprochait
Le tendre mouvement où mon ame panchoit;	Le tendre mouvement où mon âme penchait;
Mais je me l’imputois à beaucoup d’injuſtice,	Mais je me l'imputais à beaucoup d'injustice,
Quand de l’autre à mes yeux s’offroit le ſacrifice.	Quand de l'autre à mes yeux s'offrait le sacrifice.
Et Dom Silve, aprés tout, dans les ſoins amoureux	Et Dom Sylve, après tout, dans ses soins amoureux
Me ſembloit meriter un deſtin plus heureux.	Me semblait mériter un destin plus heureux.
Je m'oppoſois encor, ce qu’au ſang de Caſtille,	Je m'opposais encore ce qu'au sang de Castille
Du feu Roi de Leon, ſemble devoir la Fille;	Du feu Roi de Léon semble devoir la Fille;
Et la longue amité, qui d’un étroit lien	Et la longue amitié qui d'un étroit lien
Joignit les interéts, de ſon Pere & du mien.	Joignit les intérêts de son père et du mien.
Ainſi plus dans mon ame un autre prenoit place.	Ainsi plus dans mon âme un autre prenait place.
Plus de tous ſes reſpects je plaignois la diſgrace:	Plus de tous ses respects je plaignais la disgrâce:
Ma pitié complaiſante à ſes brulans ſoupirs,	Ma pitié complaisante à ses brûlants soupirs,
D’un dehors favorable amuſoit ſes deſirs;	D'un dehors favorable amusait ses désirs;
Et vouloit reparer par ce foible avantage,	Et voulait réparer, par ce faible avantage,
Ce qu’au fond de mon cœur je lui faiſois d’outrage.	Ce qu'au fond de mon cœur je lui faisais d'outrage.
Mais ſon premier amour que vous avez appris,	Mais son premier amour, que vous avez appris,
Doit de cette contrainte affranchir vos eſprits.	Doit de cette contrainte affranchir vos esprits.
Et puis qu’avant ſes ſoins, où pour vous il s’engage,	Et puisqu'avant ses soins, où pour vous il s'engage,
Done Ignés de ſon cœur avoir receu l’hommage;	Done Ignès de son cœur avait reçu l'hommage;
Et que par des liens auſſi fermes que doux	Et que par des liens aussi fermes que doux
L’amitié vous unit cette Comteſſe & vous.	L'amitié vous unit, cette Comtesse et vous.
Son ſecret revelé vous eſt une matiere	Son secret révélé vous est une matière
A donner à vos vœux liberté toute entière;	À donner à vos vœux liberté toute entière;
Et vous pouvez ſans crainte à cet Amant confus	Et vous pouvez sans crainte à cet Amant confus
D’un devoir d'amitié couvrir tous vos refus.	D'un devoir d'amitié couvrir tous vos refus.
Il eſt vrai que j'ai lieu de cherir la nouvelle,	Il est vrai que j'ai lieu de chérir la nouvelle,
Qui m’apprit que D. Silve étoit un infidelle;	Qui m'apprit que D. Sylve était un infidèle;
Puiſque par ſes ardents mon cœur tiranniſé	Puisque par ses ardeurs mon cœur tyrannisé
Contre elles à preſent ſe voit authoriſé.	Contre elles à présent se voit autorisé.
Qu’il en peut juſtement combattre les hommages,	Qu'il en peut justement combattre les hommages,
Et ſans ſcrupule ailleurs donner tous ſes ſuffrages.	Et sans scrupule ailleurs donner tous ses suffrages.
Mais enfin qu’elle joye en peut prendre ce coeur,	Mais enfin quelle joie en peut prendre ce cœur,
Si d’une autre contrainte il ſouffre la rigueur?	Si d'une autre contrainte il souffre la rigueur?
Si d’un Prince jaloux l’éternelle foibleſſe,	Si d'un Prince jaloux l'éternelle faiblesse,
Reçoit indignement les ſoins de ma tendreſſe:	Reçoit indignement les soins de ma tendresse:
Et ſemble preparer dans mon juſte courroux	Et semble préparer dans mon juste courroux
Un éclat à briſer tout commerce entre nous?	Un éclat à briser tout commerce entre nous?
Mais ſi de vôtre bouche il n’a point ſçeu ſa gloire,	Mais si de votre bouche il n'a point su sa gloire,
Eſt-ce crime pour lui que de n'oſer la croire?	Est-ce un crime pour lui que de n'oser la croire?
Et ce que d’un rival a pû flatter les feux,	Et ce qui d'un rival a pu flatter les feux,
L’authoriſe-t’il pas à douter de vos vœux!	L'autorise-t-il pas à douter de vos vœux!
Non, non, de cette sombre, & lâche jalouſie	Non, non, de cette sombre, et lâche jalousie
Rien ne peut excuſer l'étrange freneſie;	Rien ne peut excuser l'étrange frénésie;
Et par mes actions je l’ai trop informé,	Et par mes actions je l'ai trop informé,
Qu’il peut bien se flatter du bonheur d’être aimé.	Qu'il peut bien se flatter du bonheur d'être aimé.
Sans employer la langue, il eſt des interpretes	Sans employer la langue, il est des interprètes
Qui parlent clairement des atteintes ſecretes.	Qui parlent clairement des atteintes secrètes.
Un soupir, un regard, une simple rougeur,	Un soupir, un regard, une simple rougeur,
Un ſilence eſt aſſez pour expliquer un cœur.	Un silence est assez pour expliquer un cœur.
Tour parle dans l’amour, & ſur cette matiere	Tout parle dans l'amour, et sur cette matière
Le moindre jour doit être une grande lumière;	Le moindre jour doit être une grande lumière;
Puiſque chez nôtre Sexe, où l’honneur eſt puiſſant,	Puisque chez notre Sexe, où l'honneur est puissant,
On ne montre jamais tout ce que l’on reſſent.	On ne montre jamais tout ce que l'on ressent.
J’ai voulu, je l’avoüe, ajuſter ma conduite,	J'ai voulu, je l'avoue, ajuster ma conduite,
Et voir d’un œil égal, l’un & l’autre merite:	Et voir d'un œil égal, l'un et l'autre mérite:
Mais que contre ſes vœux on combat vainement,	Mais que contre ses vœux on combat vainement,
Et que la difference eſt connüe aiſement,	Et que la différence est connue aisément,
De toutes ces faveurs qu’on fait avec étude	De toutes ces faveurs qu'on fait avec étude
A celles où du cœur fait pancher l’habitude.	À celles où du cœur fait pencher l'habitude.
Dans les unes toûjours, on paroît ſe forcer;	Dans les unes toujours, on paraît se forcer;
Mais les autres, helas! ſe font ſans y penser,	Mais les autres, hélas! Se font sans y penser,
Semblables à ces eaux, ſi pures & ſi belles,	Semblables à ces eaux, si pures et si belles,
Qui coulent ſans effort des ſources naturelles.	Qui coulent sans effort des sources naturelles.
Ma pitié pour D. Sylve, avoir beau l'émouvoir,	Ma pitié pour D. Sylve, avait beau l'émouvoir,
J’en trahiſſois les ſoins, ſans m’en apperçevoir.	J'en trahissais les soins, sans m'en apercevoir.
Et mes regards au Prince, en un pareil martyre	Et mes regards au Prince, en un pareil martyre
En diſoient toujours plus, que je n'en voulois dire.	En disaient toujours plus, que je n'en voulais dire.
Enfin, ſi les ſoupçons de cet illuſtre Amant,	Enfin, si les soupçons de cet illustre Amant,
Puiſque vous le voulez n’ont point de fondement?	Puisque vous le voulez, n'ont point de fondement?
Pour le moins font-ils foy d'une ame bien atteinte,	Pour le moins font-ils foi d'une âme bien atteinte,
Et d’autres cheriroient ce qui fait vôtre plainte.	Et d'autres chériraient ce qui fait votre plainte.
De jaloux mouvemens doivent être odieux,	De jaloux mouvements doivent être odieux,
S’ils partent d’un amour qui deplaiſe à nos yeux.	S'ils partent d'un amour qui déplaise à nos yeux.
Mais tout ce qu’un Amant nous peut montrer d'allarmes,	Mais tout ce qu'un Amant nous peut montrer d'alarmes,
Doit lorsque nous l’aimons, avoir pour nous des charmes;	Doit lorsque nous l'aimons, avoir pour nous des charmes;
C’eſt par là que ſon feu ſe peut mieux exprimer,	C'est par là que son feu se peut mieux exprimer,
Et plus il eſt jaloux, plus nous devons l’aimer;	Et plus il est jaloux, plus nous devons l'aimer;
Ainſi puiſqu’en vôtre ame une Prince magnanime....	Ainsi puisqu'en votre âme un Prince magnanime…
Ah! ne m’avancez point cette étrange maxime.	Ah! ne m'avancez point cette étrange maxime.
Par tout la jalouſie est un monſtre odieux,	Partout la jalousie est un monstre odieux,
Rien n’en peut adoucir les traits injurieux;	Rien n'en peut adoucir les traits injurieux;
Et plus l’amour eſt cher, qui lui donne naiſſance	Et plus l'amour est cher, qui lui donne naissance
Plus on doit reſſentir les coups de cette offence.	Plus on doit ressentir les coups de cette offense.
Voir un Prince emporté, qui perd à tous momens	Voir un Prince emporté, qui perd à tous moments
Le reſpect que l’amour inspire aux vrais Amans:	Le respect que l'amour inspire aux vrais Amants:
Qui dans les ſoins jaloux, où ſon ame ſe noye,	Qui dans les soins jaloux où son âme se noie,
Querelle également mon chagrin, & ma joye;	Querelle également mon chagrin, et ma joie;
Et dans tous mes regards ne peut rien remarquer,	Et dans tous mes regards ne peut rien remarquer,
Qu’en faveur d’un Rival il ne veüille expliquer.	Qu'en faveur d'un Rival il ne veuille expliquer.
Non, non, par ces ſoupçons je ſuis trop offencée,	Non, non, par ces soupçons je suis trop offensée,
Et ſans déguiſement je te dis ma penſée.	Et sans déguisement je te dis ma pensée.
Le Prince D. Garcie eſt cher à mes deſirs,	Le Prince D. Garcie est cher à mes désirs,
Il peut d’un cœur illuſtre échaufer les ſoupirs:	Il peut d'un cœur illustre échauffer les soupirs:
Au milieu de Leon, on a veu ſon courage	Au milieu de Léon, on a vu son courage
Me donner de ſa flame un noble témoignage,	Me donner de sa flamme un noble témoignage,
Braver en ma faveur des perils les plus grands,	Braver en ma faveur des périls les plus grands,
M’enlever aux deſſeins de nos lâches tyrans;	M'enlever aux desseins de nos lâches tyrans;
Et dans ces murs forcez mettre ma destinée,	Et dans ces murs forcés mettre ma destinée,
A couvert des horreurs d’un indigne hymenée;	À couvert des horreurs d'un indigne hyménée;
Et je ne cele point que jaurois de l’ennui,	Et je ne cèle point que j'aurais de l'ennui,
Que la gloire en fût deüe à quelqu'autre qu’à lui;	Que la gloire en fût due à quelque autre qu'à lui;
Car un coeur amoureux prend un plaiſir extréme,	Car un cœur amoureux prend un plaisir extrême,
A ſe voir redevable, Eliſe, à ce qu’il aime;	À se voir redevable, Élise, à ce qu'il aime;
Et ſa flâme timide oſe mieux éclater,	Et sa flamme timide ose mieux éclater,
Lors qu'en favoriſant, elle croît s’acquiter.	Lorsqu'en favorisant, elle croit s'acquitter.
Oüi, j’aime qu’un ſecours qui hazarde ſa tête	Oui, j'aime qu'un secours qui hasarde sa tête
Semble à ſa paſſion donner droict de conquête.	Semble à sa passion donner droit de conquête.
J'aime que mon peril m’ait jettée en ſes mains,	J'aime que mon péril m'ait jetée en ses mains,
Et ſi les bruits communs ne ſont pas des bruits vains	Et si les bruits communs ne sont pas des bruits vains
Si la bonté du Ciel nous rameine mon Frere,	Si la bonté du Ciel nous ramène mon Frère,
Les voeux les plus ardens, que mon cœur puiſſe faire	Les vœux les plus ardents, que mon cœur puisse faire,
C’eſt que ſon bras encor, ſur un perfide ſang	C'est que son bras encor, sur un perfide sang
Puiſſe aider à ce Frere, à reprendre ſon rang,	Puisse aider à ce Frère, à reprendre son rang,
Et par d’heureux ſuccez d’une haute vaillance	Et par d'heureux succès d'une haute vaillance
Meriter tous les ſoins de ſa reconnoiſſance.	Mériter tous les soins de sa reconnaissance.
Mais avec tour cela, s’il pouſſe mon courroux,	Mais avec tout cela, s'il pousse mon courroux,
S’il ne purge ſes feux de leurs tranſports jaloux,	S'il ne purge ses feux de leurs transports jaloux,
Et ne les range aux loix, que je lui veux précrire,	Et ne les range aux lois, que je lui veux prescrire,
C’eſt inutilement qu’il pretend Done Eluire.	C'est inutilement qu'il prétend Done Elvire.
L’hymen ne peut nous joindre, & j’abhorre des nœuds,	L'hymen ne peut nous joindre, et j'abhorre des nœuds,
Qui deviendroient ſans doute un Enfer pour tous deux.	Qui deviendraient sans doute un Enfer pour tous deux.
Bien que l'on pût avoir des ſentimens tout autres,	Bien que l'on pût avoir des sentiments tout autres,
C’eſt au Prince, Madame, à ſe regler, aux vôtres,	C'est au Prince, Madame, à se régler, aux vôtres,
Et dans vôtre billet ils ſont ſi bien marquez....	Et dans votre billet ils sont si bien marqués…
Je n'y veux point, Eliſe, employer cette lettre,	Je n'y veux point, Élise, employer cette lettre,
C’eſt un ſoin qu’à ma bouche, il me vaut mieux commettre.	C'est un soin qu'à ma bouche, il me vaut mieux commettre.
La faveur d'un écrit laiſſe aux mains d’un Amant	La faveur d'un écrit laisse aux mains d'un Amant
Des témoins trop conſtans de nôtre attachement:	Des témoins trop constants de notre attachement:
Ainſi donc empêchez, qu’au Prince on ne la livre.	Ainsi donc empêchez, qu'au Prince on ne la livre.
Toutes vos volontez ſont des loix qu’on doit ſuivre.	Toutes vos volontés sont des lois qu'on doit suivre.
J’admire cependant que le Ciel ait jetté	J'admire cependant que le Ciel ait jeté
Dans le goût des eſprits tant de diverſité,	Dans le goût des esprits tant de diversité,
Et que ce que les uns regardent comme outrage,	Et que ce que les uns regardent comme outrage,
Soit veu par d’autres yeux ſous un autre viſage.	Soit vu par d'autres yeux sous un autre visage.
Pour moi je trouverois mon ſort tour-à-fait doux,	Pour moi je trouverais mon sort tout à fait doux,
Si j’avois un Amant qui pût étre jaloux;	Si j'avais un Amant qui pût être jaloux;
Je ſçaurois m’applaudir de ſon inquiétude;	Je saurais m'applaudir de son inquiétude;
Et ce qui pour mon ame eſt ſouvent un peu rude,	Et ce qui pour mon âme est souvent un peu rude,
C’eſt de voir D. Alvar ne prendre aucun ſouci.	C'est de voir D. Alvar ne prendre aucun souci.
Nous ne le croyons pas ſi proches, le voici.	Nous ne le croyions pas si proche, le voici.
VOtre retour ſurprend, qu’avez vous à m'apprendre?	VOtre retour surprend, qu'avez-vous à m'apprendre?
Dom Alphonſe vient-il, a t'on lieu de l'attendre?	Dom Alphonse vient-il, a-t-on lieu de l'attendre?
Oüi, Madame, & ce Frere en Caſtille élevé	Oui, Madame, et ce Frère en Castille élevé
De rentrer dans ſes droits voit le tems arrivé.	De rentrer dans ses droits voit le temps arrivé.
Jusqu'ici D. Loüis qui vit à ſa prudence	Jusqu'ici D. Louis qui vit à sa prudence
Par le feu Roi mourant, commettre ſon enfance,	Par le feu Roi mourant, commettre son enfance,
A caché ſes deſtins aux yeux de tout l’état,	A caché ses destins aux yeux de tout l'état,
Pour l’ôter aux fureurs du traître Mauregat.	Pour l'ôter aux fureurs du traître Mauregat.
Et bien que le tiran, depuis ſa lâche audace,	Et bien que le tyran, depuis sa lâche audace,
L’ait ſouvent demandé pour lui rendre ſa place,	L'ait souvent demandé pour lui rendre sa place,
Jamais ſon zele ardent n’a pris de ſeureté,	Jamais son zèle ardent n'a pris de sûreté,
A l'appas dangereux de ſa fauſſe équité,	À l'appas dangereux de sa fausse équité,
Mais les peuples émeus par cette violence	Mais les peuples émus par cette violence
Que vous a voulu faire une injuſte puiſſance,	Que vous a voulu faire une injuste puissance,
Ce genereux Vieillard a cru qu’il étoit tems	Ce généreux Vieillard a cru qu'il était temps
D'éprouver le ſuccés d’un eſpoir de vingt ans.	D'éprouver le succès d'un espoir de vingt ans.
Il a tenté Leon, & ſes fidelles trames,	Il a tenté Léon, et ses fidèles trames,
Des grands, comme du peuple, ont pratiqué les ames:	Des grands comme du peuple ont pratiqué les âmes:
Tandis que la Caſtille armoit dix mille bras,	Tandis que la Castille armait dix mille bras,
Pour redonner ce Prince aux vœux de ſes Etats;	Pour redonner ce Prince aux vœux de ses États;
Il fait auparavant ſemer ſa renommée,	Il fait auparavant semer sa renommée,
Et ne veux le montrer qu’en tête d’une armée.	Et ne veut le montrer qu'en tête d'une armée.
Que tout prét à lancer le foudre puniſſeur,	Que tout prêt à lancer le foudre punisseur,
Sous qui doit ſuccomber un lâche raviſſeur.	Sous qui doit succomber un lâche ravisseur.
On inveſtit Leon, & Dom Silve en perſonne	On investit Léon, et Dom Sylve en personne
Commande le ſecours que ſon Pere vous donne.	Commande le secours que son Père vous donne.
Un ſecours ſi puiſſant doit flater nôtre eſpoir;	Un secours si puissant doit flatter notre espoir;
Mais je crains que mon Frere y puiſſe trop devoir.	Mais je crains que mon Frère y puisse trop devoir.
Mais, Madame, admirez que malgré la tempéte	Mais, Madame, admirez que malgré la tempête
Que vôtre uſurpateur oit gronder ſur la téte,	Que votre usurpateur oit gronder sur la tête,
Tous les bruits des Leon annoncent pour certain,	Tous les bruits des Léon annoncent pour certain,
Qu’à la Comteſſe Ignes il va donner la main.	Qu'à la Comtesse Ignès il va donner la main.
Il cherche dans l’himen de cette illuſtre Fille	Il cherche dans l'hymen de cette illustre Fille
L’appui du grand credit, où ſe voit ſa famille;	L'appui du grand crédit où se voit sa famille;
Je ne reçois rien d’elle, & j’en ſuis en ſouci,	Je ne reçois rien d'elle, et j'en suis en souci,
Mais ſon cœur au tiran fut toujours endurci.	Mais son cœur au tyran fut toujours endurci.
De trop puiſſant motifs, d’honneur & de tendreſſe,	De trop puissants motifs, d'honneur et de tendresse,
Oppoſent ſes refus aux nœuds dont on la preſſe,	Opposent ses refus aux nœuds dont on la presse,
Pour....	Pour…
Le Prince entre ici.	Le Prince entre ici.
JE viens m'intereſſer,	JE viens m'intéresser,
Madame, au doux eſpoir, qu’il vous vient d’annoncer.	Madame, au doux espoir, qu'il vous vient d'annoncer.
Ce Frere qui menace un titan plein de crimes,	Ce Frère qui menace un tyran plein de crimes,
Flatte de mon amour les tranſports legitimes.	Flatte de mon amour les transports légitimes.
Son ſort offre à mon bras des perils glorieux,	Son sort offre à mon bras des périls glorieux,
Dont je puis faire hommage à l’éclat de vos yeux.	Dont je puis faire hommage à l'éclat de vos yeux.
Et par eux m’acquerir, ſi le Ciel m’eſt propice,	Et par eux m'acquérir, si le Ciel m'est propice,
La gloire d’un revers, que vous doit ſa juſtice;	La gloire d'un revers, que vous doit sa justice;
Qui va faire à vos pieds cheoir l'infidélité,	Qui va faire à vos pieds choir l'infidélité,
Et rendre à vôtre ſang toute ſa dignité.	Et rendre à votre sang toute sa dignité.
Mais ce qui plus me plaît, d’une atteinte ſi chere,	Mais ce qui plus me plaît, d'une attente si chère,
C’eſt que pour étre Roi, le Ciel nous rend ce Frere;	C'est que pour être Roi, le Ciel vous rend ce Frère;
Et qu’ainſi mon amour peut éclater au moins	Et qu'ainsi mon amour peut éclater au moins
Sans qu’à d’autres motifs on impute ſes ſoins;	Sans qu'à d'autres motifs on impute ses soins;
Et qu’il ſoit ſoupçonné, que dans vôtre perſonne	Et qu'il soit soupçonné, que dans votre personne
Il cherche à me gagner les droits d'une Couronne.	Il cherche à me gagner les droits d'une Couronne.
Oüy, tout mon cœur voudroit montrer aux yeux de tous,	Oui, tout mon cœur voudrait montrer aux yeux de tous,
Qu’il ne regarde en vous autre choſe que vous;	Qu'il ne regarde en vous autre chose que vous;
Et cent fois, ſi je puis le dire ſans offenſe,	Et cent fois, si je puis le dire sans offense,
Ses vœux ſe ſont armez contre vôtre naiſſance,	Ses vœux se sont armés contre votre naissance,
Leur chaleur indiſcrete a d’un deſtin plus bas	Leur chaleur indiscrète a d'un destin plus bas
Souhaité le partage à vos divins appas,	Souhaité le partage à vos divins appas,
Afin que de ce cœur, le noble ſacrifice	Afin que de ce cœur, le noble sacrifice
Pût du Ciel envers vous reparer l'injuſtice;	Pût du Ciel envers vous réparer l'injustice;
Et vôtre ſort tenir des mains de mon amour,	Et votre sort tenir des mains de mon amour,
Tout ce qu’il doit au ſang, dont vous tenez le jour.	Tout ce qu'il doit au sang dont vous tenez le jour.
Mais puisqu'enfin les Cieux, de tout ce juſte hommage,	Mais puisque enfin les Cieux, de tout ce juste hommage,
A mes feux prévenus dérobent l’avantage.	À mes feux prévenus dérobent l'avantage.
Trouvez bon que ces feux prennent un peu d’eſpoir	Trouvez bon que ces feux prennent un peu d'espoir
Sur la mort que mon bras s’apprête à faire voir;	Sur la mort que mon bras s'apprête à faire voir;
Et qu’ils oſent briguer par d’illuſtres ſervices,	Et qu'ils osent briguer par d'illustres services,
D’un Frere & d'un Etat les ſuffrages propices.	D'un Frère et d'un État les suffrages propices.
Je ſçay que vous pouvez, Prince, en vangeant nos droits	Je sais que vous pouvez, Prince, en vengeant nos droits
Faire par vôtre amour parler cent beaux exploits.	Faire par votre amour parler cent beaux exploits.
Mais ce n'eſt pas aſſez pour le prix qu’il eſpere	Mais ce n'est pas assez pour le prix qu'il espère
Que l’aveu d’un Etat, & la faveur d’un Frere.	Que l'aveu d'un État, et la faveur d'un Frère.
D. Eluire n'eſt pas au bout de cet effort,	D. Elvire n'est pas au bout de cet effort,
Et je vous vois a vaincre un obſtacle plus fort.	Et je vous vois à vaincre un obstacle plus fort.
Oüi, Madame, j'entens ce que vous voulez dire,	Oui, Madame, j'entends ce que vous voulez dire,
Je ſçai bien que pour vous mon cœur en vain ſoûpire;	Je sais bien que pour vous mon cœur en vain soupire;
Et l'obſtacle puiſſant, qui s'oppoſe à mes feux,	Et l'obstacle puissant, qui s'oppose à mes feux,
Sans que vous le nommiez, n'eſt pas ſecret pour eux.	Sans que vous le nommiez, n'est pas secret pour eux.
Souvent on entend mal, ce qu’on croit bien entendre,	Souvent on entend mal, ce qu'on croit bien entendre,
Et par trop de chaleur, Prince, on ſe peut méprendre.	Et par trop de chaleur, Prince, on se peut méprendre.
Mais puis qu’il faut parler, deſirez vous ſçavoir,	Mais puisqu'il faut parler, désirez-vous savoir,
Quand vous pourrez me plaire, & prendre quelque eſpoir?	Quand vous pourrez me plaire, et prendre quelque espoir?
Ce me ſera, Madame, une faveur extrême.	Ce me sera, Madame, une faveur extrême.
Quand vous ſçaurez m’aimer, cõme il faut que l’on aime.	Quand vous saurez m'aimer, comme il faut que l'on aime.
Et que peut on, helas! obſerver ſous les Cieux	Et que peut-on, hélas! observer sous les Cieux
Qui ne ccdc à l'ardeur, que m’inſpirent vos yeux?	Qui ne cède à l'ardeur, que m'inspirent vos yeux?
Quand vôtre paſſion ne fera rien paroître,	Quand votre passion ne fera rien paraître,
Dont ſe puiſſe indigner celle qui l'a fait naître.	Dont se puisse indigner celle qui l'a fait naître.
C'eſt là ſon plus grand ſoin.	C'est là son plus grand soin.
Quand tous ſes movemens	Quand tous ses mouvements
Ne prendront point de moy de trop bas ſentimens.	Ne prendront point de moi de trop bas sentiments.
Ils vous reverent trop.	Ils vous révèrent trop.
Quand d’un injuſte ombrage	Quand d'un injuste ombrage
Vôtre raiſon ſçaura me reparer l'outrage;	Votre raison saura me réparer l'outrage;
Et que vous bannirez, enfin ce monſtre affreux,	Et que vous bannirez, enfin ce monstre affreux,
Qui de ſon noir venin empoiſonne vos feux.	Qui de son noir venin empoisonne vos feux.
Cette jalouſe humeur, dont l’importun caprice,	Cette jalouse humeur, dont l'importun caprice,
Aux voeux, que vous m’offrez, rend un mauvais office,	Aux vœux, que vous m'offrez rend un mauvais office,
S'oppoſe à leur attente, & contre eux à tous coups,	S'oppose à leur attente, et contre eux à tous coups,
Arme les mouvemens de mon juſte courroux.	Arme les mouvements de mon juste courroux.
Ah! Madame, il eſt vray, quelque effort que je faſſe,	Ah! Madame, il est vrai, quelque effort que je fasse,
Qu’un peu de jalouſie en mon cœur trouve place,	Qu'un peu de jalousie en mon cœur trouve place,
Et qu'un Rival abſens de vos divins appas	Et qu'un Rival absent de vos divins appas
Au repos de ce coeur vient livrer des combats.	Au repos de ce cœur vient livrer des combats.
Soit caprice, ou raiſon, j’ay toûjours la croyance	Soit caprice, ou raison, j'ai toujours la croyance
Que vôtre ame en ces lieux ſouffre de ſon abſence:	Que votre âme en ces lieux souffre de son absence:
Et que malgré mes ſoins, vos ſoûpirs amoureux	Et que malgré mes soins, vos soupirs amoureux
Vont trouver à tous coups ce Rival trop heureux.	Vont trouver à tous coups ce Rival trop heureux.
Mais ſi de tels ſoupçons ont dequoi vous déplaire,	Mais si de tels soupçons ont de quoi vous déplaire,
Il vous eſt bien facile, helas! de m’y ſoûtraire;	Il vous est bien facile, hélas! de m'y soustraire;
Et leur banniſſement, dont j’accepte la Loy	Et leur bannissement, dont j'accepte la Loi
Dépend bien plus de vous, qu’il ne dépend de moy.	Dépend bien plus de vous, qu'il ne dépend de moi.
Oüi, c’eſt vous qui pouvez par deux mots pleins de flâme;	Oui, c'est vous qui pouvez par deux mots pleins de flamme;
Contre la jalouſie armer toute mon ame;	Contre la jalousie armer toute mon âme;
Et des pleines clartez d’un glorieux espoir	Et des pleines clartés d'un glorieux espoir
Diſſiper les horreurs que ce monſtre y fait cheoir.	Dissiper les horreurs que ce monstre y fait choir.
Daignez donc étouffer le doute qui m’accable,	Daignez donc étouffer le doute qui m'accable,
Et faites qu’un aveu d’une bouche adorable	Et faites qu'un aveu d'une bouche adorable
Me donne l’aſſurance au fort de tant d'aſſauts,	Me donne l'assurance au fort de tant d'assauts,
Que je ne puis trouver dans le peu que je vaux.	Que je ne puis trouver dans le peu que je vaux.
Prince de vos ſoupçons la tyrannie eſt grande	Prince, de vos soupçons la tyrannie est grande
Au moindre mot qu’il dit, un cœur veut qu’on l’entende,	Au moindre mot qu'il dit, un cœur veut qu'on l'entende,
Et n’aime pas ces feux, dont l’importunité	Et n'aime pas ces feux, dont l'importunité
Demande qu’on explique avec tant de clarté	Demande qu'on explique avec tant de clarté.
Le premier mouvement qui découvre nôtre ame,	Le premier mouvement qui découvre notre âme,
Doit d’un Amant diſcret ſatisfaire la flâme,	Doit d'un Amant discret satisfaire la flamme,
Et c’eſt à s’en dédire authoriſer nos vœux,	Et c'est à s'en dédire autoriser nos vœux,
Que vouloir plus avant pouſſer de tels aveux.	Que vouloir plus avant pousser de tels aveux.
Je ne dis point quel choix, s'il m’étoit volontaire,	Je ne dis point quel choix, s'il m'était volontaire,
Entre Dom Sylve & vous, mon ame pourroit faire;	Entre Dom Sylve et vous, mon âme pourrait faire;
Mais vouloir vous contraindre à n'être point jaloux,	Mais vouloir vous contraindre à n'être point jaloux
Auroit dit quelque choſe à tout autre que vous;	Aurait dit quelque chose à tout autre que vous,
Et je croyois cet ordre un aſſez doux langage	Et je croyais cet ordre un assez doux langage
Peur n’avoir pas beſoin d’en dire davantage.	Pour n'avoir pas besoin d'en dire davantage.
Cependant vôtre amour n’eſt pas encor content;	Cependant votre amour n'est pas encore content;
Il demande un aveu qui ſoit plus éclatant.	Il demande un aveu qui soit plus éclatant.
Pour l’ôter de ſcrupule, il me faut a vous méme,	Pour l'ôter de scrupule, il me faut à vous-même,
En des termes exprés, dire que je vous aime?	En des termes exprès, dire que je vous aime?
Et peut-être qu’encor pour vous en aſſurer	Et peut-être qu'encore pour vous en assurer
Vous vous obſtineriez à m’en faire jurer.	Vous vous obstineriez à m'en faire jurer.
Hé bien, Madame, hé bien, je ſuis trop temeraire,	Hé bien, Madame, hé bien, Je suis trop téméraire,
De tout ce qui vous plaît, je dois me ſatisfaire;	De tout ce qui vous plaît, je dois me satisfaire;
Je ne demande point de plus grande clarté,	Je ne demande point de plus grande clarté,
Je croi que vous avez pour moi quelque bonté,	Je crois que vous avez pour moi quelque bonté,
Que d’un peu de pitié mon feu vous ſollicite,	Que d'un peu de pitié mon feu vous sollicite,
Et je me vois heureux plus que je ne merite.	Et je me vois heureux plus que je ne mérite.
C'en eſt fait, je renonce à mes ſoupçons jaloux,	C'en est fait, je renonce à mes soupçons jaloux,
L’arrêt qui me condamne, eſt un arrêt bien doux;	L'arrêt qui les condamne, est un arrêt bien doux;
Et je reçois la Loi qu’il daigne me précrire,	Et je reçois la loi qu'il daigne me prescrire,
Pour affranchir mon cœur de leur injuſte empire.	Pour affranchir mon cœur de leur injuste empire.
Vous promettez beaucoup, Prince, & je doute fort,	Vous promettez beaucoup, Prince, et je doute fort
Si vous pourrez ſur vous faire ce grand effort.	Si vous pourrez sur vous faire ce grand effort.
Ah! Madame, il ſuffit pour me rendre croyable,	Ah! Madame, il suffit pour me rendre croyable,
Que ce qu’on tous promet doit être inviolable;	Que ce qu'on vous promet doit être inviolable;
Et que l'heur d'obeïr à ſa divinité,	Et que l'heur d'obéir à sa divinité,
Ouvre aux plus grands efforts de la facilité;	Ouvre aux plus grands efforts de la facilité;
Que le Ciel me declare une éternelle Guerre,	Que le Ciel me déclare une éternelle Guerre,
Que je tombe à-vos pieds d’un éclat de tonnerre,	Que je tombe à vos pieds d'un éclat de tonnerre,
Ou pour perir encor par des plus rudes coups,	Ou pour périr encore par de plus rudes coups,
Puiſſay-je voir ſur moi fondre vôtre courroux;	Puissé-je voir sur moi fondre votre courroux;
Si jamais mon amour deſcend à la foibleſſe	Si jamais mon amour descend à la faiblesse
De manquer aux devoirs d'une telle promeſſe;	De manquer aux devoirs d'une telle promesse;
Si jamais dans mon ame aucun jaloux tranſport	Si jamais dans mon âme aucun jaloux transport
Fait....	Fait…
J’en êtois en peine, & tu m’oblige fort,	J'en étais en peine, et tu m'obliges fort,
Que le Courrier attende. A ces regards qu'il jette,	Que le Courrier attende. À ces regards qu'il jette,
Vois-je pas que déjà cet écrit l'inquiete?	Vois-je pas que déjà cet écrit l'inquiète?
Prodigieux effet de ſon temperament,	Prodigieux effet de son tempérament,
Qui vous arrête, Prince, au milieu du ſerment?	Qui vous arrête, Prince, au milieu du serment?
J'ai creu que vous aviez quelque ſecret enſemble,	J'ai cru que vous aviez quelque secret ensemble,
Et je ne voulois pas l'interrompre.	Et je ne voulais pas l'interrompre.
Il me ſemble	Il me semble
Que vous me répondez d'un ton fort altéré,	Que vous me répondez d'un ton fort altéré,
Je vous vois tout-à-coup le viſage égaré;	Je vous vois tout à coup le visage égaré:
Ce changement ſoudain a lieu de me ſurprendre,	Ce changement soudain a lieu de me surprendre,
D’où peut-il provenir, le pourroit-on apprendre?	D'où peut-il provenir, Le pourrait-on apprendre?
D’un mal qui tout à coup vient d'attaquer mon cœur.	D'un mal qui tout à coup vient d'attaquer mon cœur.
Souvent plus qu'on ne croit ces maux ont de rigueur;	Souvent plus qu'on ne croit ces maux ont de rigueur;
Et quelque prompt ſecours tous feroit neceſſaire,	Et quelque prompt secours vous serait nécessaire,
Mais encor dites-moi vous prend il d'ordinaire?	Mais encore, dites-moi, vous prend-il d'ordinaire?
Par fois.	Parfois.
Ah! Prince foible; hé bien par cet écrit,	Ah! Prince faible; Hé bien par cet écrit,
Guerriſſez-le ce mal, il n'eſt que dans l’eſprit.	Guérissez-le ce mal, il n'est que dans l'esprit.
Par cet écrit, Madame? ah ! ma main le refuſe,	Par cet écrit, Madame? ah! ma main le refuse,
Je voi vôtre penſee, & dequoi l'on m’accuſe;	Je vois votre pensée, et de quoi l'on m'accuse;
Si....	Si…
Liſez-le, vous dis-je, & ſatisfaites-vous.	Lisez-le, vous dis-je, et satisfaites-vous.
Pour me traiter après, de foible, de jaloux?	Pour me traiter après, de faible, de jaloux?
Non, non, je dois ici vous rendre un temoignage,	Non, non, je dois ici vous rendre un témoignage,
Qu’à mon cœur cet écrit n’a point donne d’ombrage;	Qu'à mon cœur cet écrit n'a point donné d'ombrage;
Et bien que vos bontez m’en laiſſent le pouvoir,	Et bien que vos bontés m'en laissent le pouvoir,
Pour me juſtifier je ne veux peint le voir.	Pour me justifier, je ne veux point le voir.
Si vous vous obſtinez à cette reſiſtance,	Si vous vous obstinez à cette résistance,
J’aurois tort de vouloir vous faire violence;	J'aurais tort de vouloir vous faire violence;
Et c’eſt aſſez enfin, que vous avoir preſſé	Et c'est assez enfin que vous avoir pressé
De voir de quelle main ce billet m’eſt tracé.	De voir de quelle main ce billet m'est tracé.
Ma volonté toûjours vous doit être ſoûmiſe,	Ma volonté toujours vous doit être soumise,
Si c’eſt vôtre plaiſir, que pour vous je le liſe,	Si c'est votre plaisir que pour vous je le lise,
Je conſens volontier à prendre cet employ.	Je consens volontiers à prendre cet emploi.
Oui, oui, Prince, tenez, vous le lirez pour moi.	Oui, oui, Prince, tenez, vous le lirez pour moi.
C’eſt pour vous obeïr au moins, & je puis dire....	C'est pour vous obéir, au moins, et je puis dire…
C’eſt ce que vous voudrez, dépêchez-vous de lire.	C'est ce que vous voudrez, dépêchez-vous de lire.
Il eſt de Done Ignes, à ce que je connoi.	Il est de Done Ignès, à ce que je connais.
Oui, je m'en réjoüis, & pour vous, & pour moi.	Oui, je m'en réjouis, et pour vous, et pour moi.
Malgré l’effort d’un long mépris,	Malgré l'effort d'un long mépris,
Le Tyran toûjours m’aime, & depuis vôtre abſence,	Le Tyran toujours m'aime, et depuis votre absence,
Vers moi pour me porter au deſtin qu’il a pris,	Vers moi pour me porter au dessein qu'il a pris,
Il ſemble avoir tourné toute ſa violence,	Il semble avoir tourné toute sa violence,
Dont il pourſuit l’alliance	Dont il poursuit l'alliance
De vous & de ſon Fils.	De vous et de son Fils.
Ceux qui ſur moi peuvent avoir empire	Ceux qui sur moi peuvent avoir empire
Par de lâches motifs qu’un faux honneur inſpire,	Par de lâches motifs qu'un faux honneur inspire,
Approuvent tous cet indigne lien;	Approuvent tous cet indigne lien;
J'ignore encor par où finira mon martyre:	J'ignore encore par où finira mon martyre:
Mais je mourrai plutôt que d’y conſentir.	Mais je mourrai plutôt que de consentir.
Puiſſiez-vous joüir, belle Eluire,	Puissiez-vous jouir, belle Elvire,
D’un deſtin plus doux que le mien.	D'un destin plus doux que le mien.
Dans la haute vertu ſon ame eſt affermie.	Dans la haute vertu son âme est affermie.
Je vais faire réponſe à cette illuſtre amie.	Je vais faire réponse à cette illustre amie.
Cependant apprenez, Prince, à vous mieux armer	Cependant apprenez, Prince, à vous mieux armer
Contre ce qui prend droit de vous trop allarmer.	Contre ce qui prend droit de vous trop alarmer.
J’ai calmé vôtre trouble, avec cette lumiere,	J'ai calmé votre trouble, avec cette lumière,
Et la choſe a paſſé d’une douce maniere:	Et la chose a passé d'une douce manière;
Mais à n’en point mentir il ſeroit des momens,	Mais à n'en point mentir il serait des moments
Où je pourrois entrer dans d’autres ſentimens.	Où je pourrais entrer dans d'autres sentiments.
Hé, quoi vous croyez donc....	Hé quoi! Vous croyez donc…
Je croi ce qu’il faut croire....	Je crois ce qu'il faut croire…
Adieu, de mes avis conſervez la memoire,	Adieu, de mes avis conservez la mémoire,
Et s’il eſt vrai pour moi, que vôtre amour ſoit grand	Et s'il est vrai pour moi, que votre amour soit grand,
Donnez en à mon cœur les preuves qu’il pretend.	Donnez-en à mon cœur les preuves qu'il prétend.
Croyez que deſormais, c’eſt là tout mon envie,	Croyez que désormais, c'est là toute mon envie,
Et qu’avant qu’y manquer, je veux perdre la vie.	Et qu'avant qu'y manquer, je veux perdre la vie.
TOut ce que fait le Prince, à parler franchement,	Tout ce que fait le Prince, à parler franchement,
N’eſt pas ce qui me donne un grand étonnement	N'est pas ce qui me donne un grand étonnement
Car que d’un noble amour une ame bien ſaiſie,	Car que d'un noble amour une âme bien saisie
En pouſſe les tranſport juſqu'à la jalouſie;	En pousse les transports jusqu'à la jalousie;
Que de doutes frequents ſes voeux ſoyent traverſés,	Que de doutes fréquents ses vœux soient traversés,
Il eſt fort naturel, & je l’approuve aſſez;	Il est fort naturel, et je l'approuve assez;
Mais ce qui me ſurprend, Dom Lope, c’eſt d’entendre	Mais ce qui me surprend, Dom Lope, c'est d'entendre
Que vous lui preparez les ſoupçons qu’il doit prendre,	Que vous lui préparez les soupçons qu'il doit prendre,
Que vôtre ame les forme, & qu'il n’eſt en ces lieux;	Que votre âme les forme, et qu'il n'est en ces lieux;
Fâcheux que par vos ſoins, jaloux que par vos yeux.	Fâcheux que par vos soins, jaloux que par vos yeux.
Encor un coup, Dom Lope, une ame bien épriſe	Encore un coup, Dom Lope, une âme bien éprise
Des ſoupçons qu'elle prend, ne me rend point ſurpriſe;	Des soupçons qu'elle prend, ne me rend point surprise;
Mais qu'on ait ſans amour tous les ſoins d'un jaloux,	Mais qu'on ait sans amour tous les soins d'un jaloux,
C’eſt une nouveauté qui n’appartient qu’à vous.	C'est une nouveauté qui n'appartient qu'à vous.
Que ſur cette conduite à ſon aiſe l’on gloſe,	Que sur cette conduite à son aise l'on glose,
Chacun regle la ſienne au but qu'il ſe propoſe;	Chacun règle la sienne au but qu'il se propose;
Et rebuté par vous des ſoins de mon amour,	Et rebuté par vous des soins de mon amour,
Je ſonge auprés du Prince à bien faite ma Cour.	Je songe auprès du Prince à bien faire ma Cour.
Mais ſçavez vous, qu'enfin il fera mal la ſienne,	Mais savez-vous, qu'enfin il fera mal la sienne,
S'il faut qu'en cette humeur vôtre eſprit l'entretienne?	S'il faut qu'en cette humeur votre esprit l'entretienne?
Et quand, charmante Eliſe, a-t'on veu s’il vous plaît,	Et quand, charmante élise, a-t-on vu s'il vous plaît,
Qu’on cherche auprés des Grands, que ſon propre interêt?	Qu'on cherche auprès des Grands, que son propre intérêt?
Qu'un parfait Courtiſan veüille charger leur ſuite,	Qu'un parfait Courtisan veuille charger leur suite,
D'un cenſeur des défauts, qu’on trouve en leur conduite;	D'un censeur des défauts, qu'on trouve en leur conduite;
Et s’aille inquieter, ſi ſon diſcours leur nuit,	Et s'aille inquiéter, si son discours leur nuit,
Pourveu que ſa fortune en tire quelque fruit?	Pourvu que sa fortune en tire quelque fruit?
Tout ce qu’on fait ne va, qu'à ſe mettre en leur grace	Tout ce qu'on fait ne va, qu'à se mettre en leur grâce
Par la plus courte voye, on y cherche une place;	Par la plus courte voie, on y cherche une place;
Et les plus prompts moyens de gagner leur faveur,	Et les plus prompts moyens de gagner leur faveur,
C’eſt de flater toûjours le foible de leur coeur:	C'est de flatter toujours le faible de leur cœur:
D’applaudir en aveugle à ce qu'ils veulent faire,	D'applaudir en aveugle à ce qu'ils veulent faire,
Et n'appuyer jamais ce qui peut leur déplaire;	Et n'appuyer jamais ce qui peut leur déplaire;
C’eſt là le vrai ſecret d’être bien auprés d’eux,	C'est là le vrai secret d'être bien auprès d'eux,
Les utiles conſeils font paſſer pour fâcheux,	Les utiles conseils font passer pour fâcheux,
Et vous laiſſent toujours hors de la confidence,	Et vous laissent toujours hors de la confidence,
Où vous jette d’abord l'adroite complaiſance.	Où vous jette d'abord l'adroite complaisance.
Enfin on voit par tout, que l'art des Courtiſans,	Enfin on voit partout, que l'art des Courtisans,
Ne tend qu’à profiter des foibleſſes des Grands;	Ne tend qu'à profiter des faiblesses des Grands;
A nourrir les erreurs, & jamais dans leur ame,	À nourrir les erreurs, et jamais dans leur âme,
Ne porter les avis des choſes qu'on y blâme.	Ne porter les avis des choses qu'on y blâme.
Ces maximes un temps leur peuvent ſucceder;	Ces maximes un temps leur peuvent succéder;
Mais il eſt des revers, qu’on doit apprehender.	Mais il est des revers, qu'on doit appréhender.
Et dans l’eſprit des Grands, qu’on tâche de ſurprendre,	Et dans l'esprit des Grands, qu'on tâche de surprendre,
Un rayon de lumiere, à la fin peut deſcendre,	Un rayon de lumière, à la fin peut descendre,
Qui ſur tous ces flateurs vange équitablement,	Qui sur tous ces flatteurs venge équitablement,
Ce qu’a fait à leur gloire, un long aveuglement.	Ce qu'a fait à leur gloire, un long aveuglement.
Cependant je dirai, que vôtre ame s’explique	Cependant je dirai, que votre âme s'explique
Un peu bien librement ſur vôtre Politique;	Un peu bien librement sur votre Politique;
Et ſes nobles motifs, au Prince rapportez,	Et ses nobles motifs, au Prince rapportés,
Serviroient aſſez mal vos aſſiduitez.	Serviraient assez mal vos assiduités.
Outre que je pourrois deſavoüer ſans blame,	Outre que je pourrais désavouer sans blâme,
Ces libres veritez, ſur quoi s’ouvre mon ame;	Ces libres vérités, sur quoi s'ouvre mon âme;
Je ſçai fort bien qu'Eliſe a l’eſprit trop diſcret,	Je sais fort bien qu'Élise a l'esprit trop discret,
Pour aller divulguer cet entretien ſecret.	Pour aller divulguer cet entretien secret.
Qu'ai-je dit, aprés tout, que ſans moi l'on ne ſçache?	Qu'ai-je dit, après tout, que sans moi l'on ne sache?
Et dans mon procedé que faut-il que je cache?	Et dans mon procédé que faut-il que je cache?
On peut craindre une cheute avec quelque raiſon,	On peut craindre une chute avec quelque raison,
Quand on met en uſage, ou ruſe, ou trahiſon.	Quand on met en usage, ou ruse, ou trahison.
Mais qu'ai-je à redouter, moi qui par tout n'avance	Mais qu'ai-je à redouter, moi qui partout n'avance
Que les ſoins approuvez d’un peu de complaiſance;	Que les soins approuvés d'un peu de complaisance;
Et qui ſui ſeulement par d’utiles leçons	Et qui suis seulement par d'utiles leçons
La pente qu’a le Prince à de jaloux ſoupçons?	La pente qu'a le Prince à de jaloux soupçons?
Son ame ſemble en vivre, & je mets mon étude	Son âme semble en vivre, et je mets mon étude
A trouver des raiſons à ſon inquietude;	À trouver des raisons à son inquiétude;
A voir de tous côtez, s'il ne ſe paſſe rien,	À voir de tous côtés, s'il ne se passe rien,
A fournir le ſujet d'un ſecret entretien.	À fournir le sujet d'un secret entretien.
Et quand je puis venir enflé d'une nouvelle,	Et quand je puis venir enflé d'une nouvelle,
Donner à ſon repos une atteinte mortelle,	Donner à son repos une atteinte mortelle,
C’eſt lors que plus il m’aime, & je voi ſa raiſon	C'est lors que plus il m'aime, et je vois sa raison
D’une audience avide avaler ce poiſon,	D'une audience avide avaler ce poison,
Et m'en remercier, comme d'une victoire,	Et m'en remercier, comme d'une victoire,
Qui combleroit ſes jours de bonheur & de gloire.	Qui comblerait ses jours de bonheur et de gloire.
Mais mon rival paroît, je vous laiſſe tous deux,	Mais mon rival paraît, je vous laisse tous deux,
Et bien que je renonce à l'eſpoir de vos vœux,	Et bien que je renonce à l'espoir de vos vœux,
J'aurois un peu de peine à voir qu’en ma preſence,	J'aurais un peu de peine à voir qu'en ma présence,
Il reçeût des effets de quelque preference;	Il reçût des effets de quelque préférence;
Et je veux, ſi je puis, m'épargner ce ſouci.	Et je veux, si je puis, m'épargner ce souci.
Tout amant de bon ſens en doit uſer ainſi.	Tout amant de bon sens en doit user ainsi.
ENfin, nous apprenons que le Roi de Navarre	Enfin nous apprenons que le Roi de Navarre
Pour les deſirs du Prince, aujourd'hui ſe déclare;	Pour les désirs du Prince, aujourd'hui se déclare;
Et qu’un nouveau renfort de troupes nous attend	Et qu'un nouveau renfort de troupes nous attend
Pour le fameux ſervice, où ſon amour pretend.	Pour le fameux service, où son amour prétend.
Je ſuis ſurpris pour moi, qu'avec tant de viteſſe,	Je suis surpris pour moi, qu'avec tant de vitesse,
Ou ait fait avancer. Mais...	On ait fait avancer… Mais…
QUe fait là la Princeſſe.	Que fait la Princesse?
Quelques lettres, Seigneur, je le preſume ainſi;	Quelques lettres, Seigneur, je le présume ainsi;
Mais elle va ſçavoir que vous étes ici.	Mais elle va savoir que vous êtes ici.
J’Attendrai qu'elle ait fait. Prés de ſouffrir ſa veüe,	J'attendrai qu'elle ait fait. Près de souffrir sa vue,
D'un trouble tout nouveau je me ſens l'ame émeüe	D'un trouble tout nouveau je me sens l'âme émue
Et la crainte mélée à mon reſſentiment,	Et la crainte mêlée à mon ressentiment,
Jette par tout mon corps un ſoudain tremblement.	Jette par tout mon corps un soudain tremblement.
Prince, prends garde au moins, qu’on aveugle caprice	Prince, prends garde au moins, qu'un aveugle caprice
Ne te conduiſe ici dans quelque precipice,	Ne te conduise ici dans quelque précipice,
Et que de ton eſprit les deſordres puiſſans,	Et que de ton esprit les désordres puissants,
Ne donnent un peu plus au rapport de tes ſens.	Ne donnent un peu trop au rapport de tes sens.
Conſulte ta raiſon, prends ſa clarté pour guide,	Consulte ta raison, prends sa clarté pour guide,
Voi ſi de tes ſoupçons, l’apparence eſt ſolide;	Vois si de tes soupçons, l'apparence est solide;
Ne dements pas leurs voix, mais auſſi garde bien	Ne démens pas leur voix, mais aussi garde bien
Que pour les croire trop ils ne t'impoſent rien;	Que pour les croire trop ils ne t'imposent rien;
Qu’à tes premiers tranſports ils n’oſent trop permettre,	Qu'à tes premiers transports ils n'osent trop permettre,
Et relis peſement cette moitié de lettre.	Et relis posément cette moitié de lettre.
Ha! qu’eſt-ce que mon cœur, trop digne de pitié,	Ha! qu'est-ce que mon cœur, trop digne de pitié,
Ne voudroit pas donner pour ſon  autre moitié!	Ne voudrait pas donner pour son autre moitié!
Mais aprés tout que dis-je? Il ſuffit bien de l’une,	Mais après tout que dis-je? Il suffit bien de l'une,
Et n’en voilà que trop pour voir mon infortune.	Et n'en voilà que trop pour voir mon infortune.
Quoi que vôtre Rival....	Quoique votre Rival…
Vous devez toutefois vous....	Vous devez toutefois vous…
Et vous avez en vous à....	Et vous avez en vous à…
L'obſtacle le plus grand....	L'obstacle le plus grand…
Je cheris tendrement ce....	Je chéris tendrement ce…
Pour me tirer des mains de....	Pour me tirer des mains de…
Son amour, ſes devoirs....	Son amour, ses devoirs…
Mais il m’eſt odieux avec....	Mais il m'est odieux, avec…
Otez donc à vos feux ce....	Ôtez donc à vos feux ce…
Meritez les regards que l'on....	Méritez les regards que l'on…
Et lors qu’on vous oblige....	Et lorsqu'on vous oblige…
Ne vous obſtinez point à...	Ne vous obstinez point à…
Oui, mon ſort par ces mots eſt aſſez éclairci,	Oui, mon sort par ces mots est assez éclairci,
Son coeur comme ſa main ſe fait connoître ici:	Son cœur comme sa main se fait connaître ici:
Et les ſens imparfaits de cet écrit funeſte,	Et les sens imparfaits de cet écrit funeste,
Pour s’expliquer à moi, n'ont pas beſoin du reſte.	Pour s'expliquer à moi, n'ont pas besoin du reste.
Toutefois dans l’abord agiſſons doucement,	Toutefois dans l'abord agissons doucement,
Couvrons à l’infidelle un vif reſſentiment;	Couvrons à l'infidèle un vif ressentiment;
Et de ce que je tiens, ne donnant point d’indice,	Et de ce que je tiens, ne donnant point d'indice,
Confondons ſon eſprit par ſon propre artifice.	Confondons son esprit par son propre artifice.
La voici, ma raiſon, renferme mes tranſports,	La voici, ma raison, renferme mes transports,
Et rends-toi-pour un tems maîtreſſe du dehors.	Et rends-toi pour un temps maîtresse du dehors.
VOus avez bien voulu que je vous fiſſe attendre?	Vous avez bien voulu que je vous fisse attendre?
Ha! qu’elle cache bien.	Ha! Qu'elle cache bien!
On vient de nous apprendre	On vient de nous apprendre
Que le Roi vôtre Pere approuve vos projets,	Que le Roi votre Père approuve vos projets,
Et veut bien que ſon Fils nous rende nos Sujets,	Et veut bien que son Fils nous rende nos Sujets,
Et mon ame en a pris une allegreſſe extréme.	Et mon âme en a pris une allégresse extrême.
Oui, Madame, & mon coeur s'en réjoüit de méme.	Oui, Madame, et mon cœur s'en réjouit de même.
Mais....	Mais…
Le tiran ſans doute aura peine à parer	Le tyran sans doute aura peine à parer
Les foudres que par tout il entend murmurer;	Les foudres que partout il entend murmurer;
Et j’oſe me flater que le même courage	Et j'ose me flatter que le même courage
Qui pût bien me ſoûtraire à ſa brutale rage:	Qui put bien me soustraire à sa brutale rage:
Et dans les murs d'Aſtorgue, arrachez de ſes mains,	Et dans les murs d'Astorgue, arrachés de ses mains,
Me faire un ſeur azile à braver les deſſeins:	Me faire un sûr asile à braver ses desseins:
Pourra de tout Leon, achevant la conquête,	Pourra de tout Léon achevant la conquête,
Sous ſes nobles efforts faire cheoir cette tête.	Sous ses nobles efforts faire choir cette tête.
Le ſuccez en pourra parler dans quelques jours,	Le succès en pourra parler dans quelques jours,
Mais de grâce paſſons à quelque autre diſcours.	Mais de grâce passons à quelque autre discours.
Puis-je ſans trop oſer vous prier de me dire,	Puis-je sans trop oser vous prier de me dire,
A qui vous avez pris, Madame, ſoin d’écrire,	À qui vous avez pris, Madame, soin d'écrire,
Depuis que le deſtin nous a conduits ici?	Depuis que le destin nous a conduits ici?
Pourquoi cette demande? & d’où vient ce ſouci?	Pourquoi cette demande? et d'où vient ce souci?
D'un deſir curieux de pure fantaiſie.	D'un désir curieux de pure fantaisie.
La curioſité naît de la jalouſie.	La curiosité naît de la jalousie.
Non, ce n'eſt rien du tout de ce que vous penſez,	Non, ce n'est rien du tout de ce que vous pensez,
Vos ordres de ce mal me défendent aſſez.	Vos ordres de ce mal me défendent assez.
Sans chercher plus avant quel intérêt vous preſſe,	Sans chercher plus avant quel intérêt vous presse,
J’ai deux fois à Leon écrit à la Comteſſe;	J'ai deux fois à Léon écrit à la Comtesse;
Et deux fois au Marquis D. Loüis, à Burgos?	Et deux fois au Marquis D. Louis à Burgos?
Avec cette réponſe êtes-vous en repos?	Avec cette réponse êtes-vous en repos?
Vous n'avez point écrit à quelque autre perſonne,	Vous n'avez point écrit à quelque autre personne,
Madame?	Madame?
Non, ſans doute, & ce diſcours m’étonne.	Non, sans doute, et ce discours m'étonne.
De grâce ſongez bien avant que d’aſſurer,	De grâce songez bien avant que d'assurer,
En manquant de memoire on peut ſe parjurer.	En manquant de mémoire on peut se parjurer.
Ma bouche ſur ce point ne peut être parjure.	Ma bouche sur ce point ne peut être parjure.
Elle a dit toutefois une haute impoſture.	Elle a dit toutefois une haute imposture.
Prince.	Prince!
Madame.	Madame?
O Ciel! quel eſt ce mouvement,	Ô Ciel! Quel est ce mouvement?
Avez-vous, dites-moi, perdu le jugement?	Avez-vous, dites-moi, perdu le jugement,
Oüi, oüi, je l’ai perdu, lorſque dans vôtre veüe,	Oui, oui, je l'ai perdu, lorsque dans votre vue,
J’ai pris pour mon malheur le poiſon qui me tüe.	J'ai pris pour mon malheur le poison qui me tue.
Et que j’ai crû trouver quelque ſincerité	Et que j'ai cru trouver quelque sincérité
Dans les traitres appas, dont je fus enchanté.	Dans les traîtres appas dont je fus enchanté.
De quelle trahiſon pouvez vous donc vous plaindre?	De quelle trahison pouvez-vous donc vous plaindre?
Ah! que ce cœur eſt double, & ſçait bien l’art de ſeindre;	Ah! que ce cœur est double, et sait bien l'art de feindre;
Mais tous moyens de fuir lui vont être ſoûtraits,	Mais tous moyens de fuir lui vont être soustraits,
Jettez ici les yeux, & connoiſſez vos traits;	Jetez ici les yeux, et connaissez vos traits;
Sans avoir veu le reſte, il m’eſt aſſez facile	Sans avoir vu le reste, il m'est assez facile
De découvrir pour qui vous employez ce ſtile.	De découvrir pour qui vous employez ce style.
Voilà donc le ſujet qui vous trouble l’eſprit?	Voilà donc le sujet qui vous trouble l'esprit?
Vous ne rougiſſez pas en voyant cet écrit?	Vous ne rougissez pas en voyant cet écrit?
L’innocence à rougir n’eſt point accoûtumée.	L'innocence à rougir n'est point accoutumée.
Il eſt vrai qu’en ces lieux on la voit opprimée,	Il est vrai qu'en ces lieux on la voit opprimée,
Ce billet dementi pour n’avoir point de ſeing.	Ce billet démenti pour n'avoir point de seing.
Pourquoi le dementir, puiſqu'il eſt de ma main?	Pourquoi le démentir, puisqu'il est de ma main?
Encor eſt-ce beaucoup que de franchiſe pure,	Encore est-ce beaucoup que de franchise pure,
Vous demeuriez d’accord, que c’eſt vôtre écriture;	Vous demeuriez d'accord, que c'est votre écriture;
Mais ce ſera, ſans doute, & j’en ſerois garant,	Mais ce sera, sans doute, et j'en serais garant,
Un billet qu’on envoye à quelque indifferent,	Un billet qu'on envoie à quelque indifférent,
Ou du moins ce qu’il a de tendreſſe évidente	Ou du moins ce qu'il a de tendresse évidente
Sera pour une amie, ou pour quelque parente.	Sera pour une amie, ou pour quelque parente.
Non, c’eſt pour un Amant, que ma main l’a formé,	Non, c'est pour un Amant que ma main l'a formé,
Et j’ajoute de plus pour un Amant aimé.	Et j'ajoute de plus pour un Amant aimé.
Et je puis, ô Perfide....	Et je puis, ô perfide!…
Arrétez, Prince indigne,	Arrêtez, Prince indigne,
De ce lâche tranſport l’égarement inſigne,	De ce lâche transport l'égarement insigne,
Bien que de vous mon cœur ne prenue point de loi,	Bien que de vous mon cœur ne prenne point de loi,
Et ne doive en ces lieux aucun conte qu’à ſoi,	Et ne doive en ces lieux aucun compte qu'à soi,
Je veux bien me purger pour vôtre ſeul ſupplice,	Je veux bien me purger pour votre seul supplice,
Du crime que m’impoſe, un inſolent caprice;	Du crime que m'impose, un insolent caprice;
Vous ſerez éclairci, n’en doutez nullement,	Vous serez éclairci, n'en doutez nullement,
J’ai ma defence préte en ce méme moment.	J'ai ma défense prête en ce même moment.
Vous allez recevoir une pleine lumiere,	Vous allez recevoir une pleine lumière,
Mon innocence ici paroîtra toute entiere;	Mon innocence ici paraîtra toute entière;
Et je veux vous mettant juge en vôtre interét,	Et je veux vous mettant juge en votre intérêt,
Vous faire prononcer vous même vôtre arrét.	Vous faire prononcer vous-même votre arrêt.
Ce ſont propos obſcurs, qu’on ne ſçauroit comprendre.	Ce sont propos obscurs, qu'on ne saurait comprendre.
Bien-tôt à vos depens vous me pourrez entendre.	Bientôt à vos dépens vous me pourrez entendre.
Eliſe, hola.	Élise, holà.
MAdame.	Madame.
Obſervez bien au moins,	Observez bien au moins,
Si j’oſe à vous tromper employer quelques ſoins,	Si j'ose à vous tromper employer quelques soins,
Si par un ſeul coup d’œil, ou geſte qui l’inſtruiſe,	Si par un seul coup d'œil, ou geste qui l'instruise,
Je cherche de ce coup à parer la ſurpriſe.	Je cherche de ce coup à parer la surprise.
Le billet que tantôt ma main avoit tracé,	Le billet que tantôt ma main avait tracé,
Repondez promptement, où l’avez vous laiſſé?	Répondez promptement, où l'avez-vous laissé?
Madame, j’ai ſujet de m’avoüer coupable,	Madame, j'ai sujet de m'avouer coupable,
Je ne ſçai comme il eſt demeuré ſur ma table;	Je ne sais comme il est demeuré sur ma table;
Mais on vient de m’apprendre en ce même moment,	Mais on vient de m'apprendre en ce même moment,
Que D. Lope venant dans mon appartement,	Que D. Lope venant dans mon appartement,
Par une liberté, qu’on lui voit ſe permettre,	Par une liberté, qu'on lui voit se permettre,
A fureté par tout, & trouvé cette lettre.	A fureté partout et trouvé cette lettre.
Comme il la déplioit, Leonor a voulu	Comme il la dépliait, Léonor a voulu
S’en ſaiſir promptement, avant qu’il eût rien leu;	S'en saisir promptement, avant qu'il eût rien lu;
Et ſe jettant ſur lui la lettre conteſtée	Et se jetant sur lui la lettre contestée
En deux juſtes moitiez dans leurs mains eſt reſtée;	En deux justes moitiés dans leurs mains est restée;
Dom Lope auſſi-tôt prenant un prompt effort,	Dom Lope aussitôt prenant un prompt essor,
A dérobé la ſienne aux ſoins de Leonor.	A dérobé la sienne aux soins de Léonor.
Avez-vous ici l’autre?	Avez-vous ici l'autre?
Oüi, la voilà, Madame.	Oui, la voilà, Madame.
Donnez, nous allons voir qui merite le blâme,	Donnez, nous allons voir qui mérite le blâme,
Avec vôtre moitié raſſemblez celle-cy,	Avec votre moitié rassemblez celle-ci.
Liſez, & hautement, je veux l’entendre auſſi.	Lisez, et hautement, je veux l'entendre aussi.
Au Prince Dom Garcie! ah.	Au Prince Dom Garcie! ah.
Achevez de lire,	Achevez de lire,
Vôtre ame pour ce mot ne doit pas s’interdire?	Votre âme pour ce mot ne doit pas s'interdire?
Quoi que vôtre Rival, Prince, alarme vôtre ame,	Quoique votre Rival, Prince, alarme votre âme,
Vous devez toutefois vous craindre plus que lui,	Vous devez toutefois vous craindre plus que lui,
Et vous avez en vous à détruire aujourd’huy	Et vous avez en vous à détruire aujourd'hui
L’obſtacle le plus grand que trouve vôtre flâme.	L'obstacle le plus grand que trouve votre flamme.
Je cheris tendrement ce qu’à fait Dom Garcie,	Je chéris tendrement ce qu'a fait Dom Garcie,
Pour me tirer des mains de nos fiers raviſſeurs,	Pour me tirer des mains de nos fiers ravisseurs,
Son amour, ſes devoirs ont pour moi des douceurs,	Son amour, ses devoirs ont pour moi des douceurs,
Mais il m’eſt odieux avec ſa jalouſie.	Mais il m'est odieux, avec sa jalousie.
Otez donc à vos feux, ce qu’ils en font paroître,	Ôtez donc à vos feux, ce qu'ils en font paraître,
Meritez les regards que l’on jette ſur eux;	Méritez les regards que l'on jette sur eux;
Et lorsqu’on vous oblige à vous tenir heureux,	Et lorsqu'on vous oblige à vous tenir heureux,
Ne vous obſtinez point à ne pas vouloir l’être?	Ne vous obstinez point à ne pas vouloir l'être?
Hé, bien que dites vous?	Hé bien! Que dites-vous?
Ha, Madame, je dis,	Ha, Madame, je dis
Qu'à cet objet mes ſens demeurent interdits:	Qu'à cet objet mes sens demeurent interdits:
Que je voi dans ma plainte une horrible injuſtice,	Que je vois dans ma plainte une horrible injustice,
Et qu’il n’eſt point pour moi d’aſſez crüel ſupplice.	Et qu'il n'est point pour moi d'assez cruel supplice.
Il ſuffit, apprenez que ſi j’ai ſouhaité	Il suffit, apprenez que si j'ai souhaité
Qu’à vos yeux cet écrit put étre preſenté?	Qu'à vos yeux cet écrit pût être présenté?
C’eſt pour le dementir, & cent fois me dedire	C'est pour le démentir, et cent fois me dédire
De tout ce que pour vous, vous y venez de lire.	De tout ce que pour vous, vous y venez de lire.
Adieu Prince.	Adieu, Prince.
Madame, helas! où fuyez-vous.	Madame, hélas! où fuyez-vous.
Où vous ne ſerez point trop odieux jaloux.	Où vous ne serez point, trop odieux jaloux.
Ha! Madame, excuſez un Amant miſerable,	Ha! Madame, excusez un Amant misérable,
Qu’un ſort prodigieux a fait vers vous coupable,	Qu'un sort prodigieux a fait vers vous coupable,
Et qui, bien qu’il vous cauſe un courroux ſi puiſſant,	Et qui, bien qu'il vous cause un courroux si puissant,
Eut été plus blamable à reſter innocent.	Eût été plus blâmable à rester innocent.
Car enfin peut-il étre un ame bien atteinte,	Car enfin peut-il être une âme bien atteinte,
Dont l’eſpoir le plus doux ne ſoit mélé de crainte?	Dont l'espoir le plus doux ne soit mêlé de crainte?
Et pourriez vous penſer que mon cœur eût aymé,	Et pourriez-vous penser que mon cœur eût aimé,
Si ce billet fatal ne l’eut point allarmé?	Si ce billet fatal ne l'eût point alarmé?
S’il n’avoit point fremi des coups de cette foudre,	S'il n'avait point frémi des coups de cette foudre,
Dont je me fiourois tout mon bonheur en poudre;	Dont je me figurais tout mon bonheur en poudre;
Vous-même, dites-moi, ſi cet évenement,	Vous-même, dites-moi, si cet événement,
N’eut pas dans mon erreur jetté tout autre Amant?	N'eût pas dans mon erreur jeté tout autre Amant?
Si d’une preuve, helas! qui me ſembloit ſi claire,	Si d'une preuve, hélas! qui me semblait si claire,
Je pouvois dementir.	Je pouvais démentir.
Oüi, vous le pouviez faire,	Oui, vous le pouviez faire,
Et dans mes ſentimens aſſez bien declarez	Et dans mes sentiments assez bien déclarés
Vos doutes rencontroient des garants aſſurez;	Vos doutes rencontraient des garants assurés;
Vous n’aviez rien à craindre, & d’autres ſur ce gage	Vous n'aviez rien à craindre, et d'autres sur ce gage
Auroient du monde entier bravé le témoignage.	Auraient du monde entier bravé le témoignage.
Moins on merite un bien qu’on nous fait eſperer,	Moins on mérite un bien qu'on nous fait espérer,
Plus nôtre ame a de peine à pouvoir s’aſſurer;	Plus notre âme a de peine à pouvoir s'assurer;
Un ſort trop plein de gloire à nos yeux eſt fragile,	Un sort trop plein de gloire à nos yeux est fragile,
Et nous laiſſe aux ſoupçons une peinte facile.	Et nous laisse aux soupçons une pente facile.
Pour moi qui crois ſi peu meriter vos bontez,	Pour moi qui crois si peu mériter vos bontés,
J’ai douté du bonheur de mes temeritez;	J'ai douté du bonheur de mes témérités;
J’ai cru que dans ces lieux rangez ſous ma puiſſance	J'ai cru que dans ces lieux rangés sous ma puissance
Vôtre ame ſe forçoit à quelque complaiſance;	Votre âme se forçait à quelque complaisance;
Que deguiſant pour moi vôtre ſeverité....	Que déguisant pour moi votre sévérité…
Et je pourrois deſcendre à cette lâcheté,	Et je pourrais descendre à cette lâcheté,
Moi prendre le parti d’une honteuſe feinte,	Moi prendre le parti d'une honteuse feinte,
Agir par les motifs d’une ſervile crainte,	Agir par les motifs d'une servile crainte,
Trahir mes ſentimens, & pour étre en vos mains,	Trahir mes sentiments, et, pour être en vos mains,
D’un maſque de faveur vous couvrir mes dedains?	D'un masque de faveur vous couvrir mes dédains?
La gloire ſur mon cœur auroit ſi peu d’empire?	La gloire sur mon cœur aurait si peu d'empire?
Vous pouvez le penſer, & vous me l’oſez dire?	Vous pouvez le penser, et vous me l'osez dire?
Aprenez que ce cœur ne ſçait point s’abaiſſer,	Apprenez que ce cœur ne sait point s'abaisser,
Qu’il n’eſt rien ſous les Cieux qui puiſſe l’y forcer.	Qu'il n'est rien sous les Cieux qui puisse l'y forcer.
Et s’il vous a fair voir par une erreur inſigne	Et s'il vous a fait voir par une erreur insigne
Des marques de bonté, dont vous n’étiez pas digne,	Des marques de bonté, dont vous n'étiez pas digne,
Qu'il ſçaura bien montrer malgré vôtre pouvoir,	Qu'il saura bien montrer malgré votre pouvoir,
La haine que pour vous il ſe reſout d’avoir;	La haine que pour vous il se résout d'avoir;
Braver vôtre furie, & vous faire connoître	Braver votre furie, et vous faire connaître
Qu’il n’a point été lâche, & ne veut jamais l’étre.	Qu'il n'a point été lâche, et ne veut jamais l'être.
Hé bien je ſuis coupable, & ne m’en defend pas,	Hé bien je suis coupable, et ne m'en défends pas,
Mais je demande grace à vos divins appas;	Mais je demande grâce à vos divins appas;
Je la demande au nom de la plus vive flame,	Je la demande au nom de la plus vive flamme,
Dont jamais deux beaux yeux ayent fait brûler une ame.	Dont jamais deux beaux yeux aient fait brûler une âme.
Que ſi vôtre courroux ne peut étre appaiſé,	Que si votre courroux ne peut être apaisé,
Si mon crime eſt trop grand pour ſe voir excuſé,	Si mon crime est trop grand pour se voir excusé,
Si vous ne regardez, ni l’amour qui le cauſe,	Si vous ne regardez, ni l'amour qui le cause,
Ni le vif repentir que mon cœur vous expoſe;	Ni le vif repentir que mon cœur vous expose;
Il faut qu’un coup heureux, en me faiſant mourir,	Il faut qu'un coup heureux, en me faisant mourir,
M'arrache à des tourmens que je ne puis ſouffrir.	M'arrache à des tourments que je ne puis souffrir.
Non, ne preſumez pas, qu’ayant ſçeu vous deplaire,	Non, ne présumez pas, qu'ayant su vous déplaire,
Je puiſſe vivre une heure avec vôtre colere.	Je puisse vivre une heure avec votre colère.
Deja de ce moment la barbare longueur,	Déjà de ce moment la barbare longueur,
Sous ſes cuiſans remords fait ſuccomber mon cœur;	Sous ses cuisants remords fait succomber mon cœur;
Et de mille Vautours les bleſſures cruelles,	Et de mille Vautours les blessures cruelles,
N’ont rien de comparable à ſes douleurs mortelles;	N'ont rien de comparable à ses douleurs mortelles;
Madame, vous n’avez qu’à me le déclarer,	Madame, vous n'avez qu'à me le déclarer,
S’il n’eſt point de pardon que je doive eſperer,	S'il n'est point de pardon que je doive espérer,
Cette épée auſſi-tôt, par un coup favorable	Cette épée aussitôt, par un coup favorable
Va percer à vos yeux le cœur d’un miſerable;	Va percer à vos yeux le cœur d'un misérable;
Ce cœur, ce traître cœur, dont les perplexitez,	Ce cœur, ce traître cœur, dont les perplexités,
Ont ſi fort outragé vos extrêmes bontez;	Ont si fort outragé vos extrêmes bontés;
Trop heureux en mourant, ſi ce coup legitime	Trop heureux en mourant, si ce coup légitime
Efface en vôtre eſprit l’Image de mon crime;	Efface en votre esprit l'image de mon crime;
Et ne laiſſe aucuns traits de vôtre averſion	Et ne laisse aucuns traits de votre aversion
Au foible ſouvenir de mon affection;	Au faible souvenir de mon affection;
C’eſt l’unique faveur que demande ma flame.	C'est l'unique faveur que demande ma flamme.
Ha! Prince trop cruel.	Ha! Prince trop cruel.
Dites, parlez, Madame.	Dites, parlez, Madame.
Faut-il encor pour vous conſerver des bontez,	Faut-il encore pour vous conserver des bontés,
Et vous voir m’outrager par tant d’indignitez.	Et vous voir m'outrager par tant d'indignités.
Un cœur ne peut jamais outrager quand il aime,	Un cœur ne peut jamais outrager quand il aime,
Et ce que fait l’amour il l'excuſe lui-même.	Et ce que fait l'amour il l'excuse lui-même.
L’amour n’excuſe point de tels emportemens.	L'amour n'excuse point de tels emportements.
Tout ce qu’il a d’ardeur paſſe en ſes mouvemens,	Tout ce qu'il a d'ardeur passe en ses mouvements,
Et plus il devient fort, plus il trouve de peine....	Et plus il devient fort, plus il trouve de peine…
Non, ne m’en parlez point vous meritez ma haine	Non, ne m'en parlez point, vous méritez ma haine
Vous me haïſſez donc?	Vous me haïssez donc?
J’y veux tâcher au moins;	J'y veux tâcher, au moins;
Mais, helas! je crains bien que j'y perde mes ſoins,	Mais, hélas! je crains bien que j'y perde mes soins,
Et que tout le courroux qu’excite vôtre offence	Et que tout le courroux qu'excite votre offense
Ne puiſſe juſques-là faire aller ma vangeance.	Ne puisse jusque-là faire aller ma vengeance.
D’un ſupplice ſi grand ne tentez point l’effort,	D'un supplice si grand ne tentez point l'effort,
Puiſque pour vous vanger je vous offre ma mort;	Puisque pour vous venger je vous offre ma mort;
Prononcez en l’arrêt, & j’obeïs ſur l’heure.	Prononcez-en l'arrêt, et j'obéis sur l'heure.
Qui ne ſçauroit haïr, ne peut vouloir qu’on meure.	Qui ne saurait haïr, ne peut vouloir qu'on meure.
Et moi je ne puis vivre, à moins que vos bontez	Et moi je ne puis vivre à moins que vos bontés
Accordent un pardon à mes temeritez,	Accordent un pardon à mes témérités,
Reſolvez l’un des deux, de punir, on d’abſoudre.	Résolvez l'un des deux, de punir, ou d'absoudre.
Helas! j’ai trop fait voir, ce que je puis reſoudre.	Hélas! j'ai trop fait voir, ce que je puis résoudre.
Par l’aveu d’un pardon, n’eſt ce pas ſe trahir,	Par l'aveu d'un pardon, n'est-ce pas se trahir,
Que dire au criminel qu’on ne lui peut haïr;	Que dire au criminel qu'on ne le peut haïr;
Ah! c’en eſt trop, ſouffrez, adorable Princeſſe.	Ah! c'en est trop, souffrez, adorable Princesse.
Laiſſez, je me veux mal d’une telle foibleſſe.	Laissez, je me veux mal d'une telle faiblesse.
Enfin je ſuis....	Enfin je suis…
SEigneur, je viens vous informer,	Seigneur, je viens vous informer,
D’un ſecret dont vos feux ont droit de s’allarmer.	D'un secret dont vos feux ont droit de s'alarmer.
Ne me viens point parler de ſecret, ny d’allarme	Ne me viens point parler de secret, ni d'alarme
Dans les doux mouvemens du tranſport qui me charme,	Dans les doux mouvements du transport qui me charme,
Aprés ce qu’à mes yeux on vient de preſenter,	Après ce qu'à mes yeux on vient de présenter,
Il n’eſt point de ſoupçons que je doive écouter;	Il n'est point de soupçons que je doive écouter;
Et d’un divin objet la bonté ſans pareille,	Et d'un divin objet la bonté sans pareille,
A tous ces vains rapports, doit fermer mon oreille,	À tous ces vains rapports doit fermer mon oreille,
Ne m’en fait plus.	Ne m'en fais plus.
Seigneur, je veux ce qu’il vous plaît,	Seigneur, je veux ce qu'il vous plaît,
Mes ſoins en tout cecin’ont que vôtre interêt;	Mes soins en tout ceci n'ont que votre intérêt;
J’ai crû que le ſecret que je viens de ſurprendre	J'ai cru que le secret que je viens de surprendre
Meritoit bien qu’en hâte on vous le vint apprendre;	Méritait bien qu'en hâte on vous le vînt apprendre;
Mais puiſque vous voulez que je n’en touche rien,	Mais puisque vous voulez que je n'en touche rien,
Je vous dirai, Seigneur, pour changer d’entretien,	Je vous dirai, Seigneur, pour changer d'entretien,
Que deja dans Leon on voit chaque famille	Que déjà dans Léon on voit chaque famille
Lever le maſque au bruit des troupes de Caſtille,	Lever le masque au bruit des troupes de Castille,
Et que ſur tout le peuple y ſçait pour ſon vrai Roi	Et que surtout le peuple y fait pour son vrai Roi
Un éclat à donner au tiran de l’effroi.	Un éclat à donner au tyran de l'effroi.
La Caſtille du moins n’aura pas la victoire,	La Castille du moins n'aura pas la victoire,
Sans que nous eſſayons d’en partager la gloire;	Sans que nous essayions d'en partager la gloire;
Et nos troupes auſſi peuvent étre en état,	Et nos troupes aussi peuvent être en état,
D’imprimer quelque crainte au cœur de Mauregat.	D'imprimer quelque crainte au cœur de Mauregat.
Mais quel eſt ce ſecret, dont tu voulois m’inſtruire,	Mais quel est ce secret dont tu voulais m'instruire,
Voyons un peu?	Voyons un peu?
Seigneur, je n’ai rien à vous dire.	Seigneur, je n'ai rien à vous dire.
Va, va, parle, mon cœur t’en donne le pouvoir.	Va, va, parle, mon cœur t'en donne le pouvoir.
Vos paroles, Seigneur, m’en ont trop fait ſçavoir,	Vos paroles, Seigneur, m'en ont trop fait savoir;
Et puiſque mes avis ont dequoi vous deplaire,	Et puisque mes avis ont de quoi vous déplaire,
Je ſçaurai deſormais trouver l’art de me taire.	Je saurai désormais trouver l'art de me taire.
Enfin, je veux ſçavoir la choſe abſolument.	Enfin, je veux savoir la chose absolument.
Je ne replique point à ce commandement;	Je ne réplique point à ce commandement;
Mais, Seigneur, en ce lieu le devoir de mon zele	Mais, Seigneur, en ce lieu le devoir de mon zèle
Trahiroit le ſecret d’une telle nouvelle.	Trahirait le secret d'une telle nouvelle.
Sortons pour vous l’apprendre, & ſans rien embraſſer.	Sortons pour vous l'apprendre; et sans rien embrasser.
Vous même vous verrez ce qu’on en doit penſer.	Vous-même vous verrez ce qu'on en doit penser.
ELiſe, que dis tu de l’étrange foibleſſe,	Élise, que dis-tu de l'étrange faiblesse,
Que vient de témoigner le cœur d’une Prin¬ceſſe?	Que vient de témoigner le cœur d'une Princesse?
Que dis tu de me voir tomber ſi promptement,	Que dis-tu de me voir tomber si promptement,
De toute la chaleur de mon reſſentiment;	De toute la chaleur de mon ressentiment;
Et malgré tant d’éclat relâcher mon courage	Et malgré tant d'éclat relâcher mon courage
Au pardon trop heureux d’un ſi cruel outrage?	Au pardon trop honteux d'un si cruel outrage?
Moi, je dis que d’un cœur que nous pouvons cherir,	Moi, je dis que d'un cœur que nous pouvons chérir,
Une injure ſans doute eſt bien dure a ſouffrir:	Une injure sans doute est bien dure à souffrir;
Mais que s’il n’en eſt point qui davantage irrite,	Mais que s'il n'en est point qui davantage irrite,
Il n’en eſt point auſſi qu’on pardonne ſi vîte;	Il n'en est point aussi qu'on pardonne si vite;
Et qu’un coupable aimé triomphe à nos genoux	Et qu'un coupable aimé triomphe à nos genoux
De tous les promts tranſports du plus boüillant courroux,	De tous les prompts transports du plus bouillant courroux,
D’autant plus aiſément, Madame, quand l’offence	D'autant plus aisément, Madame, quand l'offense
Dans un excez d’amour peut trouver ſa naiſſance;	Dans un excès d'amour peut trouver sa naissance;
Ainſi quelque depit que l’on vous ait cauſé,	Ainsi quelque dépit que l'on vous ait causé,
Je ne m’étonne point de le voir appaiſé;	Je ne m'étonne point de le voir apaisé;
Et je ſçai quel pouvoir malgré vôtre menace,	Et je sais quel pouvoir malgré votre menace,
A de pareils forfaits donnera toûjours grace.	À de pareils forfaits donnera toujours grâce.
Ah! ſçache quelque ardeur qui m'impoſe des loix,	Ah! Sache, quelque ardeur qui m'impose des lois,
Que mon front a rougi pour la derniere fois,	Que mon front a rougi pour la dernière fois,
Et que ſi deſormais on pouſſe ma colere,	Et que si désormais on pousse ma colère,
Il n’eſt point de retour qu’il faille qu’on eſpere.	Il n'est point de retour qu'il faille qu'on espère.
Quand je pourrois reprendre un tendre ſentiment,	Quand je pourrais reprendre un tendre sentiment,
C’eſt aſſez contre lui que l’éclat d’un ſerment;	C'est assez contre lui que l'éclat d'un serment;
Car enfin un eſprit qu’un peu d’orgueil inſpire,	Car enfin un esprit qu'un peu d'orgueil inspire,
Trouve beaucoup de honte à ſe pouvoir dedire;	Trouve beaucoup de honte à se pouvoir dédire;
Et ſouvent aux depens d’un penible combat,	Et souvent, aux dépens d'un pénible combat,
Fait ſur ſes propres vœux un illuſtre attentat,	Fait sur ses propres vœux un illustre attentat,
S’obſtine par honneur, & n’a rien qu’il n’immole	S'obstine par honneur, et n'a rien qu'il n'immole
A la noble fierté de tenir ſa parole.	À la noble fierté de tenir sa parole.
Ainſi dans le pardon que l’on vient d’obtenir,	Ainsi dans le pardon que l'on vient d'obtenir,
Ne prens point de clartez pour regler l’avenir;	Ne prends point de clartés pour régler l'avenir;
Et quoi qu’à mes deſtins la fortune prepare,	Et quoi qu'à mes destins la fortune prépare,
Crois que je ne puis être au Prince de Navarre,	Crois que je ne puis être au Prince de Navarre,
Que de ces noirs accez qui troublent ſa raiſon,	Que de ces noirs accès qui troublent sa raison,
Il n’ait fait éclater l'entiere gueriſon,	Il n'ait fait éclater l'entière guérison,
Et reduit tout mon cœur que ce mal perſecute,	Et réduit tout mon cœur que ce mal persécute,
A n’en plus redouter l’affront d’une recheute.	À n'en plus redouter l'affront d'une rechute.
Mais quel affront nous fait le tranſport d’un j’aloux.	Mais quel affront nous fait le transport d'un jaloux.
En eſt-il un qui ſoit plus digne de courroux?	En est-il un qui soit plus digne de courroux?
Et puis que nôtre cœur fait un effort extréme,	Et puisque notre cœur fait un effort extrême,
Lors qu’il ſe peut reſoudre à confeſſer qu’il aime?	Lorsqu'il se peut résoudre à confesser qu'il aime?
Puiſque l’honneur du Sexe en tout tems rigoureux,	Puisque l'honneur du Sexe, en tout temps rigoureux,
Oppoſe un fort obſtacle à de pareils aveux.	Oppose un fort obstacle à de pareils aveux.
L’Amant qui voit pour lui franchir un tel obſtacle,	L'Amant qui voit pour lui franchir un tel obstacle,
Doit il impunement douter de cet Oracle?	Doit-il impunément douter de cet Oracle?
Et n’eſt-il pas coupable, alors qu’il ne croit pas,	Et n'est-il pas coupable alors qu'il ne croit pas,
Ce qu’on ne dit jamais qu’aprés de grands combats.	Ce qu'on ne dit jamais qu'après de grands combats?
Moi, je tiens que toujours un peu de defiance,	Moi, je tiens que toujours un peu de défiance,
En ces occaſions n’a rien qui nous offence;	En ces occasions n'a rien qui nous offense;
Et qu’il eſt dangereux qu’un cœur qu’on a charmé,	Et qu'il est dangereux qu'un cœur qu'on a charmé,
Soit trop perſuadé, Madame, d’étre aimé.	Soit trop persuadé, Madame, d'être aimé.
Si....	Si…
N’en diſputons plus, chacun a ſa penſée,	N'en disputons plus, chacun a sa pensée,
C’eſt un ſcrupule, enfin, dont mon ame eſt bleſſée;	C'est un scrupule, enfin, dont mon âme est blessée;
Et contre mes deſirs, je ſens je ne ſçai quoi,	Et contre mes désirs, je sens je ne sais quoi,
Me predire un éclat entre le Prince & moi;	Me prédire un éclat entre le Prince et moi;
Qui malgré ce qu’on doit aux vertus dont il brille.	Qui malgré ce qu'on doit aux vertus dont il brille.
Mais ô Ciel! en ces lieux, D. Silve de Caſtille,	Mais ô Ciel! en ces lieux D. Sylve de Castille,
Ah! Seigneur, par quel ſort vous vois-je maintenant?	Ah! Seigneur, par quel sort vous vois-je maintenant?
JE ſçai que mon abord, Madame, eſt ſurprenant,	Je sais que mon abord, Madame, est surprenant,
Et qu’étre ſans éclat entré dans cette Ville,	Et qu'être sans éclat entré dans cette Ville,
Dont l’ordre d’un Rival rend l’accez difficile;	Dont l'ordre d'un Rival rend l'accès difficile;
Qu’avoir pu me ſoutraire aux yeux de ſes Soldats,	Qu'avoir pu me soustraire aux yeux de ses Soldats,
C’eſt un évenement que vous n’attendiez pas.	C'est un événement que vous n'attendiez pas.
Mais ſi j’ai dans ces lieux franchi quelques obſtacles	Mais si j'ai dans ces lieux franchi quelques obstacles
L’ardeur de vous revoir peut bien d’autres miracles.	L'ardeur de vous revoir peut bien d'autres miracles.
Tout mon cœur a ſenti par de trop rudes coups	Tout mon cœur a senti par de trop rudes coups
Le rigoureux deſtin d’étre éloigné de vous;	Le rigoureux destin d'être éloigné de vous;
Et je n’ai pu nier au tourment qui le tüe,	Et je n'ai pu nier au tourment qui le tue,
Quelques momens ſecrets d’une ſi chere veüe.	Quelques moments secrets d'une si chère vue.
Je viens vous dire donc que je rends grâce aux Cieux	Je viens vous dire donc que je rends grâce aux Cieux
De vous voir hors des mains d’un tiran odieux;	De vous voir hors des mains d'un tyran odieux;
Mais parmi les douceurs d’une telle avanture,	Mais parmi les douceurs d'une telle aventure,
Ce qui m’eſt un ſujet d’éternerlle torture,	Ce qui m'est un sujet d'éternelle torture,
C’eſt de voir qu’à mon bras les rigueurs de mon ſort	C'est de voir qu'à mon bras les rigueurs de mon sort
Ont envié l’honneur en cet illuſtre effort,	Ont envié l'honneur de cet illustre effort,
Et fait à mon Rival, avec trop d’injuſtice,	Et fait à mon Rival, avec trop d'injustice,
Offrir les doux perils d’un ſi fameux ſervice;	Offrir les doux périls d'un si fameux service;
Oüi, Madame, j’avois pour rompre vos liens	Oui, Madame, j'avais, pour rompre vos liens
Des ſentimens ſans doute auſſi beaux que les ſiens;	Des sentiments sans doute aussi beaux que les siens;
Et je pouvois pour vous gagner cette victoire,	Et je pouvais pour vous gagner cette victoire,
Si le Ciel n’eut voulu m’en dérober la gloire.	Si le Ciel n'eût voulu m'en dérober la gloire.
Je ſçai, Seigneur, je ſçai, que vous avez un cœur,	Je sais, Seigneur, je sais que vous avez un cœur,
Qui des plus grands perils vous peut rendre vainqueur;	Qui des plus grands périls vous peut rendre vainqueur;
Et je ne doute point que ce genereux zele,	Et je ne doute point que ce généreux zèle,
Dont la chaleur vous pouſſe à vanger ma querelle,	Dont la chaleur vous pousse à venger ma querelle,
N’eut contre les efforts d’un indigne projet	N'eût contre les efforts d'un indigne projet
Pu faire en ma faveur tout ce qu’un autre a fait.	Pu faire en ma faveur tout ce qu'un autre a fait.
Mais ſans cette action, dont vous étiez capable,	Mais sans cette action dont vous étiez capable,
Mon ſort à la Caſtille eſt aſſez redevable;	Mon sort à la Castille est assez redevable;
On ſçait ce qu’en ami, plein d’ardeur & de foi,	On sait ce qu'en ami, plein d'ardeur et de foi,
Le Comte vôtre Pere a fait pour le feu Roi.	Le Comte votre Père a fait pour le feu Roi.
Aprés l’avoir aidé, juſqu’à l’heure derniere,	Après l'avoir aidé, jusqu'à l'heure dernière,
Il donne en ſes Etats un azile à mon Frere.	Il donne en ses États un asile à mon Frère.
Quatre luſtres entiers, il y cache ſon ſort,	Quatre lustres entiers il y cache son sort,
Aux barbares fureurs de quelque lâche effort;	Aux barbares fureurs de quelque lâche effort;
Et pour rendre à mon front l’éclat d’une Couronne,	Et pour rendre à son front l'éclat d'une Couronne,
Contre nos ravifſeurs vous marchez en perſonne.	Contre nos ravisseurs vous marchez en personne.
N’étes-vous pas content, & ces ſoins genereux.	N'êtes-vous pas content, et ces soins généreux.
Ne m’arrachent-ils point par d’aſſez puiſſans nœuds?	Ne m'attachent-ils point par d'assez puissants nœuds?
Quoi vôtre ame, Seigneur, ſeroit elle obſtinée	Quoi? Votre âme, Seigneur, serait-elle obstinée
A vouloir aſſervir toure ma deſtinée;	À vouloir asservir toute ma destinée;
Et faut-il que jamais il ne tombe ſur nous	Et faut-il que jamais il ne tombe sur nous
L’ombre d’un ſeul bien ſait qu’il ne vienne de vous?	L'ombre d'un seul bienfait qu'il ne vienne de vous?
Ah! ſouffrez dans les maux, où mon deſtin m'expoſe,	Ah! souffrez dans les maux où mon destin m'expose,
Qu’aux ſoins d’une autre auſſi, je doive quelque choſe:	Qu'aux soins d'un autre aussi, je doive quelque chose:
Et ne vous plaignez point de voir un autre bras,	Et ne vous plaignez point de voir un autre bras,
Acquerir de la gloire, où le vôtre n’eſt pas.	Acquérir de la gloire, où le vôtre n'est pas.
Oüi, Madame, mon cœur doit ceſſer de s’en plaindre,	Oui, Madame, mon cœur doit cesser de s'en plaindre,
Avec trop de raiſon vous voulez m’y contraindre,	Avec trop de raison vous voulez m'y contraindre,
Et c’eſt injuſtement qu’on ſe plaint d’un malheur,	Et c'est injustement qu'on se plaint d'un malheur,
Quand un autre plus grand s’offre à nôtre douleur.	Quand un autre plus grand s'offre à notre douleur.
Ce ſecours d’un Rival m’eſt un cruel martyre;	Ce secours d'un Rival m'est un cruel martyre;
Mais, helas! de mes maux, ce n’eſt pas là le pire,	Mais, hélas! de mes maux ce n'est pas là le pire,
Le coup, le rude coup, dont je ſuis atterré,	Le coup, le rude coup, dont je suis atterré,
C’eſt de me voir par vous ce Rival preferé.	C'est de me voir par vous ce Rival préféré.
Oüi, je ne vois que trop, que ſes feux pleints de gloire	Oui, je ne vois que trop, que ses feux pleins de gloire
Sur les miens dans vôtre ame emportent la victoire;	Sur les miens dans votre âme emportent la victoire;
Er cette occaſion de ſervir vos appas,	Et cette occasion de servir vos appas,
Cet avantage offert de ſignaler ſon bras,	Cet avantage offert de signaler son bras,
Cet éclatant exploit qui vous fut ſalutaire,	Cet éclatant exploit qui vous fut salutaire,
N’eſt que le pur effet du bonheur de vous plaire;	N'est que le pur effet du bonheur de vous plaire;
Que le ſecret pouvoir d’un aſtre merveilleux,	Que le secret pouvoir d'un astre merveilleux,
Qui fait tomber la gloire, où s’attachent vos vœux.	Qui fait tomber la gloire, où s'attachent vos vœux.
Ainſi tous mes efforts ne ſeront que fumée,	Ainsi tous mes efforts ne seront que fumée.
Contre vos fiers Tyrans je conduis une armée.	Contre vos fiers Tyrans je conduis une armée.
Mais je marche en tremblant à cet illuſtre emploi,	Mais je marche en tremblant à cet illustre emploi,
Aſſuré que vos vœux ne ſeront pas pour moi,	Assuré que vos vœux ne seront pas pour moi,
Et que s’ils ſont ſuivis la fortune prepare	Et que s'ils sont suivis la fortune prépare
L'heur des plus beaux ſucces aux ſoins de la Navarre,	L'heur des plus beaux succès aux soins de la Navarre,
Ah! Madame, faut-il me voir precipité.	Ah! Madame, faut-il me voir précipité.
De l’eſpoir glorieux dont je m’étois flatté;	De l'espoir glorieux dont je m'étais flatté;
Et ne puis-je ſçavoir quels crimes on m'impute,	Et ne puis-je savoir quels crimes on m'impute,
Pour avoir merité cette effroyable cheute?	Pour avoir mérité cette effroyable chute?
Ne me demandez rien avant que regarder,	Ne me demandez rien avant que regarder,
Ce qu’à mes ſentimens vous devez demander;	Ce qu'à mes sentiments vous devez demander;
Et ſur cette froideur qui ſemble vous confondre,	Et sur cette froideur qui semble vous confondre,
Répondez-vous, Seigneur, ce que je puis répondre,	Répondez-vous, Seigneur, ce que je puis répondre,
Car enfin tous vos ſoins ne ſçauroient ignorer	Car enfin tous vos soins ne sauraient ignorer
Quels ſecrets de vôtre ame on m’a ſçeu déclarer.	Quels secrets de votre âme on m'a su déclarer.
Et je la crois cette ame, & trop noble, & trop haute,	Et je la crois, cette âme, et trop noble, et trop haute,
Pour vouloir m’obliger à commettre une faute;	Pour vouloir m'obliger à commettre une faute;
Vous-même, dites vous, s’il eſt de l’équité,	Vous-même, dites-vous, s'il est de l'équité,
De me voir couronner une infidelité.	De me voir couronner une infidélité.
Si vous pouviez m’offrir, ſans beaucoup d'injuſtice	Si vous pouviez m'offrir, sans beaucoup d'injustice
Un cœur à d’autres yeux offert en ſacrifice;	Un cœur à d'autres yeux offert en sacrifice;
Vous plaindre avec raiſon, & blâmer mes refus,	Vous plaindre avec raison, et blâmer mes refus,
Lors qu’ils veulent d’un crime affranchir vos vertus.	Lorsqu'ils veulent d'un crime affranchir vos vertus.
Oüi, Seigneur, c’eſt un crime & les premieres flâmes	Oui, Seigneur, c'est un crime et les premières flammes
Ont des droits ſi ſacrez ſur les illuſtres ames,	Ont des droits si sacrés sur les illustres âmes,
Qu’il faut perdre grandeurs, & renoncer au jour,	Qu'il faut perdre grandeurs, et renoncer au jour,
Plûtôt que de pancher vers un ſecond amour.	Plutôt que de pencher vers un second amour.
J’ai pour vous cette ardeur que peut prendre l’eſtime	J'ai pour vous cette ardeur que peut prendre l'estime
Pour un courage haut, pour un cœur magnanime;	Pour un courage haut, pour un cœur magnanime;
Mais n’exigez de moi que ce que je vous dois,	Mais n'exigez de moi que ce que je vous dois,
Et ſoûtenez l’honneur de vôtre premier choix.	Et soutenez l'honneur de votre premier choix.
Malgré vos feux nouveaux, voyez quelle tendreſſe	Malgré vos feux nouveaux, voyez quelle tendresse
Vous conſerve le cœur de l’aimable Comteſſe;	Vous conserve le cœur de l'aimable Comtesse;
Ce que pour un ingrat (car vous l’êtes Seigneur,)	Ce que pour un ingrat (car vous l'êtes, Seigneur,)
Elle a d’un choix conſtant refuſé le bonheur.	Elle a d'un choix constant refusé de bonheur.
Quel mépris genereux dans ſon ardeur extrême,	Quel mépris généreux dans son ardeur extrême,
Elle a fait de l’éclat, que donne un Diademe;	Elle a fait de l'éclat, que donne un Diadème;
Voyez combien d’efforts pour vous elle a bravez,	Voyez combien d'efforts pour vous elle a bravés,
Et rendez à ſon cœur, ce que vous lui devez.	Et rendez à son cœur, ce que vous lui devez.
Ah! Madame, à mes yeux n’offrez point ſon merite;	Ah! Madame, à mes yeux n'offrez point son mérite;
Il n’eſt que trop preſent à l’ingrat qui la quitte;	Il n'est que trop présent à l'ingrat qui la quitte;
Et ſi mon cœur vous dit, ce que pour elle il ſent,	Et si mon cœur vous dit, ce que pour elle il sent,
J’ai peur qu’il ne ſoit pas envers vous innocent.	J'ai peur qu'il ne soit pas envers vous innocent.
Oüi, ce cœur l’oſe plaindre, & ne ſuit pas ſans peine	Oui, ce cœur l'ose plaindre, et ne suit pas sans peine
L’imperieux effort de l’amour qui l’entraîne.	L'impérieux effort de l'amour qui l'entraîne.
Aucun eſpoir pour vous n’a flatté mes deſirs,	Aucun espoir pour vous n'a flatté mes désirs,
Qui ne m’ait arraché pour elle des ſoûpirs;	Qui ne m'ait arraché pour elle des soupirs;
Qui n’ait dans ſes douceurs fait jetter à mon ame,	Qui n'ait dans ses douceurs fait jeter à mon âme,
Quelques triſtes regards vers ſa premiere flame;	Quelques tristes regards vers sa première flamme;
Se reprocher l’effet de vos divins attraits,	Se reprocher l'effet de vos divins attraits,
Et mêler des remords à mes plus chers ſouhaits.	Et mêler des remords à mes plus chers souhaits.
J’ai fait plus que cela, puiſqu’il vous faut tout dire,	J'ai fait plus que cela, puisqu'il vous faut tout dire,
Oüi, j’ai voulu ſur moi vous ôter vôtre empire,	Oui, j'ai voulu sur moi vous ôter votre empire,
Sortir de vôtre chaine, & rejetter mon cœur,	Sortir de votre chaîne, et rejeter mon cœur,
Sous le jong innocent de ſun premier vainqueur.	Sous le joug innocent de son premier vainqueur.
Mais aprés mes efforts ma conſtance abbatüe	Mais après mes efforts, ma constance abattue
Voit un cours neceſſaire à ce mal qui me tüe.	Voit un cours nécessaire à ce mal qui me tue.
Et deût être mon ſort à jamais malheureux,	Et dût être mon sort à jamais malheureux,
Je ne puis renoncer à l’eſpoir de mes vœux;	Je ne puis renoncer à l'espoir de mes vœux;
Je ne ſçaurois ſouffrir l’épouvantable idée	Je ne saurais souffrir l'épouvantable idée
De vous voir par un autre à mes yeux poſſedée;	De vous voir par un autre à mes yeux possédée;
Et le flambeau du jour qui m’offre vos appas,	Et le flambeau du jour qui m'offre vos appas,
Doit avant cet Hymen éclairer mon trépas.	Doit avant cet Hymen éclairer mon trépas.
Ie ſçai que je trahis une Princeſſe aimable,	Je sais que je trahis une Princesse aimable,
Mais, Madame, aprés tout mon cœur eſt il coupable?	Mais, Madame, après tout mon cœur est-il coupable?
Et le fort aſcendant, que prend vôtre beauté,	Et le fort ascendant, que prend votre beauté,
Laiſſe-t’il aux eſprits aucune liberté?	Laisse-t-il aux esprits aucune liberté?
Helas! je ſuis ici bien plus à plaindre qu'elle,	Hélas! je suis ici bien plus à plaindre qu'elle,
Son cœur, en me perdant, ne perd qu’un infidelle.	Son cœur, en me perdant, ne perd qu'un infidèle.
D’un pareil déplaiſir on ſe peut conſoler;	D'un pareil déplaisir on se peut consoler;
Mais moi par un malheur qui ne peut s’égaler,	Mais moi par un malheur qui ne peut s'égaler,
J’ai celui de quitter une aimable perſonne,	J'ai celui de quitter une aimable personne,
Et tous les maux encor que mon amour me donne.	Et tous les maux encore que mon amour me donne.
Vous n’avez que les maux que vous voulez avoir,	Vous n'avez que les maux que vous voulez avoir,
Et toûjours nôtre cœut eſt en nôtre pouvoir;	Et toujours notre cœur est en notre pouvoir;
Il peut bien quelquefois montrer quelque foibleſſe,	Il peut bien quelquefois montrer quelque faiblesse,
Mais enfin, ſur nos ſens, la raiſon, la maîtreſſe....	Mais enfin, sur nos sens, la raison, la maîtresse…
MAdame, mon abord, comme je connois bien,	Madame, mon abord, comme je connais bien,
Aſſez mal-à propos trouble vôtre entretien;	Assez mal à propos trouble votre entretien;
Et mes pas en ce lieu, s’il faut que je le die,	Et mes pas en ce lieu, s'il faut que je le die,
Ne croyoient pas trouver ſi bonne compagnie.	Ne croyaient pas trouver si bonne compagnie.
Cette veüe, en effet, ſurprend au dernier poinct,	Cette vue, en effet, surprend au dernier point;
Et de même que vous, je ne l’attendois point.	Et de même que vous, je ne l'attendais point.
Oüi, Madame, je croi que de cette viſite,	Oui, Madame, je crois que de cette visite,
Comme vous l’aſſurez, vous n’étiez point inſtruite;	Comme vous l'assurez, vous n'étiez point instruite;
Mais, Seigneur, vous deviez nous faire au moins l’hon¬neur	Mais, Seigneur, vous deviez nous faire au moins l'honneur
De nous donner avis de ce rare bonheur;	De nous donner avis de ce rare bonheur;
Et nous mettre en êtat, ſans nous vouloir ſurprendre	Et nous mettre en état, sans nous vouloir surprendre
De vous rendre en ces lieux, ce qu’on voudroit vous rendre.	De vous rendre en ces lieux ce qu'on voudrait vous rendre.
Les heroïques ſoins vous occupent ſi fort,	Les héroïques soins vous occupent si fort,
Que de vous en tirer, Seigneur, j’aurois eu tort	Que de vous en tirer, Seigneur, j'aurais eu tort
Et des grands Conquerans les ſublimes penſées	Et des grands Conquérants les sublimes pensées
Sont aux civilitez avec peine abbaiſſées.	Sont aux civilités avec peine abaissées.
Mais les grands Conquerans, dont on vante les ſoins,	Mais les grands Conquérants, dont on vante les soins,
Loin d’aimer le ſecret, affectent les témoins,	Loin d'aimer le secret, affectent les témoins,
Leur ame dés l’enfance à la gloire élevée,	Leur âme dès l'enfance à la gloire élevée,
Les fait dans leurs projets aller tête levée;	Les fait dans leurs projets aller tête levée;
Et s’appuyant toûjours ſur des hauts ſentimens,	Et s'appuyant toujours sur des hauts sentiments,
Ne s’abaiſſe jamais à des déguiſemens.	Ne s'abaisse jamais à des déguisements.
Ne commettez vous point vos vertus heroïques,	Ne commettez-vous point vos vertus héroïques,
En paſſant dans ces lieux par des ſourdes pratiques;	En passant dans ces lieux par des sourdes pratiques;
Et ne craignez vous point, qu’on puiſſe aux yeux de tous	Et ne craignez-vous point, qu'on puisse aux yeux de tous
Trouver cette action trop indigne de vous?	Trouver cette action trop indigne de vous?
Ie ne ſçay ſi quelqu’un blâmera ma conduite,	Je ne sais si quelqu'un blâmera ma conduite,
Au ſecret que j’ay fait d’une telle viſite;	Au secret que j'ai fait d'une telle visite;
Mais je ſçay qu’aux projets qui veulent la clarté,	Mais je sais qu'aux projets qui veulent la clarté,
Prince, je n’ay jamais cherché l’obſcurité.	Prince, je n'ai jamais cherché l'obscurité.
Et quand j'auray ſur vous à faire une entrepriſe,	Et quand j'aurai sur vous à faire une entreprise,
Vous n’aurez pas ſujet de blâmer la ſurpriſe;	Vous n'aurez pas sujet de blâmer la surprise;
Il ne tiendra qu’à vous de vous en garantir,	Il ne tiendra qu'à vous de vous en garantir,
Et l’on prendra le ſoin de vous en avertir.	Et l'on prendra le soin de vous en avertir.
Cependant demeurons aux termes ordinaires,	Cependant demeurons aux termes ordinaires,
Remettons nos débats aprés d’autres affaires;	Remettons nos débats après d'autres affaires;
Et d’un ſang un peu chaud reprimant les boüillons,	Et d'un sang un peu chaud réprimant les bouillons,
N’oublions pas tous deux, devant qui nous parlons.	N'oublions pas tous deux devant qui nous parlons.
Prince, vous avez tort, & ſa viſite eſt telle;	Prince, vous avez tort, et sa visite est telle;
Que vous....	Que vous…
Ah! c’en eſt trop que prendre ſa querelle,	Ah! c'en est trop que prendre sa querelle,
Madame, & vôtre eſprit devroit feindre un peu mieux,	Madame, et votre esprit devrait feindre un peu mieux,
Lors qu’il veut ignorer ſa venuë en ſes lieux.	Lorsqu'il veut ignorer sa venue en ses lieux.
Cette chaleur ſi prompte, à vouloir la défendre,	Cette chaleur si prompte, à vouloir la défendre,
Perſuade aſſez mal, qu’elle ait pû vous ſurprendre.	Persuade assez mal, qu'elle ait pu vous surprendre.
Quoy que vous ſoupçonniez, il m’importe ſi peu,	Quoi que vous soupçonniez, il m'importe si peu,
Que j’aurois du regret d’en faire un deſaveu.	Que j'aurais du regret d'en faire un désaveu.
Pouſſez-donc juſqu’au bout cet orgueil heroïque,	Poussez donc jusqu'au bout cet orgueil héroïque,
Et que ſans heſiter tout vôtre cœur s'explique;	Et que sans hésiter tout votre cœur s'explique;
C’eſt au déguiſement donner trop de credit;	C'est au déguisement donner trop de crédit;
Ne deſavoüez rien, puiſque vous l’avez dit.	Ne désavouez rien, puisque vous l'avez dit.
Tranchez, tranchez le mot, forcez toute contrainte,	Tranchez, tranchez le mot, forcez toute contrainte,
Dites que de ſes feux vous reſſentez l’atteinte;	Dites que de ses feux vous ressentez l'atteinte;
Que pour vous ſa preſence à des charmes ſi doux....	Que pour vous sa présence a des charmes si doux…
Et ſi je veux l’aimer m’en empêcherez-vous?	Et si je veux l'aimer m'en empêcherez-vous?
Avez vous ſur mon cœur quelque empire à pretendre,	Avez-vous sur mon cœur quelque empire à prétendre,
Et pour regler mes vœux ai je vôtre ordre à prendre?	Et pour régler mes vœux ai-je votre ordre à prendre?
Sçachez que trop d’orgueil a pû vous décevoir,	Sachez que trop d'orgueil a pu vous décevoir,
Si vôtre cœur ſur moi s eſt crû quelque pouvoir;	Si votre cœur sur moi s'est cru quelque pouvoir;
Et que mes ſentimens ſont d’une ame trop grande,	Et que mes sentiments sont d'une âme trop grande,
Pour vouloir les cacher, lorsqu’on me les demande.	Pour vouloir les cacher, lorsqu'on me les demande.
Je ne vous dirai point ſi le Comte eſt aimé,	Je ne vous dirai point si le comte est aimé,
Mais apprenez de moi qu’il eſt fort eſtimé,	Mais apprenez de moi qu'il est fort estimé,
Que ſes hautes vertus, pour qui je m’intereſſe,	Que ses hautes vertus, pour qui je m'intéresse,
Meritent mieux que vous les vœux d’une Princeſſe,	Méritent mieux que vous les vœux d'une Princesse,
Que je garde aux ardeurs, aux ſoins qu’il me fait voir	Que je garde aux ardeurs, aux soins qu'il me fait voir
Tout le reſſentiment qu’une ame puiſſe avoir.	Tout le ressentiment qu'une âme puisse avoir.
Et que ſi des deſtins la fatale puiſſance,	Et que si des destins la fatale puissance,
M’ote la liberté d’étre ſa recompenſe;	M'ôte la liberté d'être sa récompense;
Au moins eſt-il en moi de promettre à ſes vœux,	Au moins est-il en moi de promettre à ses vœux,
Qu’on ne me verra point le butin de vos feux.	Qu'on ne me verra point le butin de vos feux.
Et ſans vous amuſer d'une attente frivole,	Et sans vous amuser d'une attente frivole,
C’eſt à quoi je m’engage, & je tiendrai parole.	C'est à quoi je m'engage, et je tiendrai parole.
Voilà mon cœur ouvert, puiſque vous le voulez,	Voilà mon cœur ouvert, puisque vous le voulez,
Et mes vrais ſentimens à vos yeux étalez;	Et mes vrais sentiments à vos yeux étalés;
Etes vous ſatisfait, & mon ame attaquée,	êtes-vous satisfait, et mon âme attaquée,
S’eſt elle à vôtre avis aſſez bien expliquée?	S'est-elle à votre avis assez bien expliquée?
Voyez pour vous ôter tout lieu de ſoupçonner,	Voyez pour vous ôter tout lieu de soupçonner,
S’il reſte quelque jour encor à vous donner;	S'il reste quelque jour encore à vous donner;
Cependant ſi vos ſoins s’attachent à me plaire,	Cependant si vos soins s'attachent à me plaire,
Songez que vôtre bras, Comte, m’eſt neceſſaire,	Songez que votre bras, Comte, m'est nécessaire,
Et d’un capricieux, quels que ſoient les tranſports,	Et d'un capricieux, quels que soient les transports,
Qu’à punir nos Tyrans il doit tous ces efforts.	Qu'à punir nos Tyrans il doit tous ses efforts.
Fermez l’oreille, enfin, à toute ſa furie,	Fermez l'oreille, enfin, à toute sa furie,
Et pour vous y porter, c’eſt moi qui vous en prie.	Et pour vous y porter, c'est moi qui vous en prie.
TOut vous rit, & vôtre ame en cette occaſion	Tout vous rit, et votre âme en cette occasion
Joüit ſuperbement de ma confufion;	Jouit superbement de ma confusion;
Il vous eſt doux de voir un aveu plein de gloire,	Il vous est doux de voir un aveu plein de gloire,
Sur les feux d’un Rival marquer vôtre victoire;	Sur les feux d'un Rival marquer votre victoire;
Mais c’eſt à vôtre joye un ſurcroit ſans égal,	Mais c'est à votre joie un surcroît sans égal,
D’en avoir pour témoins les yeux de ce Rival;	D'en avoir pour témoins les yeux de ce Rival;
Et mes pretentions hautement étouffées,	Et mes prétentions hautement étouffées,
A vos vœux triomphans ſont d’illuſtres trophées;	À vos vœux triomphants sont d'illustres trophées;
Goûtez à pleins tranſport ce bonheur éclatant,	Goûtez à pleins transports ce bonheur éclatant,
Mais ſçachez qu’on n’eſt pas encor où l’on pretend.	Mais sachez qu'on n'est pas encore où l'on prétend.
La fureur qui m’anime a de trop juſtes cauſes,	La fureur qui m'anime a de trop justes causes,
Et l’on verra peut-être arriver bien des choſes;	Et l'on verra peut-être arriver bien des choses;
Un deſeſpoir va loin quand il eſt échappé,	Un désespoir va loin quand il est échappé,
Et tout eſt pardonnable à qui ſe voit trompé.	Et tout est pardonnable à qui se voit trompé.
Si l’ingrate à mes yeux pour flatter vôtre flame,	Si l'ingrate à mes yeux pour flatter votre flamme,
A jamais n'être à moi, vient d’engager ſon ame;	À jamais n'être à moi, vient d'engager son âme;
Je ſçaurai bien trouver dans mon juſte courroux	Je saurai bien trouver dans mon juste courroux
Les moyens d’empêcher qu’elle ne ſoit à vous.	Les moyens d'empêcher qu'elle ne soit à vous.
Cet obſtacle n’eſt pas ce qui me met en peine,	Cet obstacle n'est pas ce qui me met en peine,
Nous verrons quelle attente en tout cas ſera vaine,	Nous verrons quelle attente en tout cas sera vaine,
Et chacun de ſes feux pourra par ſa valeur,	Et chacun de ses feux pourra par sa valeur,
Ou defendre la gloire, ou vanger le malheur.	Ou défendre la gloire, ou venger le malheur.
Mais comme entre Rivaux, l'ame la plus poſée,	Mais comme entre Rivaux, l'âme la plus posée,
A des termes d’aigreur, trouve une pente aiſée,	À des termes d'aigreur, trouve une pente aisée,
Et que je ne veux point qu’un pareil entretien	Et que je ne veux point qu'un pareil entretien
Puiſſe trop échauffer vôtre eſprit, & le mien;	Puisse trop échauffer votre esprit, et le mien;
Prince, affranchiſſez-vous d’une gêne ſecrete,	Prince, affranchissez-vous d'une gêne secrète,
Et me donnez moyen de faire ma retraite.	Et me donnez moyen de faire ma retraite.
Non, non, ne craiguez point qu’on pouſſe vôtre eſprit,	Non, non, ne craignez point qu'on pousse votre esprit,
A violer ici l’ordre qu’on vous précrit;	À violer ici l'ordre qu'on vous prescrit;
Quelque juſte ſureur qui me preſſe & vous flatte,	Quelque juste fureur qui me presse et vous flatte,
Je ſçai, Comte, je ſçai, quand il faut qu’elle éclate.	Je sais, Comte, je sais quand il faut qu'elle éclate.
Ces lieux vous ſont ouverts, oüi, ſortez-en, ſortez,	Ces lieux vous sont ouverts, oui, sortez-en, sortez,
Glorieux des douceurs que vous en remportez;	Glorieux des douceurs que vous en remportez;
Mais encor une fois apprenez que ma tête	Mais encore une fois apprenez que ma tête
Peut ſeule dans vos mains mettre vôtre conquête.	Peut seule dans vos mains mettre votre conquête.
Quand nous en ferons-là, le fort en nôtre bras,	Quand nous en serons là, le sort en notre bras,
De tous nos interêts vuidera les debats.	De tous nos intérêts videra les débats.
REtournez, D. Alvar, & perdez l’eſperance,	Retournez, D. Alvar, et perdez l'espérance,
De me perſuader l’oubli de cette offence;	De me persuader l'oubli de cette offense;
Cette playe en mon cœur ne ſçauroit ſe guerir,	Cette plaie en mon cœur ne saurait se guérir,
Et les ſoins qu’on en prend ne font rien que l’ai¬(grir.	Et les soins qu'on en prend ne font rien que l'aigrir.
A quelques faux reſpects croit il que je defere?	À quelques faux respects croit-il que je défère?
Non, non, il a pouſſé trop avant ma colere;	Non, non, il a poussé trop avant ma colère;
Et ſon vain repentir qui porte ici vos pas,	Et son vain repentir qui porte ici vos pas,
Sollicite un pardon que vous n’obtiendrez pas.	Sollicite un pardon que vous n'obtiendrez pas.
Madame, il fait pitié, jamais cœur que je penſe,	Madame, il fait pitié, jamais cœur que je pense,
Par un plus vif remors n’expia ſon offence;	Par un plus vif remords n'expia son offense;
Et ſi dans ſa douleur vous le conſideriez,	Et si dans sa douleur vous le considériez,
Il toucheroit vôtre ame, & vous l’excuſeriez.	Il toucherait votre âme, et vous l'excuseriez.
On ſçait bien que le Prince eſt dans un âge à ſuivre	On sait bien que le Prince est dans un âge à suivre
Les premiers mouvemens où ſon ame ſe livre,	Les premiers mouvements où son âme se livre,
Et qu’en un ſang boüillant, toutes les paſſions	Et qu'en un sang bouillant toutes les passions
Ne laiſſent guere place à des reflexions.	Ne laissent guère place à des réflexions.
Dom Lope prevenu d’une fauſſe lumiere,	Dom Lope prévenu d'une fausse lumière,
De l’erreur de ſon Maître, a fourni la matiere;	De l'erreur de son Maître, a fourni la matière;
Un bruit aſſez confus, dont le zele indiſcret,	Un bruit assez confus, dont le zèle indiscret,
A de l’abord du Comte éventé le ſecret,	A de l'abord du Comte éventé le secret,
Vous avoir miſe auſſi de cette intelligence,	Vous avait mise aussi de cette intelligence,
Que dans ces lieux gardez à donné ſa preſence,	Qui dans ces lieux gardés a donné sa présence,
Le Prince a creu l’avis, & ſon amour ſeduit,	Le Prince a cru l'avis, et son amour séduit,
Sur une fauſſe allarme a fait tout ce grand bruit;	Sur une fausse alarme a fait tout ce grand bruit;
Mais d’une telle erreur ſon ame eſt revenüe,	Mais d'une telle erreur son âme est revenue,
Vôtre innocence, enfin, lui vient d’étre connüe,	Votre innocence, enfin lui vient d'être connue,
Et D. Lope, qu’il chaſſe, eſt un viſible effet,	Et D. Lope qu'il chasse est un visible effet,
Du vif remords qu’il ſent de l’éclat qu’il a fait.	Du vif remords qu'il sent de l'éclat qu'il a fait.
Ah! c’eſt trop promptement qu’il croit mon innocence,	Ah! c'est trop promptement qu'il croit mon innocence,
Il n’en a pas encor une entiere aſſurance;	Il n'en a pas encore une entière assurance;
Dites-lui, dites-lui, qu’il doit bien tout peſer,	Dites-lui, dites-lui, qu'il doit bien tout peser,
Et ne ſe hâter point, de peur de s’abuſer.	Et ne se hâter point, de peur de s'abuser.
Madame, il ſçait trop bien....	Madame, il sait trop bien…
Mais, D. Alvar, de grace,	Mais, D. Alvar, de grâce,
N’étendons pas plus loin un diſcours qui me laſſe,	N'étendons pas plus loin un discours qui me lasse,
Il reveille un chagrin qui vient à contre tems,	Il réveille un chagrin qui vient à contre-temps,
En troubler dans mon cœur d’autres plus importans.	En troubler dans mon cœur d'autres plus importants.
Oüi, d’un trop grand malheur la ſurpriſe me preſſe,	Oui, d'un trop grand malheur la surprise me presse,
Et le bruit du trépas de l’illuſtre Comteſſe,	Et le bruit du trépas de l'illustre Comtesse,
Doit s’emparer, ſi bien de tout mon deplaiſir,	Doit s'emparer, si bien de tout mon déplaisir,
Qu’aucun autre ſouci n’a droit de me ſaiſir.	Qu'aucun autre souci n'a droit de me saisir.
Madame, ce peut étre une fauſſe nouvelle,	Madame, ce peut être une fausse nouvelle,
Mais mon retour au Prince, en porte une crüelle.	Mais mon retour au Prince en porte une cruelle.
De quelque grand ennui qu’il puiſſe étre agité,	De quelque grand ennui qu'il puisse être agité,
Il en aura toujours moins qu’il n’a merité.	Il en aura toujours moins qu'il n'a mérité.
J’Attendois qu’il ſortît, Madame, pour vous dire,	J'attendais qu'il sortît, Madame, pour vous dire
Ce qu’il veut maintenant que vôtre ame reſpire,	Ce qui veut maintenant que votre âme respire,
Puis que vôtre chagrin dans un moment d’ici,	Puisque votre chagrin dans un moment d'ici,
Du ſort de Done Ignes peut ſe voir éclairci.	Du sort de Done Ignès peut se voir éclairci.
Un inconnu qui vient pour cette confidence,	Un inconnu qui vient pour cette confidence,
Vous fait par un des ſiens demander audiance.	Vous fait par un des siens demander audience.
Eliſe, il faut le voir, qu’il vienne promptement.	Élise, il faut le voir, qu'il vienne promptement.
Mais il veut n’étre veu que de vous ſeulement,	Mais il veut n'être vu que de vous seulement,
Et par cet Envoyé, Madame, il ſollicite,	Et par cet Envoyé, Madame, il sollicite,
Qu’il puiſſe ſans témoins vous rendre ſa viſite.	Qu'il puisse sans témoins vous rendre sa visite.
Hé bien nous ſerons ſeuls, & je vais l’ordonner,	Hé bien nous serons seuls, et je vais l'ordonner,
Tandis que tu prendras le ſoin de l’amener.	Tandis que tu prendras le soin de l'amener.
Que mon impatience en ce moment eſt forte!	Que mon impatience en ce moment est forte!
O deſtins, eſt-ce joye, ou douleur qu’on m’apporte?	Ô destins, est-ce joie, ou douleur qu'on m'apporte?
OU....	Où…?
Si vous me cherchez, Madame, me voici.	Si vous me cherchez, Madame, me voici.
En quel lieu vôtre maître....	En quel lieu votre maître…
Il eſt proche d’ici;	Il est proche d'ici;
Le ferai-je venir?	Le ferai-je venir?
Dites lui qu’il s’avance,	Dites-lui qu'il s'avance,
Aſſuré qu’on l’attend avec impatience,	Assuré qu'on l'attend avec impatience,
Et qu’il ne ſe verra d’aucuns yeux éclairé.	Et qu'il ne se verra d'aucuns yeux éclairé.
Je ne ſçai quel ſecret en doit être auguré,	Je ne sais quel secret en doit être auguré,
Tant de precautions qu’il affecte de prendre....	Tant de précautions qu'il affecte de prendre…
Mais le voici deja.	Mais le voici déjà.
SEigneur; pour vous attendre	Seigneur; pour vous attendre
On a fait.... Mais que voi-je, ha! Madame, mes yeux.	On a fait… Mais que vois-je, ha! Madame, mes yeux.
Ne me deſcouvrez point, Eliſe, dans ces lieux,	Ne me découvrez point, Élise, dans ces lieux,
Et laiſſez reſpirer ma triſte deſtinée,	Et laissez respirer ma triste destinée,
Sous une feinte mort, que je me ſuis donnée.	Sous une feinte mort, que je me suis donnée.
C’eſt elle qui m'arrache à tous mes fiers tirans;	C'est elle qui m'arrache à tous mes fiers tyrans;
Car je puis ſous ce nom comprendre mes parens;	Car je puis sous ce nom comprendre mes parents;
J’ai par elle évité cet himen redoutable,	J'ai par elle évité cet hymen redoutable,
Pour qui j’aurois ſouffert une mort veritable;	Pour qui j'aurais souffert une mort véritable;
Et ſous cet équipage, & le bruit de ma mort,	Et sous cet équipage, et le bruit de ma mort,
Il faut cacher à tous le ſecret de mon ſort,	Il faut cacher à tous le secret de mon sort,
Pour me voir à l’abri de l’injuſte pourſuite,	Pour me voir à l'abri de l'injuste poursuite,
Qui pourroit dans ces lieux perſecuter ma fuite.	Qui pourrait dans ces lieux persécuter ma fuite.
Ma ſurpriſe en public eut trahi vos deſirs,	Ma surprise en public eût trahi vos désirs,
Mais allez là dedans étouffer des ſoupirs;	Mais allez là dedans étouffer des soupirs;
Et des charmans tranſports d’une pleine allegreſſe,	Et des charmants transports d'une pleine allégresse,
Saiſir à vôtre aſpect le cœur de la Princeſſe?	Saisir à votre aspect le cœur de la Princesse?
Vous la trouverez ſeule, elle même a pris ſoin	Vous la trouverez seule, elle-même a pris soin
Que vôtre abord fut libre, & n’eut aucun témoin;	Que votre abord fût libre, et n'eût aucun témoin;
Voi-je pas D. Alvar?	Vois-je pas D. Alvar?
LE Prince me renvoye,	Le Prince me renvoie,
Vous prier que pour lui vôtre credit s’employe,	Vous prier que pour lui votre crédit s'emploie,
De ſes jours, belle Eliſe, on doit n’eſperer rien,	De ses jours, belle Élise, on doit n'espérer rien,
S’il n’obtient par vos ſoins un moment d’entretien.	S'il n'obtient par vos soins un moment d'entretien.
Son ame a des tranſports.... Mais le voici lui-même.	Son âme a des transports… Mais le voici lui-même.
AH! ſois un peu ſenſible à ma diſgrace extréme,	Ah! sois un peu sensible à ma disgrâce extrême,
Eliſe, & prend pitié d’un cœur infortuné,	Élise, et prends pitié d'un cœur infortuné,
Qu’aux plus vives douleurs tu vois abandonné.	Qu'aux plus vives douleurs tu vois abandonné.
C’eſt avec d’autre yeux que ne fait la Princeſſe,	C'est avec d'autres yeux que ne fait la Princesse,
Seigneur, que je verrois le tourment qui vous preſſe;	Seigneur, que je verrais le tourment qui vous presse;
Mais nous avons du Ciel, ou du temperament,	Mais nous avons du Ciel ou du tempérament,
Que nous jugeons de tout chacun diverſement.	Que nous jugeons de tout chacun diversement.
Et puis qu’elle vous blame, & que ſa fantaſie,	Et puisqu'elle vous blâme, et que sa fantaisie,
Lui fait un monſtre affreux de vôtre jalouſie;	Lui fait un monstre affreux de votre jalousie;
Je ſerois complaiſant & voudrois m’efforcer	Je serais complaisant et voudrais m'efforcer
De cacher à ſes yeux, ce qui peut les bleſſer.	De cacher à ses yeux, ce qui peut les blesser.
Un Amant ſuit ſans doute une utile methode,	Un Amant suit sans doute une utile méthode,
S’il fait qu’à nôtre humeur la ſienne s’accommode.	S'il fait qu'à notre humeur la sienne s'accommode.
Et cent devoirs font moins que ces ajuſtemens,	Et cent devoirs font moins que ces ajustements,
Qui font crcire en deux cœurs les mêmes ſentimens.	Qui font croire en deux cœurs les mêmes sentiments.
L’art de ces deux rapports fortement les aſſemble,	L'art de ces deux rapports fortement les assemble,
Et nous n’aimons rien tant, que ce qui nous reſſemble.	Et nous n'aimons rien tant que ce qui nous ressemble.
Je le ſçai, mais helas! les deſtins inhumains,	Je le sais, mais, hélas! les destins inhumains,
S’oppoſent à l'effet de ces juſtes deſleins;	S'opposent à l'effet de ces justes desseins;
Et malgré tous mes ſoins viennent toûjours me rendre	Et malgré tous mes soins viennent toujours me tendre
Un piege, dont mon cœur ne ſçauroit ſe defendre;	Un piège, dont mon cœur ne saurait se défendre;
Ce n’eſt pas que l’ingrate aux yeux de mon Rival,	Ce n'est pas que l'ingrate aux yeux de mon Rival,
N’ait fait contre mes feux un aveu trop fatal,	N'ait fait contre mes feux un aveu trop fatal,
Et témoigné pour lui des excez de tendreſſe,	Et témoigné pour lui des excès de tendresse,
Dont le cruel objet me reviendra ſans ceſſe:	Dont le cruel objet me reviendra sans cesse:
Mais comme trop d’ardeur, enfin, m’avoit ſeduit,	Mais comme trop d'ardeur, enfin m'avait séduit,
Quand j’ai creu qu’en ces lieux elle l’ait introduit,	Quand j'ai cru qu'en ces lieux elle l'ait introduit,
D’un trop cuiſant ennui je ſentirois l’atteinte,	D'un trop cuisant ennui je sentirais l'atteinte,
A lui laiſſer ſur moi quelque ſujet de plainte.	À lui laisser sur moi quelque sujet de plainte.
Oüi, je veux faire au moins, ſi je m’en vois quitté,	Oui, je veux faire au moins, si je m'en vois quitté,
Que ce ſoit de ſon cœur pure infidelité;	Que ce soit de son cœur pure infidélité;
Et venant m’excuſer d’un trait de promptitude,	Et venant m'excuser d'un trait de promptitude,
Derober tout pretexte à ſon ingratitude.	Dérober tout prétexte à son ingratitude.
Laiſſez un peu de tems à ſon reſſentiment,	Laissez un peu de temps à son ressentiment,
Et ne la voyez point, Seigneur, ſi promptement.	Et ne la voyez point, Seigneur, si promptement.
Ah! ſi tu me cheris, obtiens que je la voye,	Ah! si tu me chéris, obtiens que je la voie,
C’eſt une liberté qu’il faut qu’elle m’octroye;	C'est une liberté qu'il faut qu'elle m'octroie;
Je ne pars point d’ici qu’au moins ſon fier dedain.	Je ne pars point d'ici qu'au moins son fier dédain.
De grace differez l'effet de ce deſſein.	De grâce différez l'effet de ce dessein.
Non, ne m’oppoſe point une excuſe frivole.	Non, ne m'oppose point une excuse frivole.
Il faut que ce ſoit elle, avec une parole,	Il faut que ce soit elle, avec une parole,
Qui trouve les moyens de le faire en aller;	Qui trouve les moyens de le faire en aller;
Demeurez donc, Seigneur, je m’en vais lui parler.	Demeurez donc, Seigneur, je m'en vais lui parler.
Di lui, que j’ai d’abord banni de ma preſence,	Dis-lui que j'ai d'abord banni de ma présence,
Celui dont les avis ont cauſé mon offence.	Celui dont les avis ont causé mon offense.
Que D. Lope jamais....	Que D. Lope jamais…
QUe vois je, ô juſtes Dieux,	Que vois-je, ô justes Dieux,
Faut il que je m’aſſure au rapport de mes yeux?	Faut-il que je m'assure au rapport de mes yeux?
Ah! ſans doute ils me ſont des témoins trop fidelles.	Ah! sans doute ils me sont des témoins trop fidèles.
Voilà le comble affreux de mes peines mortelles.	Voilà le comble affreux de mes peines mortelles.
Voici le coup fatal qui devoit m’accabler,	Voici le coup fatal qui devait m'accabler,
Et quand par des ſoupçons je me ſentois troubler,	Et quand par des soupçons je me sentais troubler,
C’étoit, c’étoit le Ciel, dont la ſourde menace,	C'était, c'était le Ciel, dont la sourde menace,
Preſageoit à mon cœur cette horrible diſgrace.	Présageait à mon cœur cette horrible disgrâce.
Qu’avez-vous veu, Seigneur, qui vous puiſſe émouvoir?	Qu'avez-vous vu, Seigneur, qui vous puisse émouvoir?
J’ai veu ce que mon ame a peine à concevoir,	J'ai vu ce que mon âme a peine à concevoir,
Et le renverſement de toute la nature	Et le renversement de toute la nature
Ne m’étonneroit pas comme cette avanture.	Ne m'étonnerait pas comme cette aventure.
C’en eſt fait le deſtin.... je ne ſçaurois parler.	C'en est fait… Le destin… Je ne saurais parler.
Seigneur, que vôtre eſprit tâche à ſe rapeller.	Seigneur, que votre esprit tâche à se rappeler.
J’ai veu.... vengeance, ô Ciel.	J'ai vu… vengeance, ô Ciel.
Quelle atteinte ſoudaine....	Quelle atteinte soudaine…
I’en mourrai, D. Alvar, la choſe eſt bien certaine.	J'en mourrai, D. Alvar, la chose est bien certaine.
Mais, Seigneur, qui pourroit....	Mais, Seigneur, qui pourrait…
Ah! tout eſt rüiné;	Ah! tout est ruiné;
Ie ſuis, je ſuis trahi, je fuis aſſaſſiné;	Je suis, je suis trahi, je suis assassiné;
Un homme, ſans mourir te le puis-je bien dire,	Un homme… sans mourir te le puis-je bien dire,
Un homme dans les bras de l’infidelle Eluire?	Un homme dans les bras de l'infidèle Elvire?
Ah! Seigneur, la Princeſſe eſt vertueuſe au point.	Ah! Seigneur, la Princesse est vertueuse au point.
Ah! ſur ce que j’ai veu, ne me conteſtez point.	Ah! sur ce que j'ai vu ne me contestez point.
D. Alvar, c’en eſt trop que ſoutenir ſa gloire,	D. Alvar, c'en est trop que soutenir sa gloire,
Lorſque mes yeux font foi d’une action ſi noire.	Lorsque mes yeux font foi d'une action si noire.
Seigneur, nos paſſions nous font prendre ſouvent,	Seigneur, nos passions nous font prendre souvent,
Pour choſe veritable un objet decevant;	Pour chose véritable un objet décevant;
Et de croire qu’une ame à la vertu nourrie,	Et de croire qu'une âme à la vertu nourrie,
Se puiſſe....	Se puisse…
D. Alvar, laissez moi je vous prie,	D. Alvar, laissez-moi, je vous prie,
Un Conſeiller me choque en cette occaſion,	Un Conseiller me choque en cette occasion,
Et je ne prens avis que de ma paſſion.	Et je ne prends avis que de ma passion.
Il ne faut rien repondre à cet eſprit farouche.	Il ne faut rien répondre à cet esprit farouche.
Ah! que ſenſiblement cette atteinte me touche,	Ah! que sensiblement cette atteinte me touche,
Mais il faut voir qui c’eſt, & de ma main punir....	Mais il faut voir qui c'est, et de ma main punir…
La voici, ma fureur, te peux tu retenir?	La voici, ma fureur, te peux-tu retenir?
HE' bien que voulez-vous, & quel eſpoir, de grace,	Hé bien que voulez-vous, et quel espoir de grâce,
Aprés vos procedez peut flater vôtre audace?	Après vos procédés, peut flatter votre audace?
Oſez vous à mes yeux encor vous preſenter,	Osez-vous à mes yeux encore vous présenter,
Et que me direz-vous que je doire écouter?	Et que me direz-vous que je doive écouter?
Que toutes les horreurs, dont un ame eſt capable	Que toutes les horreurs dont une âme est capable
A vos deloyautez n’ont rien de comparable,	À vos déloyautés n'ont rien de comparable,
Que le ſort, les demons & le Ciel en courroux,	Que le sort, les démons et le Ciel en courroux,
N’ont jamais rien produit de ſi méchant que vous.	N'ont jamais rien produit de si méchant que vous.
Ah! vraiment j’attendois l'excuſe d’une outrage,	Ah! Vraiment, j'attendais l'excuse d'un outrage,
Mais à ce que je vois, c’eſt un autre langage.	Mais, à ce que je vois, c'est un autre langage.
Oüi, oüi, c’en eſt un autre, & vous n’attendiez pas	Oui, oui, c'en est un autre, et vous n'attendiez pas
Que j’euſſe decouvert le traître dans vos bras,	Que j'eusse découvert le traître dans vos bras,
Qu’un funeſte hazard par la porte entr’ouverte,	Qu'un funeste hasard par la porte entr'ouverte,
Eut offert à mes yeux vôtre honte, & ma perte.	Eût offert à mes yeux votre honte, et ma perte.
Eſt-ce l’heureux Amant ſur ſes pas revenu,	Est-ce l'heureux Amant sur ses pas revenu,
Ou quelque autre Rival qui m’étoit inconnu?	Ou quelque autre Rival qui m'était inconnu?
O Ciel! donne à mon cœur des forces ſuffiſantes	ô Ciel! donne à mon cœur des forces suffisantes
Pour pouvoir ſupporter des douleurs ſi cuiſantes.	Pour pouvoir supporter des douleurs si cuisantes.
Rougiſſez maintenant, vous en avez raiſon,	Rougissez maintenant, vous en avez raison,
Et le maſque eſt levé de vôtre trahiſon.	Et le masque est levé de votre trahison.
Voilà ce que marquoient les troubles de mon ame,	Voilà ce que marquaient les troubles de mon âme,
Ce n’étoit pas en vain que s’allarmoit ma flame;	Ce n'était pas en vain que s'alarmait ma flamme;
Par ces frequens foupçons qu’on trouvoit odieux,	Par ces fréquents soupçons qu'on trouvait odieux,
Je cherchois le malheur qu’ont rencontré mes yeux.	Je cherchais le malheur qu'ont rencontré mes yeux.
Et malgré tous vos ſoins , & vôtre adreſſe à feindre,	Et malgré tous vos soins et votre adresse à feindre,
Mon aſtre me diſoit ce que j’avois à craindre;	Mon astre me disait ce que j'avais à craindre;
Mais ne preſumez pas que ſaiis étre vangé,	Mais ne présumez pas que sans être vengé,
Je ſouffre le depit de me voir outragé.	Je souffre le dépit de me voir outragé.
Je ſçai que ſur les vœux on n’a point de puiſſance,	Je sais que sur les vœux on n'a point de puissance,
Que l’amour veur par tout naître ſans dependance,	Que l'amour veut partout naître sans dépendance,
Que jamais par la force on n’entra dans un cœur,	Que jamais par la force on n'entra dans un cœur,
Et que toute ame eft libre à nommer ſon vainqueur	Et que toute âme est libre à nommer son vainqueur
Auſſi ne trouverois-je aucun ſujet de plainte,	Aussi ne trouverais-je aucun sujet de plainte,
Si pour moi vôtre bouche avoit parlé ſans feinte,	Si pour moi votre bouche avait parlé sans feinte,
Et ſon arrét livrant mon eſpoir à la mort,	Et son arrêt livrant mon espoir à la mort,
Mon cœur n’auroit eu droit de s’en prendre qu’au ſort.	Mon cœur n'aurait eu droit de s'en prendre qu'au sort.
Mais d’un aveu trompeur voir ma flame applaudie,	Mais d'un aveu trompeur voir ma flamme applaudie,
C’eſt une trahiſon, c’eſt une perfidie,	C'est une trahison, c'est une perfidie,
Qui ne ſçauroit trouver de trop grands chatimens,	Qui ne saurait trouver de trop grands châtiments,
Et je puis tout permettre à mes reſſentimens;	Et je puis tout permettre à mes ressentiments;
Non, non, n’eſperez rien aprés un tel outrage,	Non, non, n'espérez rien après un tel outrage,
Je ne ſuis plus à moi, je ſuis tout à la rage,	Je ne suis plus à moi, je suis tout à la rage,
Trahi de tous côtez, mis dans un triſte état,	Trahi de tous côtés, mis dans un triste état,
Il faut que mon amour ſe vange avec éclat,	Il faut que mon amour se venge avec éclat,
Qu’ici j’immole tout à ma fureur extréme,	Qu'ici j'immole tout à ma fureur extrême,
Et que mon deſeſpoir acheve par moi-même.	Et que mon désespoir achève par moi-même.
Aſſez paiſiblement vous a t’on écouté,	Assez paisiblement vous a-t-on écouté,
Et pourrai-je a mon tour parler en liberté?	Et pourrai-je à mon tour parler en liberté?
Et par quels beaux diſcours que l’artifice inſpire....	Et par quels beaux discours que l'artifice inspire…
Si vous avez encor quelque choſe à me dire,	Si vous avez encore quelque chose à me dire,
Vous pouvez l’ajouter, je ſuis prête à l’oüir,	Vous pouvez l'ajouter, je suis prête à l'ouïr,
Si non, faites au moins que je puiſſe joüir	Sinon, faites au moins que je puisse jouir
De deux, ou trois momens de paiſible audience.	De deux, ou trois moments de paisible audience.
Hé bien, j’écoute, ô Ciel, quelle eſt ma patience.	Hé bien, j'écoute. ô Ciel, quelle est ma patience.
Je force ma colere, & veux ſans nulle aigreur,	Je force ma colère, et veux sans nulle aigreur,
Repondre à ce diſcours ſi rempli de fureur.	Répondre à ce discours si rempli de fureur.
C'eſt que vous voyez bien....	C'est que vous voyez bien…
Ah! j’ai prété l’oreille,	Ah! J'ai prêté l'oreille,
Autant qu’il vous a plu; rendez-moi la pareille.	Autant qu'il vous a plu; rendez-moi la pareille.
J’admire mon deſtin, & jamais ſous les Cieux,	J'admire mon destin, et jamais sous les Cieux,
Il ne fut rien, je croi, de ſi prodigieux,	Il ne fut rien, je crois, de si prodigieux,
Rien dont la nouveauté ſoit plus inconcevable.	Rien dont la nouveauté soit plus inconcevable.
Et rien que la raiſon rende moins ſupportable.	Et rien que la raison rende moins supportable.
Je me vois un Amant, qui ſans ſe rebuter,	Je me vois un Amant, qui sans se rebuter,
Applique tous ſes ſoins à me perſecuter,	Applique tous ses soins à me persécuter,
Qui dans tout cet amour que ſa bouche m’exprime,	Qui dans tout cet amour que sa bouche m'exprime,
Ne conſerver pour moi nul ſentiment d’eſtime,	Ne conserve pour moi nul sentiment d'estime,
Rien au fond de ce cœur qu’ont pu bleſſer mes yeux,	Rien au fond de ce cœur qu'ont pu blesser mes yeux,
Qui faſſe droit au ſang que j’ai reçû des Cieux,	Qui fasse droit au sang que j'ai reçu des Cieux,
Et de mes actions défende l’innocence	Et de mes actions défende l'innocence
Contre le moindre effort d’une fauſſe apparence,	Contre le moindre effort d'une fausse apparence,
Oüi, je vous.... Ah! ſur tout ne m’interrompez point.	Oui, je vois… Ah! surtout ne m'interrompez point.
Je vois, dis-je, mon ſort malheureux à ce point,	Je vois, dis-je, mon sort malheureux à ce point,
Qu’un cœur qui dit qu’il m’aime, & qui doit faire croire,	Qu'un cœur qui dit qu'il m'aime, et qui doit faire croire,
Que quand tout l’Univers douteroit de ma gloire,	Que, quand tout l'Univers douterait de ma gloire,
Il voudroit contre tous en être le garand,	Il voudrait contre tous en être le garant,
Eſt celui qui s’en fait l’ennemi le plus grand.	Est celui qui s'en fait l'ennemi le plus grand.
On ne voit échaper aux ſoins que prend ſa flame	On ne voit échapper aux soins que prend sa flamme
Aucune occaſion de ſoupçonner mon ame;	Aucune occasion de soupçonner mon âme;
Mais c’eſt peu des ſoupçons, il en fait des éclats,	Mais c'est peu des soupçons, il en fait des éclats,
Que ſans étre bleſſé l’amour ne ſouffre pas.	Que sans être blessé l'amour ne souffre pas.
Loin d’agir en Amant, qui plus que la mort méme	Loin d'agir en Amant, qui plus que la mort même
Apprehende toujours d’offencer ce qu’il aime,	Appréhende toujours d'offenser ce qu'il aime,
Qui ſe plaint doucement, & cherche avec reſpect	Qui se plaint doucement, et cherche avec respect
A pouvoir s’éclaircir de ce qu’il croit ſuſpect.	À pouvoir s'éclaircir de ce qu'il croit suspect.
A toute extremité dans ſes doutes il paſſe,	À toute extrémité dans ses doutes il passe,
Et ce n’eſt que fureur, qu’injure, & que menace;	Et ce n'est que fureur, qu'injure et que menace;
Cependant aujourd’hui je veux fermer les yeux	Cependant aujourd'hui je veux fermer les yeux
Sur tout ce qui devroit me le rendre odieux,	Sur tout ce qui devrait me le rendre odieux,
Et lui donner moyen par une bonté pure	Et lui donner moyen par une bonté pure
De tirer ſon ſalut d’une nouvelle injure.	De tirer son salut d'une nouvelle injure.
Ce grand emportement qu’il m’a falu ſouffrir,	Ce grand emportement qu'il m'a fallu souffrir,
Part de ce qu’à vos yeux le hazard vient d’offrir,	Part de ce qu'à vos yeux le hasard vient d'offrir,
J’aurois tort de vouloir dementir vôtre veüe,	J'aurais tort de vouloir démentir votre vue,
Et vôtre ame ſans doute a dû paroître émeüe,	Et votre âme sans doute a dû paraître émue,
Et n’eſt-ce pas....	Et n'est-ce pas…
Encor un peu d’attention,	Encore un peu d'attention,
Et vous allez ſçavoir ma reſolution.	Et vous allez savoir ma résolution.
Il faut que de nous deux le deſtin s’accompliſſe,	Il faut que de nous deux le destin s'accomplisse,
Vous êtes maintenant ſur un orand precipice,	Vous êtes maintenant sur un grand précipice,
Et ce que vôtre cœur pourra déliberer,	Et ce que votre cœur pourra délibérer,
Va vous y faire choir, ou bien vous en tirer.	Va vous y faire choir, ou bien vous en tirer.
Si malgré cet objet qui vous a pû ſurprendre,	Si malgré cet objet qui vous a pu surprendre,
Prince, vous me rendez ce que vous devez rendre,	Prince, vous me rendez ce que vous devez rendre,
Et ne demandez point d’autre preuve que moi	Et ne demandez point d'autre preuve que moi
Pour condamner l’erreur du trouble où je vous voi.	Pour condamner l'erreur du trouble où je vous vois.
Si de vos ſentimens la prompte déferance.	Si de vos sentiments la prompte déférence.
Veut ſur ma ſeule foi croire mon innocence,	Veut sur ma seule foi croire mon innocence,
Et de tous vos ſoupçons démentir le credit,	Et de tous vos soupçons démentir le crédit,
Pour croire aveuglement ce que mon cœur vous dit;	Pour croire aveuglément ce que mon cœur vous dit;
Cette ſoûmiſſion, cette marque d’eſtime,	Cette soumission, cette marque d'estime,
Du paſſé dans ce cœur efface tout le crime.	Du passé dans ce cœur efface tout le crime.
Je retracte à l’inſtant, ce qu’un juſte courroux	Je rétracte à l'instant, ce qu'un juste courroux
M’a fait dans la chaleur prononcer contre vous;	M'a fait dans la chaleur prononcer contre vous;
Et ſi je puis un jour choiſir ma deſtinée,	Et si je puis un jour choisir ma destinée,
Sans choquer les devoirs du rang où je ſuis née,	Sans choquer les devoirs du rang où je suis née,
Mon honneur fatisfait par ce reſpect ſoudain	Mon honneur satisfait par ce respect soudain
Promet à vôtre amour & mes veux, & ma main;	Promet à votre amour et mes vœux et ma main;
Mais prêtez bien l’oreille à ce que je vais dire,	Mais prêtez bien l'oreille à ce que je vais dire,
Si cet offre ſur vous obtient ſi peu d’empire,	Si cet offre sur vous obtient si peu d'empire,
Que vous me refuſiez de me faire entre nous	Que vous me refusiez de me faire entre nous
Un ſacrifice entier de vos ſoupçons jaloux;	Un sacrifice entier de vos soupçons jaloux;
S’il ne vous ſuffit pas de toute l’aſſurance	S'il ne vous suffit pas de toute l'assurance
Que vous peuvent donner mon cœur, & ma naiſſance.	Que vous peuvent donner mon cœur et ma naissance.
Et que de vôtre eſprit les ombrages puiſſans	Et que de votre esprit les ombrages puissants
Forcent mon innocence à convaincre vos ſens,	Forcent mon innocence à convaincre vos sens,
Et porter à vos yeux l’éclatant témoignage	Et porter à vos yeux l'éclatant témoignage
D’une vertu ſincere à qui l’on fait outrage:	D'une vertu sincère à qui l'on fait outrage:
Ie ſuis prête à le faire, & vous ſerez content,	Je suis prête à le faire, et vous serez content,
Mais il vous faut de moi détacher à l’inſtant,	Mais il vous faut de moi détacher à l'instant,
A mesvœux pour jamais renoncer de vous même,	À mes vœux pour jamais renoncer de vous-même,
Et j’atteſte du Ciel la puiſſance ſupréme,	Et j'atteste du Ciel la puissance suprême,
Que quoi que le deſtin puiſſe ordonner de nous,	Que, quoi que le destin puisse ordonner de nous,
Ie choiſirai plûtôt d’être à la mort qu’à vous;	Je choisirai plutôt d'être à la mort qu'à vous;
Voilà dans ces deux choix de quoi vous ſatisfaire,	Voilà dans ces deux choix de quoi vous satisfaire,
Aviſez maintenant celui qui peut vous plaire.	Avisez maintenant celui qui peut vous plaire.
Iuſte Ciel! jamais rien peut-il étre inventé	Juste Ciel! jamais rien peut-il être inventé
Avec plus d’artifice, & de deloyauté?	Avec plus d'artifice, et de déloyauté?
Tout ce que des Enfers la malice étudie,	Tout ce que des Enfers la malice étudie,
A t’il rien de ſi noir que cette perfidie,	A-t-il rien de si noir que cette perfidie,
Et peut-elle trouver dans toute ſa rigueur	Et peut-elle trouver dans toute sa rigueur
Un plus cruel moyen d’embaraſſer un cœur?	Un plus cruel moyen d'embarrasser un cœur?
Ah! que vous ſçavez bien, ici contre moy-même,	Ah! que vous savez bien, ici contre moi-même,
Ingrate, vous ſervir de ma foibleſſe extrême,	Ingrate, vous servir de ma faiblesse extrême,
Et ménager pour vous l’effort prodigieux	Et ménager pour vous l'effort prodigieux
De ce fatal amour né de vos traîtres yeux,	De ce fatal amour né de vos traîtres yeux,
Parce qu’on eſt ſurpriſe, & qu’on manque d'excuſe,	Parce qu'on est surprise, et qu'on manque d'excuse,
D’un offre de pardon on emprunte la ruſe,	D'un offre de pardon on emprunte la ruse,
Vôtre feinte douceur forge un amuſement,	Votre feinte douceur forge un amusement,
Pour divertir l’effet de mon reſſentiment;	Pour divertir l'effet de mon ressentiment;
Et par le nœud ſubtil du choix qu’elle embaraſſe,	Et par le nœud subtil du choix qu'elle embarrasse,
Veut ſoûtraire un perfide au coup qui le menace.	Veut soustraire un perfide au coup qui le menace.
Oüi, vos dexteritez veulent me détourner	Oui, vos dextérités veulent me détourner
D’un éclairciſſement qui vous doit condamner;	D'un éclaircissement qui vous doit condamner;
Et vôtre ame feignant une innocente entiere	Et votre âme feignant une innocence entière
Ne s’offre a m’en donner une pleine lumiere,	Ne s'offre à m'en donner une pleine lumière,
Qu’à des conditions qu’aprés d’ardans ſouhaits,	Qu'à des conditions qu'après d'ardents souhaits,
Vous penſez que mon cœur n’acceptera jamais;	Vous pensez que mon cœur n'acceptera jamais;
Mois vous ſerez trompée en me croyant ſurprendre,	Mais vous serez trompée en me croyant surprendre,
Oüi, oüi, je pretends voir ce qui doit vous defendre,	Oui, oui, je prétends voir ce qui doit vous défendre,
Et quel fameux prodige acuſant ma fureur,	Et quel fameux prodige accusant ma fureur,
Peut de ce que j’ai veu juſtiſier l’horreur.	Peut de ce que j'ai vu justifier l'horreur.
Songez que ce par choix vous allez vous precrire	Songez que par ce choix vous allez vous prescrire
De ne plus rien pretendre au cœur de Done Eluire.	De ne plus rien prétendre au cœur de Done Elvire.
Soit, je ſouſcris à tout, & mes vœux auſſi bien,	Soit, je souscris à tout, et mes vœux aussi bien,
En l’état où je ſuis, ne pretendent plus rien.	En l'état où je suis, ne prétendent plus rien.
Vous vous repentirez de l’éclat que vous faites.	Vous vous repentirez de l'éclat que vous faites.
Non, non, tous ces diſcours ſont de vaines defaites,	Non, non, tous ces discours sont de vaines défaites,
Et c’eſt moi bien plûtôt qui dois vous avertir,	Et c'est moi bien plutôt qui dois vous avertir,
Que quelqu’autre dans peu ſe pourra repentir;	Que quelque autre dans peu se pourra repentir;
Le traître, quel qu’il ſoit, n’aura pas l’avantage	Le traître, quel qu'il soit, n'aura pas l'avantage
De dérober ſa vie à l’effort de ma rage.	De dérober sa vie à l'effort de ma rage.
Ah! c’eſt trop en ſouffrir, & mon cœur irrité	Ah! c'est trop en souffrir, et mon cœur irrité
Ne doit plus conſerver une ſotte bonté;	Ne doit plus conserver une sotte bonté;
Abandonnent l’ingrat à ſon propre caprice;	Abandonnons l'ingrat à son propre caprice;
Et puis qu’il veut perir, conſentons qu’il periſſe;	Et puisqu'il veut périr, consentons qu'il périsse;
Eliſe.... A cet éclat vous voulez me forcer,	Élise… À cet éclat vous voulez me forcer,
Mais je vous apprendrai que c’eſt trop m’offenſer.	Mais je vous apprendrai que c'est trop m'offenser.
Faites un peu ſortir la perſonne cherie....	Faites un peu sortir la personne chérie…
Allez, vous m’entendez, dites que je l’en prie.	Allez, vous m'entendez, dites que je l'en prie.
Et je puis....	Et je puis…
Attendez vous ſerez ſatisfait.	Attendez, vous serez satisfait.
Voici de ſon jaloux ſans doute un nouveau trait.	Voici de son jaloux sans doute un nouveau trait.
Prenez garde qu’au moins cette noble colere,	Prenez garde qu'au moins cette noble colère,
Dans la même fierté, juſqu’au bout perſevere;	Dans la même fierté, jusqu'au bout persévère;
Et ſur tout deformais ſongez bien à quel prix	Et surtout désormais songez bien à quel prix
Vous avez voulu voir vos ſoupçons éclaircis.	Vous avez voulu voir vos soupçons éclaircis.
Voici, graces au Ciel, ce qui les a fait naître,	Voici, grâces au Ciel, ce qui les a fait naître,
Ces ſoupçons obligeans que l’on me fait paroître,	Ces soupçons obligeants que l'on me fait paraître,
Voyez bien ce viſage, & ſi de Done Ignes,	Voyez bien ce visage, et si de Done Ignès,
Vos yeux au méme inſtant n’i connoiſſent les traits.	Vos yeux au même instant n'y connaissent les traits.
O Ciel?	Ô Ciel!
Si la fureur dont vôtre ame eſt émüe,	Si la fureur dont votre âme est émue,
Vous trouble juſques là l’uſage de la veüe,	Vous trouble jusque-là l'usage de la vue,
Vous avez d’autres yeux à pouvoir conſulter,	Vous avez d'autres yeux à pouvoir consulter,
Qui ne vous laiſſeront aucun lieu de douter.	Qui ne vous laisseront aucun lieu de douter.
Sa mort eſt une adreſſe au beſoin inventée	Sa mort est une adresse au besoin inventée
Pour fuir l’authorité qui l’a perſecutée,	Pour fuir l'autorité qui l'a persécutée,
Et ſous un tel habit elle cachoit ſon ſort	Et sous un tel habit elle cachait son sort
Pour mieux joüir du fruit de cette feinte mort.	Pour mieux jouir du fruit de cette feinte mort.
Madame, pardonnez, s’il faut que je conſente	Madame, pardonnez, s'il faut que je consente
A trahir vos ſecrets, & tromper vôtre attente;	À trahir vos secrets et tromper votre attente;
Je me vois expoſée à ſa temerité,	Je me vois exposée à sa témérité,
Toutes mes actions n’ont plus de liberté,	Toutes mes actions n'ont plus de liberté,
Et mon honneur en butte aux ſoupçons qu’il peut prendre	Et mon honneur en butte aux soupçons qu'il peut prendre
Eſt reduit à toute heure aux ſoins de le defendre.	Est réduit à toute heure aux soins de se défendre.
Nos doux embraſſemens qu’à ſurpris ce jaloux,	Nos doux embrassements qu'a surpris ce jaloux,
De cent indignitez m’ont fait ſouffrir les coups.	De cent indignités m'ont fait souffrir les coups.
Oüi, voilà le ſujet d’une fureur ſi prompte,	Oui, voilà le sujet d'une fureur si prompte,
Et l’aſſuré témoin qu’on produit de ma honte,	Et l'assuré témoin qu'on produit de ma honte,
Joüiſſez à cette heure en tiran abſolu	Jouissez à cette heure en tyran absolu
De l’éclairciſſement que vous avez voulu;	De l'éclaircissement que vous avez voulu;
Mais ſçachez que j’aurai ſans ceſſe la memoire	Mais sachez que j'aurai sans cesse la mémoire
De l’outrage ſanglant qu’on a fait à ma gloire,	De l'outrage sanglant qu'on a fait à ma gloire,
Et ſi je puis jamais oublier mes ſermens,	Et si je puis jamais oublier mes serments,
Tombent ſur moi du Ciel les plus grands chatiment,	Tombent sur moi du Ciel les plus grands châtiments,
Qu’un tonnerre éclatant mette ma tête en poudre.	Qu'un tonnerre éclatant mette ma tête en poudre.
Lors qu’à ſouffrir vos feux je pourrai me reſoudre,	Lorsqu'à souffrir vos feux je pourrai me résoudre,
Allons, Madame, allons, ôtons nous de ces lieux,	Allons, Madame, allons, ôtons-nous de ces lieux,
Qu’infectent les regards d’un monſtre furieux,	Qu'infectent les regards d'un monstre furieux,
Fuyons-en promptement l’atteinte envenimée,	Fuyons-en promptement l'atteinte envenimée,
Evitons les effets de ſa rage animée,	Évitons les effets de sa rage animée,
Et ne faiſons des vœux dans nos juſtes deſſeins,	Et ne faisons des vœux, dans nos justes desseins,
Que pour nous voir bien-tôt affranchir de ſes mains.	Que pour nous voir bientôt affranchir de ses mains.
Seigneur, de vos ſoupçons l’injuſte violence,	Seigneur, de vos soupçons l'injuste violence,
A la même vertu vient de faire une offence.	À la même vertu vient de faire une offense.
Quelles triſtes clartez diſſipent mon erreur,	Quelles tristes clartés dissipent mon erreur,
Envelopent mes ſens d’une profonde horreur,	Enveloppent mes sens d'une profonde horreur,
Et ne laisſent plus voir à mon ame abatüe,	Et ne laissent plus voir à mon âme abattue,
Que l’effroiable objet d’un remords qui me tüe:	Que l'effroyable objet d'un remords qui me tue:
Ah! D. Alvar, je voi que vous avez raiſon,	Ah! D. Alvar, je vois que vous avez raison,
Mais l’Enfer dans mon cœur a ſouflé ſon poiſon;	Mais l'Enfer dans mon cœur a soufflé son poison;
Et par un trait fatal d’une rigueur extrême,	Et par un trait fatal d'une rigueur extrême,
Mon plus grand ennemi ſe rencontre en moi-même.	Mon plus grand ennemi se rencontre en moi-même.
Que me ſert-il d’aimer du plus ardent amour,	Que me sert-il d'aimer du plus ardent amour,
Qu’une ame conſumée ait jamais mis au jour;	Qu'une âme consumée ait jamais mis au jour;
Si par ſes mouvemens qui font toute ma peine,	Si par ses mouvements qui font toute ma peine,
Cet amour à tous coups ſe rend digne de haine?	Cet amour à tous coups se rend digne de haine?
Il faut, il faut vanger par mon juſte trépas	Il faut, il faut venger par mon juste trépas
L’outrage que j’ai fait à ſes divins appas?	L'outrage que j'ai fait à ses divins appas?
Auſſi bien quel conſeil aujourd’hui puis-je ſuivre?	Aussi bien quel conseil aujourd'hui puis-je suivre?
Ah! j’ai perdu l’objet, pour qui j’aimois à vivre,	Ah! j'ai perdu l'objet pour qui j'aimais à vivre,
Si j’ai pû renoncer à l’eſpoir de ſes vœux,	Si j'ai pu renoncer à l'espoir de ses vœux,
Renoncer à la vie, eſt beaucoup moins fâcheux.	Renoncer à la vie, est beaucoup moins fâcheux.
Seigneur.	Seigneur…
Non, D. Alvar, ma mort eſt neceſſaire,	Non, D. Alvar, ma mort est nécessaire,
Il n’eſt ſoins, ny raiſons qui m’en puiſſent diſtraire;	Il n'est soins, ni raisons qui m'en puissent distraire;
Mais il faut que mon ſort en ſe precipitant	Mais il faut que mon sort en se précipitant
Rende à cette Princeſſe un ſervice éclatant.	Rende à cette Princesse un service éclatant.
Et je veux me chercher dans cette illuſtre envie	Et je veux me chercher dans cette illustre envie
Les moyens glorieux de ſortir de la vie,	Les moyens glorieux de sortir de la vie,
Faire par un grand coup qui ſignale ma foi,	Faire par un grand coup, qui signale ma foi,
Qu’en expirant pour elle, elle ait regret à moi,	Qu'en expirant pour elle, elle ait regret à moi,
Et qu’elle puiſſe dire en ſe voyant vangée,	Et qu'elle puisse dire, en se voyant vengée,
C’eſt par ſon trop d’amour qu’il m’avoit outragée.	C'est par son trop d'amour qu'il m'avait outragée.
Il faut que de ma main un illuſtre attentat	Il faut que de ma main un illustre attentat
Porte une mort trop deuë au ſein de Mauregat,	Porte une mort trop due au sein de Mauregat,
Que j’aille prevenir par une belle audace,	Que j'aille prévenir par une belle audace,
Le coup, dont la Caſtille avec bruit le menace,	Le coup, dont la Castille avec bruit le menace,
Et j’auray des douceurs dans mon inſtant fatal,	Et j'aurai des douceurs dans mon instant fatal,
De ravir cette gloire à l’eſpoir d’un Rival.	De ravir cette gloire à l'espoir d'un Rival.
Un ſervice, Seigneur, de cette conſequence	Un service, Seigneur, de cette conséquence
Auroit bien le pouvoir d’effacer vôtre offence;	Aurait bien le pouvoir d'effacer votre offense;
Mais hazarder....	Mais hasarder…
Allons par un juſte devoir,	Allons, par un juste devoir,
Faire à ce noble effort ſervir mon deſeſpoir.	Faire à ce noble effort servir mon désespoir.
OUy, jamais il ne fut de ſi rude ſurpriſe,	Oui, jamais il ne fut de si rude surprise,
Il venoit de former cette haute entrepriſe,	Il venait de former cette haute entreprise,
A l’avide deſir d’immoler Mauregat,	À l'avide désir d'immoler Mauregat,
De ſon prompt déſeſpoir, il tournoit toutl’éclat.	De son prompt désespoir, il tournait tout l'éclat.
Ses ſoins precipitez vouloient à ſon courage	Ses soins précipités voulaient à son courage
De cette juſte mort aſſurer l'avantage,	De cette juste mort assurer l'avantage,
Y chercher ſon pardon, & prevenir l’ennuy,	Y chercher son pardon, et prévenir l'ennui,
Qu’un Rival partageaſt cette gloire avec lüy.	Qu'un Rival partageât cette gloire avec lui.
Il ſortoit de ces murs, quand un bruit trop fidele,	Il sortait de ces murs, quand un bruit trop fidèle,
Eſt venu luy porter la facheuſe nouvelle,	Est venu lui porter la fâcheuse nouvelle,
Que ce même Rival qu’il vouloit prevenir	Que ce même Rival qu'il voulait prévenir
A remporté l’honneur qu’il penſoit obtenir;	A remporté l'honneur qu'il pensait obtenir;
L’a prevenu luy-même, en immolant le traître,	L'a prévenu lui-même, en immolant le traître,
Et pouſſe dans ce jour, Dom Alphonſe à paroître,	Et pousse dans ce jour Dom Alphonse à paraître,
Qui d’un ſi prompt ſuccés va gouter la douceur,	Qui d'un si prompt succès va goûter la douceur,
Et vient prendre en ces lieux la Princeſſe ſa ſœur:	Et vient prendre en ces lieux la Princesse sa sœur:
Et ce qui n’a pas peine à gagner la croyance,	Et, ce qui n'a pas peine à gagner la croyance,
On entend publier que c’eſt la recompenſe,	On entend publier que c'est la récompense,
Dont il pretend payer le ſervice éclatant	Dont il prétend payer le service éclatant
Du bras qui luy fait jour au Thrône qui l’attend.	Du bras qui lui fait jour au Trône qui l'attend.
Oüi, Done Eluire a ſçeu ces nouvelles ſemées,	Oui, Done Elvire a su ces nouvelles semées,
Et du vieux Dom Loüis les trouve confirmées.	Et du vieux Dom Louis les trouve confirmées.
Qui vient de luy mander, que Leon dans ce jour,	Qui vient de lui mander, que Léon dans ce jour,
De Dom Alphonſe, & d’elle, attend l’heureux retour,	De Dom Alphonse, et d'elle attend l'heureux retour,
Et que c’eſt-là qu’on doit, par un revers proſpere,	Et que c'est là qu'on doit, par un revers prospère,
Luy voir prendre un époux de la main de ce Frere:	Lui voir prendre un époux de la main de ce Frère:
Dans ce peu qu’il en dit, il donne aſſez à voir,	Dans ce peu qu'il en dit, il donne assez à voir,
Que Dom Sylve eſt l’époux qu’elle doit recevoir.	Que Dom Sylve est l'époux qu'elle doit recevoir.
Ce coup au cœur du Prince....	Ce coup au cœur du Prince…
Eſt ſans doute bien rude,	Est sans doute bien rude,
Et je le trouve à plaindre en ſon inquietude,	Et je le trouve à plaindre en son inquiétude,
Son interêt pourtant, ſi j'en ay bien jugé,	Son intérêt pourtant, si j'en ai bien jugé,
Eſt encor cher au cœur qu’il a tant outragé;	Est encor cher au cœur qu'il a tant outragé;
Et je n’ay point connu, qu’à ce ſuccés qu’on vante,	Et je n'ai point connu, qu'à ce succès qu'on vante,
La Princeſſe ait fait voir une ame fort contente,	La Princesse ait fait voir une âme fort contente,
De ce Frere qui vient, & de la lettre auſſi,	De ce Frère qui vient, et de la lettre aussi,
Mais....	Mais…
FAites Dom Alvar venir la Princeſſe ici,	Faites, Dom Alvar, venir la Princesse ici,
Soffrez que devant vous je luy parle, Madame,	Souffrez que devant vous je lui parle, Madame,
Sur cet évenement, dont on ſurprend mon ame;	Sur cet événement, dont on surprend mon âme;
Et ne m’accuſez point d’un trop prompt changement,	Et ne m'accusez point d'un trop prompt changement,
Si je perds contre luy tout mon reſſentiment.	Si je perds contre lui tout mon ressentiment.
Sa diſgrace imprevuë a pris droit de l’éteindre,	Sa disgrâce imprévue a pris droit de l'éteindre,
Sans luy laiſſer ma haine, il eſt aſſez à plaindre.	Sans lui laisser ma haine, il est assez à plaindre.
Et le Ciel qui s'expoſe à ce trait de rigueur,	Et le Ciel, qui l'expose à ce trait de rigueur,
N’a que trop bien ſervi les ſermens de mon cœur.	N'a que trop bien servi les serments de mon cœur.
Un éclatant arrêt de ma gloire outragée,	Un éclatant arrêt de ma gloire outragée,
A jamais n’être à luy me tenoit engagée;	À jamais n'être à lui me tenait engagée;
Mais quand par les deſtins il eſt executé,	Mais quand par les destins il est exécuté,
J’y vois pour ſon amour trop de ſeverité;	J'y vois pour son amour trop de sévérité;
Et le triſte ſuccés de tout ce qu’il m’adreſſe	Et le triste succès de tout ce qu'il m'adresse
M’efface ſon offence, & lui rend ma tendreſſe.	M'efface son offense, et lui rend ma tendresse.
Oüi, mon cœur trop vangé par de ſi rudes coups,	Oui, mon cœur trop vengé par de si rudes coups,
Laiſſe à leur cruauté deſarmer ſon courroux,	Laisse à leur cruauté désarmer son courroux,
Et cherche maintenant par un ſoin pitoyable	Et cherche maintenant par un soin pitoyable
A conſoler le ſort d’un Amant miſerable?	À consoler le sort d'un Amant misérable?
Et je croi que ſa flâme à bien pû meriter	Et je crois que sa flamme a bien pu mériter
Cette compaſſion que je lui veux prêter.	Cette compassion que je lui veux prêter.
Madame, on auroit tort de trouver à redire	Madame, on aurait tort de trouver à redire
Aux tendres ſentimens qu’on voit qu’il vous inſpire,	Aux tendres sentiments qu'on voit qu'il vous inspire,
Ce qu’il a fait pour vous... Il vient, & ſa pâleur,	Ce qu'il a fait pour vous… Il vient, et sa pâleur,
De ce coup ſurprenant marque aſſez la douleur.	De ce coup surprenant marque assez la douleur.
MAdame, avec quel front faut il que je m’avance,	Madame, avec quel front faut-il que je m'avance,
Quand je viens vous offrir l’odieuſe preſence....	Quand je viens vous offrir l'odieuse présence…
Prince, ne parlons plus de mon reſſentiment,	Prince, ne parlons plus de mon ressentiment,
Voſtre ſort dans mon ame a fait du changement,	Votre sort dans mon âme a fait du changement,
Et par le triſte êtat ou ſa rigueur vous jette,	Et par le triste état où sa rigueur vous jette,
Ma colere eſt éteinte, & nôtre paix eſt faire.	Ma colère est éteinte, et notre paix est faite.
Oüi, bien que vôtre amour ait merité les coups,	Oui, bien que votre amour ait mérité les coups,
Que fait ſur lui du Ciel éclater le courroux;	Que fait sur lui du Ciel éclater le courroux;
Bien que ſes noirs ſoupçons ayent offencé ma gloire;	Bien que ses noirs soupçons aient offensé ma gloire;
Par des indignitez qu’on auroit peine à croire;	Par des indignités qu'on aurait peine à croire;
J’avoüerai toutefois que je plains ſon malheur,	J'avouerai toutefois que je plains son malheur,
Juſqu’à voir nos ſuccés avec quelque douleur;	Jusqu'à voir nos succès avec quelque douleur;
Que je haï les faveurs de ce fameux ſervice,	Que je hais les faveurs de ce fameux service,
Lors qu’on vent de mon cœur lui faire un ſacrifice,	Lorsqu'on veut de mon cœur lui faire un sacrifice,
Et voudrois bien pouvoir racheter les momens,	Et voudrais bien pouvoir racheter les moments,
Où le ſort contre vous n’armoit que mes ſermens,	Où le sort contre vous n'armait que mes serments,
Mais, enfin, vous ſçavez comme nos deſtinées,	Mais, enfin, vous savez comme nos destinées,
Aux interêts publics ſont toûjours enchainées,	Aux intérêts publics sont toujours enchaînées,
Et que l’ordre des Cieux pour diſpoſer de moi,	Et que l'ordre des Cieux pour disposer de moi,
Daus mon Frere qui vient, me va montrer mon Roi.	Dans mon Frère qui vient me va montrer mon Roi.
Cedez comme moi, Prince, à cette violence,	Cédez comme moi, Prince, à cette violence,
Où la grandeur ſoûmet celles de ma naiſſance;	Où la grandeur soumet celles de ma naissance;
Et ſi de vôtre amour les deplaiſirs ſont grands,	Et si de votre amour les déplaisirs sont grands,
Qu’il ſe faſſe un ſecours de la part que j'y prends;	Qu'il se fasse un secours de la part que j'y prends;
Et ne ſe ſerve point contre un coup qui l’étonne	Et ne se serve point contre un coup qui l'étonne
Du pouvoir qu’en ces lieux vôtre valeur vous donne;	Du pouvoir qu'en ces lieux votre valeur vous donne;
Ce vous ſeroit ſans doute un indigne tranſport	Ce vous serait sans doute un indigne transport
De vouloir dans vos maux luter contre le ſort,	De vouloir dans vos maux lutter contre le sort,
Et lors que c’eſt en vain qu’on s'oppoſe à ſa rage,	Et lorsque c'est en vain qu'on s'oppose à sa rage,
La ſoûmiſſion prompte eſt grandeur de courage.	La soumission prompte est grandeur de courage.
Ne reſiſtez donc point à ſes coups éclatans,	Ne résistez donc point à ses coups éclatants,
Ouvrez les murs d'Aſtorgue au Frere que j’attends;	Ouvrez les murs d'Astorgue au Frère que j'attends;
Laiſſez-moi rendre aux droits qu’il peut ſur moi preten(dre,	Laissez-moi rendre aux droits qu'il peut sur moi prétendre,
Ce que mon triſte cœur à reſolu de rendre;	Ce que mon triste cœur a résolu de rendre;
Et ce fatal hommage, où mes vœux ſont forcez	Et ce fatal hommage, où mes vœux sont forcés
Peut-être n’ira pas ſi loin que vous penſez.	Peut-être n'ira pas si loin que vous pensez.
C’eſt faire voir, Madame, une bonté trop rare,	C'est faire voir, Madame, une bonté trop rare,
ue vouloir adoucir le coup qu’on me prepare,	Que vouloir adoucir le coup qu'on me prépare,
Sur moi ſans de tels ſoins vous pouvez laiſſer cheoir	Sur moi sans de tels soins vous pouvez laisser choir
Le foudre rigoureux de tout vôtre devoir.	Le foudre rigoureux de tout votre devoir.
En l’état où je ſuis, je n’ai rien à vous dire,	En l'état où je suis, je n'ai rien à vous dire,
J’ai merité du ſort tout ce qu’il a de pire,	J'ai mérité du sort tout ce qu'il a de pire,
Et je ſçai, quelques maux qu’il me faille endurer,	Et je sais, quelques maux qu'il me faille endurer,
Que je me ſuis ôté le droit d’en murmurer.	Que je me suis ôté le droit d'en murmurer.
Par-où pourrois-je, helas! dans ma vaſte diſgrace,	Par où pourrais-je, hélas! dans ma vaste disgrâce,
Vers vous de quelque plainte authoriſer l’audace,	Vers vous de quelque plainte autoriser l'audace,
Mon amour s’eſt rendu mille fois odieux,	Mon amour s'est rendu mille fois odieux,
Il n’a fait qu’outrager vos attraits glorieux:	Il n'a fait qu'outrager vos attraits glorieux:
Et lors que par un juſte, & fameux ſacrifice,	Et lorsque par un juste, et fameux sacrifice,
Mon bras à vôtre ſang cherche à rendre un ſervice,	Mon bras à votre sang cherche à rendre un service,
Mon aſtre m’abandonne au déplaiſir fatal,	Mon astre m'abandonne au déplaisir fatal,
De me voir prevenu par le bras d’un Rival.	De me voir prévenu par le bras d'un Rival.
Madame, aprés cela je n’ai rien à pretendre,	Madame, après cela je n'ai rien à prétendre,
Je ſuis digne du coup que l’on me fait attendre,	Je suis digne du coup que l'on me fait attendre,
Et je le vois venir, ſans oſer contre lui,	Et je le vois venir, sans oser contre lui,
Tenter de vôtre cœur le favorable appui.	Tenter de votre cœur le favorable appui.
Ce qui peut me reſter dans mon malheur extréme,	Ce qui peut me rester dans mon malheur extrême,
C’eſt de chercher alors mon remede en moi-même,	C'est de chercher alors mon remède en moi-même,
Et faire que ma mort propice à mes deſirs,	Et faire que ma mort propice à mes désirs,
Affranchiſſe mon cœur de tous ſes déplaiſirs.	Affranchisse mon cœur de tous ses déplaisirs.
Oüi, bien tôt dans ces lieux, Dom Alphonſe doit étre,	Oui, bientôt dans ces lieux Dom Alphonse doit être,
Et déja mon Rival commence de paroître.	Et déjà mon Rival commence de paraître.
De Leon vers ces murs, il ſemble avoir volé,	De Léon vers ces murs il semble avoir volé,
Pour recevoir le prix du Tyran immolé;	Pour recevoir le prix du Tyran immolé;
Ne craignez point du tout qu’aucune reſiſtance	Ne craignez point du tout qu'aucune résistance
Faſſe valoir icy ce que j’ay de puiſſance,	Fasse valoir ici ce que j'ai de puissance,
Il n’eſt effort humain que pour vous conſerver,	Il n'est effort humain que pour vous conserver,
Si vous y conſentiez, je ne pûſſe braver:	Si vous y consentiez, je ne pusse braver:
Mais ce n'eſt pas à moy, dont on haït la memoire,	Mais ce n'est pas à moi, dont on hait la mémoire,
A pouvoir eſperer cet aveu plein de gloire,	À pouvoir espérer cet aveu plein de gloire,
Et je ne voudrois pas par des efforts trop vains	Et je ne voudrais pas, par des efforts trop vains
Jetter le moindre obſtacle à vos juſtes deſſeins.	Jeter le moindre obstacle à vos justes desseins.
Non, je ne contrains point vos ſentimens, Madame,	Non, je ne contrains point vos sentiments, Madame,
Je vais en liberté laiſſer toute vôtre ame,	Je vais en liberté laisser toute votre âme,
Ouvrir les murs d'Aſtorgue à cet heureux vainqueur,	Ouvrir les murs d'Astorgue à cet heureux vainqueur,
Et ſubir de mon ſort la derniere rigueur.	Et subir de mon sort la dernière rigueur.
MAdame, au deſeſpoir où ſon deſtin l'expoſe,	Madame, au désespoir où son destin l'expose,
De tous mes déplaiſirs n’imputez pas la cauſe,	De tous mes déplaisirs n'imputez pas la cause,
Vous me rendrez juſtice, en croyant que mon cœur	Vous me rendrez justice en croyant que mon cœur
Fait de vos interêts ſa plus vive douleur,	Fait de vos intérêts sa plus vive douleur,
Que bien plus que l’amour l’amitié m’eſt ſenſible,	Que bien plus que l'amour l'amitié m'est sensible,
Et que ſi je me plains d’une diſgrace horrible,	Et que si je me plains d'une disgrâce horrible,
C’eſt de voir que du Ciel le funeſte couroux	C'est de voir que du Ciel le funeste courroux
Ait pris chez moy les traits qu’il lance contre vous,	Ait pris chez moi les traits qu'il lance contre vous,
Et rendu mes regards coupables d’une flâme,	Et rendu mes regards coupables d'une flamme,
Qui traite indignement les bontez de vôtre ame.	Qui traite indignement les bontés de votre âme.
C’eſt un évenement, dont ſans doute vos yeux	C'est un événement, dont sans doute vos yeux
N’ont point pour moy, Madame, à quereller les Cieux;	N'ont point pour moi, Madame, à quereller les Cieux;
Si les foibles attraits qu’étale mon viſage,	Si les faibles attraits qu'étale mon visage
M'exposoient au deſtin de ſouffrir un volage,	M'exposaient au destin de souffrir un volage,
Le Ciel ne pouvoir mieux m’adoucir de tels coups,	Le Ciel ne pouvait mieux m'adoucir de tels coups,
Quand pour m’ôter ce cour, il s’eſt ſervi de vous,	Quand pour m'ôter ce cœur il s'est servi de vous,
Et mon front ne doit point rougir d’une inconſtance	Et mon front ne doit point rougir d'une inconstance
Qui de vos traits aux miens marque la difference.	Qui de vos traits aux miens marque la différence.
Si pour ce changement je pouſſe des ſoupirs,	Si pour ce changement je pousse des soupirs,
Ils viennent de le voir fatal à vos deſirs;	Ils viennent de le voir fatal à vos désirs;
Et dans cette douleur que l’amitié m’excite,	Et dans cette douleur que l'amitié m'excite,
Je m'accuſe pour vous de mon peu de merite,	Je m'accuse pour vous de mon peu de mérite,
Qui n’a pu retenir un cour, dont les tributs	Qui n'a pu retenir un cœur dont les tributs
Cauſent un ſi grand trouble à vos vœux combatus.	Causent un si grand trouble à vos vœux combattus.
Accuſez-vous plûtôt de l’injuſte ſilence,	Accusez-vous plutôt de l'injuste silence,
Qui m'a de vos deux cœurs caché l’intelligence,	Qui m'a de vos deux cœurs caché l'intelligence,
Ce ſecret plûtôt ſçeu, peut-étre à toutes deux	Ce secret plus tôt su, peut-être à toutes deux
Nous auroit épargné des troubles ſi facheux;	Nous aurait épargné des troubles si fâcheux;
Et met juſtes froideurs des deſirs d’un volage,	Et mes justes froideurs des désirs d'un volage,
Au point de leur naiſſance, ayant banni l’hommage,	Au point de leur naissance, ayant banni l'hommage,
Euſſent pû renvoyer....	Eussent pu renvoyer…
Madame, le voici.	Madame, le voici.
Sans rencontrer ſes yeux vous pouvez étre ici,	Sans rencontrer ses yeux vous pouvez être ici,
Ne ſortez point, Madame; & dans un tel martire,	Ne sortez point, Madame; et dans un tel martyre,
Veuillez être témoin de ce que je vais dire.	Veuillez être témoin de ce que je vais dire.
Madame, j’y conſens, quoi que je ſçache bien,	Madame, j'y consens, quoique je sache bien,
Qu’on fuiroit en ma place un pareil entretien.	Qu'on fuirait en ma place un pareil entretien.
Son ſuccez, ſi le Ciel ſeconde ma penſée,	Son succès, si le Ciel seconde ma pensée,
Madame, n’aura rien, dont vous ſoyez bleſſée.	Madame, n'aura rien dont vous soyez blessée.
AVant que vous parliez je demande inſtamment,	Avant que vous parliez, je demande instamment,
Que vous daignez, Seigneur, m’écouter un moment	Que vous daigniez, Seigneur, m'écouter un moment
Deja la renommee a juſqu'à nos oreilles	Déjà la renommée a jusqu'à nos oreilles
Porté de vôtre bras les ſoudaines merveilles;	Porté de votre bras les soudaines merveilles;
Et j'admire avec tous, comme en ſi peu de tems,	Et j'admire avec tous comme en si peu de temps,
Il donne à nos deſtins ces ſuccés éclatans.	Il donne à nos destins ces succès éclatants.
Je ſçai bien qu’un bien-fait de cette conſequence	Je sais bien qu'un bienfait de cette conséquence
Ne ſçauroit demander trop de reconnoiſſance,	Ne saurait demander trop de reconnaissance,
Et qu’on doit toute choſe à l’exploit immortel	Et qu'on doit toute chose à l'exploit immortel
Qui replace mon Frere au Thrône paternel.	Qui replace mon Frère au trône paternel.
Mais quoi que de ſon cœur vous offre les hommages,	Mais quoi que de son cœur vous offrent les hommages,
Uſez en genereux de tous vos avantages,	Usez en généreux de tous vos avantages,
Et ne permettez pas que ce coup glorieux	Et ne permettez pas que ce coup glorieux
ette ſur moi, Seigneur, un joug imperieux.	Jette sur moi, seigneur, un joug impérieux.
Que vôtre amour qui ſçait quel interét m’anime,	Que votre amour qui sait quel intérêt m'anime,
S’obſtine à triompher d’un refus legitime,	S'obstine à triompher d'un refus légitime,
Et veuille que ce Frere, où l’on va m'expoſer	Et veuille que ce Frère, où l'on va m'exposer
Commence d’étre Roi pour me tiranniſer.	Commence d'être Roi pour me tyranniser.
Leon a d’autres prix, dont en cette occurance,	Léon a d'autres prix, dont en cette occurrence,
Il peut mieux honorer vôtre haute vaillance;	Il peut mieux honorer votre haute vaillance;
Et c’eſt à vos vertus faire un preſent trop bas,	Et c'est à vos vertus faire un présent trop bas,
Que vous donner un cœur qui ne ſe donne pas,	Que vous donner un cœur qui ne se donne pas,
Peût-on étre jamais ſatisfait en ſoi-même,	Peut-on être jamais satisfait en soi-même,
Lors que par la contrainte on obtient ce qu’on aime;	Lorsque par la contrainte on obtient ce qu'on aime;
C’eſt un triſte avantage, & l’Amant genereux	C'est un triste avantage, et l'Amant généreux
A ces conditions refuſe d’étre heureux;	À ces conditions refuse d'être heureux;
Il ne veut rien devoir à cette violence	Il ne veut rien devoir à cette violence
Qu’exercent ſur nos cœurs les droits de la naiſſance,	Qu'exercent sur nos cœurs les droits de la naissance,
Et pour l’objet qu’il aime eſt toûjours trop zelé,	Et pour l'objet qu'il aime est toujours trop zélé,
Pour ſouffrir qu’en victime il lui ſoit immolé,	Pour souffrir qu'en victime il lui soit immolé,
Ce n’eſt pas que ce cœur au merite d’un autre.	Ce n'est pas que ce cœur au mérite d'un autre.
Pretendre reſerver ce qu’il refuſe au vôtre:	Prétende réserver ce qu'il refuse au vôtre:
Non, Seigneur, j’en repons, & vous donne ma foi	Non, Seigneur, j'en réponds, et vous donne ma foi
Que perſonne jamais n’aura pouvoir ſur moi;	Que personne jamais n'aura pouvoir sur moi;
Qu’une ſainte retraite à toute autre pourſuite....	Qu'une sainte retraite à toute autre poursuite…
J’ai de vôtre diſcours aſſez ſouffert la ſuite,	J'ai de votre discours assez souffert la suite,
Madame; & par deux mots je vous l'euſſe épargné,	Madame; et par deux mots je vous l'eusse épargné,
Si vôtre fauſſe allarme eut ſur vous moins gagné.	Si votre fausse alarme eût sur vous moins gagné.
Je ſçai qu’un bruit commun, qui par tout ſe fait croire,	Je sais qu'un bruit commun, qui partout se fait croire,
De la mort d’un Tiran me veut donner la gloire;	De la mort du Tyran me veut donner la gloire;
Mais le ſeul Peuple, enfin, comme on nous fait ſçavoir,	Mais le seul peuple enfin, comme on nous fait savoir,
Laiſſant par D. Loüis êchaufer ſon devoir,	Laissant par D. Louis échauffer son devoir,
A remporté l’honneur de cet Acte Heroïque,	A remporté l'honneur de cet Acte Héroïque,
Dont mon nom eſt chargé par la rumeur publique,	Dont mon nom est chargé par la rumeur publique,
Et ce qui d’un tel bruit a fourni le ſujet,	Et ce qui d'un tel bruit a fourni le sujet,
C’eſt que pour appuyer ſon illuſtre projet.	C'est que, pour appuyer son illustre projet.
D. Loüis fit ſemer par une feinte utile,	D. Louis fit semer par une feinte utile,
Que ſecoudé des miens j’avois ſaiſi la Ville,	Que secondé des miens j'avais saisi la Ville,
Et par cette nouvelle il a pouſſé les bras,	Et par cette nouvelle il a poussé les bras,
Qui d’un Uſurpateur ont hâté le trépas.	Qui d'un Usurpateur ont hâté le trépas.
Par ſon zele prudent il a ſçeu tout conduire,	Par son zèle prudent il a su tout conduire,
Et c’eſt un par des ſiens qu’il vient de m’en inſtruire;	Et c'est par un des siens qu'il vient de m'en instruire;
Mais dans le même inſtant un ſecret m'eſt appris	Mais dans le même instant un secret m'est appris
Qui va vous étonner autant qu’il m’a ſurpris.	Qui va vous étonner autant qu'il m'a surpris.
Vous attendez un Frere, & Leon ſon vrai maître,	Vous attendez un Frère, et Léon son vrai maître,
A vos yeux maintenant le Ciel le fait paroître.	À vos yeux maintenant le Ciel le fait paraître.
Oüi, je ſuis Dom Alphonſe, & mon ſort conſervé,	Oui, je suis Dom Alphonse, et mon sort conservé,
Et ſous le nom du ſang de Caſtille élevé,	Et sous le nom du sang de Castille élevé,
Eſt un fameux effet de l’amitié ſincere,	Est un fameux effet de l'amitié sincère,
Qui fut entre ſon Prince, & le Roi nôtre Pere.	Qui fut entre son Prince, et le Roi notre Père.
Dom Loüis du ſecret à toutes les clartez,	Dom Louis du secret a toutes les clartés,
Et doit aux yeux de tous prouver ces veritez,	Et doit aux yeux de tous prouver ces vérités,
D’autres ſoins maintenant occupent ma penſée,	D'autres soins maintenant occupent ma pensée,
Non, qu’à vôtre ſujet elle ſoit traverſée.	Non qu'à votre sujet elle soit traversée.
Que ma flâme querelle un tel évenement,	Que ma flamme querelle un tel événement,
Et qu’en mon cœur le Frere importune l’Amant.	Et qu'en mon cœur le Frère importune l'Amant.
Mes feux par ce ſecret on receu ſans murmure,	Mes feux par ce secret ont reçu sans murmure,
Le changement qu’en eux a précrit la nature;	Le changement qu'en eux a prescrit la nature;
Et le ſang qui nous joint m'a ſi bien détaché	Et le sang qui nous joint m'a si bien détaché
De l’amour, dont pour vous mon cœur étoit touché,	De l'amour dont pour vous mon cœur était touché,
Qu’il ne reſpire plus pour faveur ſouveraine	Qu'il ne respire plus, pour faveur souveraine
Que les cheres douceurs de ſa premiere chaîne.	Que les chères douceurs de sa première chaîne.
Et le moyen de rendre à l’adorable Ignes,	Et le moyen de rendre à l'adorable Ignès,
Ce que de ſes bontez a merité l'excès;	Ce que de ses bontés a mérité l'excès;
Mais ſon ſort incertain rend le mien miſerable,	Mais son sort incertain rend le mien misérable,
Et ſi ce qu’on en dit ſe trouvoit veritable,	Et si ce qu'on en dit se trouvait véritable,
En vain Leon m’appelle, & le Trône m’attend,	En vain Léon m'appelle, et le Trône m'attend,
La Couronne n’a rien à me rendre content;	La Couronne n'a rien à me rendre content;
Et je n’en veux l’éclat que pour goûter la joye,	Et je n'en veux l'éclat que pour goûter la joie,
D’en couronner l’objet où le Ciel me renvoye,	D'en couronner l'objet où le Ciel me renvoie,
Et pouvoir reparer par ces juſtes tributs	Et pouvoir réparer par ces justes tributs
L’outrage que j’ai fait à ſes rares vertus.	L'outrage que j'ai fait à ses rares vertus.
Madame, c’eſt de vous que j’ai raiſon d’attendre,	Madame, c'est de vous que j'ai raison d'attendre,
Ce que de ſon deſtin mon ame peut apprendre,	Ce que de son destin mon âme peut apprendre,
Inſtruiſez-m’en de grace, & par vôtre diſcours,	Instruisez-m'en de grâce, et par votre discours,
Hâtez mon deſeſpoir, ou le bien de mes jours.	Hâtez mon désespoir, ou le bien de mes jours.
Ne vous étonnez pas ſi je tarde à repondre,	Ne vous étonnez pas si je tarde à répondre,
Seigneur, ces nouveautez ont droit de me confondre	Seigneur, ces nouveautés ont droit de me confondre
Je n’entreprendrai point de dire à vôtre amour,	Je n'entreprendrai point de dire à votre amour,
Si Done Ignes eſt morte, ou reſpire le jour;	Si Done Ignès est morte ou respire le jour;
Mais par ce Cavalier, l’un de ſes plus fidelles,	Mais par ce Cavalier, l'un de ses plus fidèles,
Vous en pourrez ſans doute apprendre des nouvelles?	Vous en pourrez sans doute apprendre des nouvelles?
Ah! Madame, il m’eſt doux en ces perplexités	Ah! Madame, il m'est doux en ces perplexités
De voir ici briller vos celeſtes beautez,	De voir ici briller vos célestes beautés,
Mais vous avec quels yeux verrez vous un volage,	Mais vous avec quels yeux verrez-vous un volage,
Dont le crime....	Dont le crime…
Ah! gardez de me faire un outrage;	Ah! gardez de me faire un outrage;
Et de vous hazarder à dire que vers moi,	Et de vous hasarder à dire que vers moi,
Un cœur, dont je fais cas ait pû manquer de fois;	Un cœur, dont je fais cas ait pu manquer de foi;
J’en refuſe l’idée, & l'excuſe me bleſſe,	J'en refuse l'idée, et l'excuse me blesse,
Rien n’a pu m’offencer auprés de la Princeſſe,	Rien n'a pu m'offenser auprès de la Princesse,
Et tout ce que d’ardeur elle vous a cauſé,	Et tout ce que d'ardeur elle vous a causé,
Par un ſi haut merite eſt aſſez excuſé.	Par un si haut mérite est assez excusé.
Cette flame vers moi ne vous rend point coupable,	Cette flamme vers moi ne vous rend point coupable,
Et dans le noble orgueil, dont je me ſens capable,	Et dans le noble orgueil, dont je me sens capable,
Sçachez ſi vous l’êtiez, que ce ſeroit en vain,	Sachez si vous l'étiez, que ce serait en vain,
Que vous preſumeriez de fléchir mon dedain,	Que vous présumeriez de fléchir mon dédain,
Et qu’il n’eſt repentit, ni ſupréme puiſſance	Et qu'il n'est repentir, ni suprême puissance
Qui gagnat ſur mon cœur d’oublier cette offence.	Qui gagnât sur mon cœur d'oublier cette offense.
Mon Frere, d’un tel nom ſouffrez-moi la douceur,	Mon Frère, d'un tel nom souffrez-moi la douceur,
De quel raviſſement comblez vous une ſœur;	De quel ravissement comblez-vous une sœur;
Que j’aime vôtre choix, & benis l’avanture,	Que j'aime votre choix, et bénis l'aventure,
Qui vous fait couronner une amitié ſi pure,	Qui vous fait couronner une amitié si pure,
Et de deux nobles cœurs que j’aime tendrement....	Et de deux nobles cœurs que j'aime tendrement…
DE grace cachez-moi vôtre contentement,	De grâce cachez-moi votre contentement,
Madame, & me laiſſez mourir dans la croyance,	Madame, et me laissez mourir dans la croyance,
Que le devoir vous fait un peu de violence.	Que le devoir vous fait un peu de violence.
Je ſçai que de vos vœux vous pouvez diſpoſer,	Je sais que de vos vœux vous pouvez disposer,
Et mon deſſein n’eſt pas de leur rien oppoſer,	Et mon dessein n'est pas de leur rien opposer,
Vous le voyez aſſez, & quelle obeiſſance	Vous le voyez assez, et quelle obéissance
De vos commandemens m’arrache ſa puiſſance;	De vos commandements m'arrache sa puissance;
Mais je vous avoüerai que cette gayeté	Mais je vous avouerai que cette gaieté
Surprend au dépourveu route ma fermeté;	Surprend au dépourvu toute ma fermeté;
Et qu’un pareil objet dans mon ame fait naître	Et qu'un pareil objet dans mon âme fait naître
Un tranſport, dont j’ai peur que je ne ſois pas maître,	Un transport, dont j'ai peur que je ne sois pas maître,
Et je me punirois, s’il m’avoit pu titer	Et je me punirais, s'il m'avait pu tirer
De ce reſpect ſoûmis où je veux demeurer.	De ce respect soumis où je veux demeurer.
Oüi, vos commandemens ont précrit à mon ame,	Oui, vos commandements ont prescrit à mon âme,
De ſouffrir ſans éclat le malheur de ma flame.	De souffrir sans éclat le malheur de ma flamme.
Cet ordre ſur mon cœur doit étre tout puiſſant,	Cet ordre sur mon cœur doit être tout-puissant,
Et je pretends mourir en vous obeïſſant;	Et je prétends mourir en vous obéissant;
Mais encor une fois, la joye où je vous treuve,	Mais encore une fois la joie où je vous trouve,
M'expoſe à la rigueur d’une trop rude épreuve,	M'expose à la rigueur d'une trop rude épreuve,
Et l'ame la plus ſage en ces occaſions	Et l'âme la plus sage en ces occasions,
Repond malaiſement de ſes émotions.	Répond malaisément de ces émotions.
Madame, épargnez-moi cette crüelle atteinte,	Madame, épargnez-moi cette cruelle atteinte,
Donnez-moi par pitié deux momens de contrainte.	Donnez-moi par pitié deux moments de contrainte.
Et quoi que d’un Rival vous inſpirent les ſoins,	Et quoi que d'un Rival vous inspirent les soins,
N’en rendez pas mes yeux les malheureux témoins;	N'en rendez pas mes yeux les malheureux témoins;
C’eſt la moindre faveur qu’on peut je croi pretendre,	C'est la moindre faveur qu'on peut je crois prétendre,
Lors que dans ma diſgrace un Amant peut deſcendre;	Lorsque dans ma disgrâce un Amant peut descendre;
Je ne l’exige pas, Madame, pour long-tems,	Je ne l'exige pas, Madame, pour longtemps,
Et bien-tôt mon depart rendra vos vœux contens.	Et bientôt mon départ rendra vos vœux contents.
Je vais; ou de ſes feux mon ame conſumée,	Je vais où de ses feux mon âme consumée,
N’aprendra vôtre himen que par la renommée,	N'apprendra votre hymen que par la renommée,
Ce n’eſt pas un ſpectacle où je doive courir,	Ce n'est pas un spectacle où je doive courir,
Madame, ſans le voir j’en ſçaurai bien mourir.	Madame, sans le voir j'en saurai bien mourir.
Seigneur, permettez-moi de blamer vôtre plainte,	Seigneur, permettez-moi de blâmer votre plainte,
De vos maux la Princeſſe a ſçeu paroître atteinte,	De vos maux la Princesse a su paraître atteinte,
Et cette joye encor, dequoi vous murmurez	Et cette joie encore, de quoi vous murmurez
Ne lui vient que des biens qui vous ſont preparez.	Ne lui vient que des biens qui vous sont préparés.
Elle goûte un ſuccez à vos deſirs proſpere,	Elle goûte un succès à vos désirs prospère,
Et dans vôtre Rival elle trouve ſon Frere;	Et dans votre Rival elle trouve son Frère;
C’eſt Dom Alphonſe, enfin, dont on a tant parlé;	C'est Dom Alphonse enfin, dont on a tant parlé;
Et ce fameux ſecret vient d’étre devoilé.	Et ce fameux secret vient d'être dévoilé.
Mon cœur, graces au Ciel; aprés un long martire	Mon cœur, grâces au Ciel; après un long martyre
Seigneur, ſans vous rien prendre à tout ce qu’il deſire,	Seigneur, sans vous rien prendre, a tout ce qu'il désire,
Et goûte d’autant mieux ſon bonheur en ce jour,	Et goûte d'autant mieux son bonheur en ce jour,
Qu’il ſe voit en êtat de ſervir vôtre amour.	Qu'il se voit en état de servir votre amour.
Helas! cette bonté, Seigneur, doit me confondre,	Hélas! cette bonté, Seigneur, doit me confondre,
A mes plus chers deſirs elle daigne repondre,	À mes plus chers désirs elle daigne répondre,
Le coup que je craignois le Ciel l’a détourné,	Le coup que je craignais, le Ciel l'a détourné,
Et tout autre que moi ſe verroit fortuné;	Et tout autre que moi se verrait fortuné;
Mais ces douces clartez d’un ſecret favorable,	Mais ces douces clartés d'un secret favorable,
Vers l’objet adoré me découvre coupable,	Vers l'objet adoré me découvrent coupable,
Et tombé de nouveau dans ces traîtres ſoupçons,	Et tombé de nouveau dans ces traîtres soupçons,
Surquoi l’on m’a tant fait d’inutiles leçons;	Sur quoi l'on m'a tant fait d'inutiles leçons;
Et par qui mon ardeur ſi ſouvent odieuſe,	Et par qui mon ardeur, si souvent odieuse,
Doit perdre tout eſpoir d’être jamais heureuſe:	Doit perdre tout espoir d'être jamais heureuse:
Oüi, l’on doit me haïr avec trop de raiſon,	Oui, l'on doit me haïr avec trop de raison,
Moi-même je me trouve indigne de pardon,	Moi-même je me trouve indigne de pardon,
Et quelque heureux ſuccés que le ſort me preſente,	Et quelque heureux succès que le sort me présente,
La mort, la ſeule mort, eſt toute mon attente.	La mort, la seule mort est toute mon attente.
Non, non, de ce tranſport le ſoûmis mouvement,	Non, non, de ce transport le soumis mouvement,
Prince, jette en mon ame un plus doux ſentiment,	Prince, jette en mon âme un plus doux sentiment,
Par lui de mes ſermens je me ſens détachée,	Par lui de mes serments je me sens détachée,
Vos plaintes, vos reſpects, vos douleurs m’ont touchée,	Vos plaintes, vos respects, vos douleurs m'ont touchée,
J’y vois par tout briller un excés d’amitié,	J'y vois partout briller un excès d'amitié,
Et vôtre maladie eſt digne de pitié.	Et votre maladie est digne de pitié.
Je vois, Prince, je vois, qu’on doit quelque indulgence,	Je vois, Prince, je vois qu'on doit quelque indulgence,
Aux defauts, où du Ciel fait pancher l’influence,	Aux défauts où du Ciel fait pencher l'influence,
Et pour tout dire, enfin, jaloux, ou non jaloux;	Et pour tout dire enfin, jaloux ou non jaloux;
Mon Roi ſans me gêner peut me donner à vous.	Mon Roi, sans me gêner, peut me donner à vous.
Ciel! dans l’excés des biens que cet aveu m’octroye,	Ciel! dans l'excès des biens que cet aveu m'octroie,
Rends capable mon cœur de ſupporter ſa joye.	Rends capable mon cœur de supporter sa joie.
Je veux que cet Hymen aprés nos vains débats,	Je veux que cet Hymen après nos vains débats,
Seigneur, joigne à jamais nos cœurs, & nos Etats;	Seigneur, joigne à jamais nos cœurs et nos États.
Mais ici le temps preſſe, & Leon nous appelle,	Mais ici le temps presse, et Léon nous appelle,
Allons dans nos plaiſirs ſatisfaire ſon zele,	Allons dans nos plaisirs satisfaire son zèle,
Et par nôtre preſence, & nos ſoins differents,	Et par notre présence et nos soins différents,
Donner le dernier coup au parti des Tyrans.	Donner le dernier coup au parti des Tyrans.
