PAr grace & priuilege du Roy, donné   à Paris le dernier iour de Septembre   1668.	PAr grâce et privilège du Roi, donné à Paris le dernier jour de Septembre 1668.
ſigné par le Roy en ſon Conſeil GVITONNEAV.	signé par le Roi en son Conseil GUITONNEAU.
Il eſt permis au Sieur de MOLIERE de faire imprimer, vendre & debiter   vne Comedie par luy composée intitulée George Dandin, ou le mary confondu, pendant   ſept années, & defenſes ſont faites à tous   autres de l’imprimer, ny d’autre édition   que celle de l’Expoſant, ou de ceux qui   auront droit de luy, à peine de trois mille   liures d’amende, confiſcation des exemplaires contrefaits, & de tous dépens,   dommages, & intereſts, comme il eſt plus   amplement porté par leſdites lettres.	Il est permis au Sieur de MOLIÈRE de faire imprimer, vendre et débiter une Comédie par lui composée intitulée George Dandin, ou le mari confondu, pendant sept années, et défenses sont faites à tous autres de l’imprimer, ni d’autre édition que celle de l’Exposant, ou de ceux qui auront droit de lui, à peine de trois mille livres d’amende, confiscation des exemplaires contrefaits, et de tous dépens, dommages, et intérêts, comme il est plus amplement porté par lesdites lettres.
Ledit Sieur de MOLIERE a cedé ſon droit   de Priuilege à IEAN RIBOV Marchand   Libraire à Paris, ſuiuant l’accord fait entre eux.	Ledit Sieur de MOLIÈRE a cédé son droit de Privilège à JEAN RIBOU Marchand Libraire à Paris, suivant l’accord fait entre eux.
AH!	AH!
qu’vne femme Demoiſelle eſt vne étrange affaire, & que mon mariage eſt vne leçon bien parlante à tous les Payſans qui veulent s’éleuer au deſſus de leur condition, & s’allier cõme i’ay fait à la maisõ d’vn Gentilhomme.	qu’une femme Demoiselle est une étrange affaire, et que mon mariage est une leçon bien parlante à tous les Paysans qui veulent s’élever au-dessus de leur condition, et s’allier comme j’ai fait à la maison d’un Gentilhomme.
La nobleſſe de foy eſt bõne:	La noblesse de foi est bonne:
c’eſt vne choſe conſiderable aſſurement, mais elle eſt acõpagnée de tant de mauuaiſes circonſtances, qu’il eſt tres-bon de ne s'y point froter.	c’est une chose considérable assurément, mais elle est accompagnée de tant de mauvaises circonstances, qu’il est très bon de ne s’y point frotter.
Ie ſuis deuenu là-deſſus ſçauant à mes dépens, & connois le ſtyle des Nobles lors qu’ils nous font nous autres entrer dans leur famille.	Je suis devenu là-dessus savant à mes dépens, et connais le style des Nobles lorsqu’ils nous font nous autres entrer dans leur famille.
L’alliance qu’ils font eſt petite auec nos perſonnes.	L’alliance qu’ils font est petite avec nos personnes.
C’eſt noſtre bien ſeul qu’ils épouſent, & i’aurois bien mieux fait, tout riche que ie ſuis, de m’allier en bonne &  franche payſanerie, que de prẽdre vne femme qui ſe tient au deſſus de moy, s’offence de porter mon nom, & penſe qu’auec tout mon bien ie n’ay pas aſſez acheté la qualité de sõ mary.	C’est notre bien seul qu’ils épousent, et j’aurais bien mieux fait, tout riche que je suis, de m’allier en bonne et franche paysannerie, que de prendre une femme qui se tient au dessus de moi, s’offense de porter mon nom, et pense qu’avec tout mon bien je n’ai pas assez acheté la qualité de son mari.
George Dandin, George Dandin, vous auez fait vne ſotiſe la plus grande du monde.	George Dandin, George Dandin, vous avez fait une sottise la plus grande du monde.
Ma maiſon m’eſt effroyable maintenant, & ie n’y rentre point ſans y trouuer quelque chagrin.	Ma maison m’est effroyable maintenant, et je n’y rentre point sans y trouver quelque chagrin.
Voyant ſortir Lubin de cheZ luy.	Voyant sortir Lubin de chez lui.
QVe diantre ce drôle-là vient-il faire chez moi.	QUe diantre ce drôle-là vient-il faire chez moi.
Voila vn homme qui me regarde.	Voilà un homme qui me regarde.
Il ne me connoiſt pas.	Il ne me connaît pas.
Il ſe doute de quelque choſe.	Il se doute de quelque chose.
Oüais!	Ouais!
il a grand’ peine à ſalüer.	il a grand’ peine à saluer.
I’ay peur qu’il n’aille dire qu’il m’a veu ſortir de là dedans.	J’ai peur qu’il n’aille dire qu’il m’a vu sortir de là dedans.
Bonjour.	Bonjour.
Seruiteur.	Serviteur.
Vous n'eſtes pas d’icy que ie croy.	Vous n’êtes pas d’ici que je crois.
Non, ie n’y ſuis venu que pour voir la Feſte de demain.	Non, je n’y suis venu que pour voir la Fête de demain.
Hé dites-moy vn peu, s’il vous plaiſt, vous venez de là dedans.	Hé dites-moi un peu, s’il vous plaît, vous venez de là-dedans.
Chut.	Chut.
Comment.	Comment.
Paix.	Paix.
Quoy donc?	Quoi donc?
Motus, il ne faut pas dire que vous m’ayez veu ſortir de là.	Motus, il ne faut pas dire que vous m’ayez vu sortir de là.
Pourquoy?	Pourquoi?
Mon Dieu parce.	Mon Dieu parce.
Mais encor?	Mais encor?
Doucement.	Doucement.
I’ay peur qu’on ne nous écoute.	J’ai peur qu’on ne nous écoute.
Point, point.	Point, point.
C’eſt que ie viens de parler à la Maiſtreſſe du logis de la part d’vn certain Monſieur qui luy fait les doux yeux, & il ne faut pas qu’on ſçache cela.	C’est que je viens de parler à la Maîtresse du logis de la part d’un certain Monsieur qui lui fait les doux yeux, et il ne faut pas qu’on sache cela.
Entendez-vous?	Entendez-vous?
Oüy.	Oui.
Voila la raiſon.	Voilà la raison.
On m’a enchargé de prendre garde que perſonne ne me viſt, & ie vous prie au moins de ne pas dire que vous m’ayez veu.	On m’a enchargé de prendre garde que personne ne me vît, et je vous prie au moins de ne pas dire que vous m’ayez vu.
Ie n’ay garde.	Je n’ai garde.
Ie ſuis bien aiſe de faire les choſes ſecretement comme on m’a recommandé.	Je suis bien aise de faire les choses secrètement comme on m’a recommandé.
C’eſt bien fait.	C’est bien fait.
Le mary, à ce qu’ils diſent, eſt vn ialoux qui ne veut pas qu’on faſſe l’amour à ſa femme, & il feroit le diable à quatre ſi cela venoit à ſes oreilles.	Le mari, à ce qu’ils disent, est un jaloux qui ne veut pas qu’on fasse l’amour à sa femme, et il ferait le diable à quatre si cela venait à ses oreilles.
Vous comprenez bien.	Vous comprenez bien.
Fort bien.	Fort bien.
Il ne faut pas qu’il ſçache rien de tout cecy.	Il ne faut pas qu’il sache rien de tout ceci.
Sans doute.	Sans doute.
On le veut tromper tout doucement.	On le veut tromper tout doucement.
Vous entendez bien.	Vous entendez bien.
Le mieux du monde.	Le mieux du monde.
Si vous alliez dire que vous m’auez veu ſortir de chez luy, vous gaſteriez toute l’affaire.	Si vous alliez dire que vous m’avez vu sortir de chez lui, vous gâteriez toute l’affaire.
Vous comprenez bien.	Vous comprenez bien.
Aſſurement.	Assurément.
Hé comment nommez vous celuy qui vous a enuoyé là dedans.	Hé comment nommez-vous celui qui vous a envoyé là-dedans.
C’eſt le Seigneur de noſtre pays, Monſieur le Vicomte de choſe...	C’est le Seigneur de notre pays, Monsieur le Vicomte de chose…
foin ie ne me ſouuiens iamais comment diantre ils baragouynent ce nom là, Monſieur Cli...Clitande.	foin je ne me souviens jamais comment diantre ils baragouinent ce nom là, Monsieur Cli…Clitande.
Eſt-ce ce ieune Courtiſan qui demeure...	Est-ce ce jeune Courtisan qui demeure…
Oüy.	Oui.
Auprés de ces arbres.	Auprès de ces arbres.
à part.	à part.
C’eſt pour cela que depuis peu ce Damoiſeau poly s’eſt venu loger contre moy, i’auois bon nez ſans doute, & ſon voiſinage déja m'auoit donné quelque ſoupçon.	C’est pour cela que depuis peu ce Damoiseau poli s’est venu loger contre moi, j’avais bon nez sans doute, et son voisinage déjà m’avait donné quelque soupçon.
Teſtigué, c’eſt le plus honneſte homme que vous ayez iamais veu.	Testigué, c’est le plus honnête homme que vous ayez jamais vu.
Il m’a donné trois pieces d’or pour aller dire ſeulement à la femme qu’il eſt amoureux d’elle, & qu’il ſouhaite fort l’honneur de pouvoir luy parler.	Il m’a donné trois pièces d’or pour aller dire seulement à la femme qu’il est amoureux d’elle, et qu’il souhaite fort l’honneur de pouvoir lui parler.
Voyez s'il y a là vne grande fatigue pour me payer ſi bien, & ce qu’eſt au prix de cela vne iournée de trauail où ie ne gagne que dix ſols.	Voyez s’il y a là une grande fatigue pour me payer si bien, et ce qu’est au prix de cela une journée de travail où je ne gagne que dix sols.
Hé bien auez-vous fait voſtre meſſage.	Hé bien avez-vous fait votre message.
Oüy, i’ay trouué là dedans vne certaine Claudine, qui tout du premier coup a compris ce que ie voulois, & qui m'a fait parler à ſa Maiſtreſſe.	Oui, j’ai trouvé là-dedans une certaine Claudine, qui tout du premier coup a compris ce que je voulais, et qui m’a fait parler à sa Maîtresse.
à part. Ah coquine de ſeruante.	à part. Ah coquine de servante.
Morguéne cette Claudine là eſt tout à fait iolie, elle a gagné mon amitié, & il ne tiendra qu’à elle que nous ne ſoyõs mariez enſemble.	Morguène cette Claudine-là est tout à fait jolie, elle a gagné mon amitié, et il ne tiendra qu’à elle que nous ne soyons mariés ensemble.
Mais quelle réponſe a fait la Maiſtreſſe à ce Monsieur le Courtiſan.	Mais quelle réponse a fait la Maîtresse à ce Monsieur le Courtisan.
Elle m’a dit de luy dire...attendez, ie ne ſçay ſi ie me ſouviendrez bien de tout cela.	Elle m’a dit de lui dire… attendez, je ne sais si je me souviendrez bien de tout cela.
Qu’elle luy eſt tout à fait obligée de l’affection qu’il a pour elle, & qu’à cauſe de ſon mary qui eſt fantaſque, il garde d’en rien faire paroiſtre, &  qu’il faudra ſonger à chercher quelque invention pour ſe pouuoir entretenir tous deux.	Qu’elle lui est tout à fait obligée de l’affection qu’il a pour elle, et qu’à cause de son mari qui est fantasque, il garde d’en rien faire paraître, et qu’il faudra songer à chercher quelque invention pour se pouvoir entretenir tous deux.
à part.	à part.
Ah!	Ah!
pendarde de femme.	pendarde de femme.
Teſtiguiene cela ſera drôle, car le mary ne ſe doutera point de la manigance, voila ce qui eſt de bon.	Testiguiène cela sera drôle, car le mari ne se doutera point de la manigance, voilà ce qui est de bon.
Et il aura vn pied de nez auec ſa ialouſie.	Et il aura un pied de nez avec sa jalousie.
Eſt ce pas?	Est-ce pas?
Cela eſt vray.	Cela est vrai.
Adieu.	Adieu.
Bouche couſuë au moins.	Bouche cousue au moins.
Gardez bien le ſecret, afin que le mary ne le ſçache pas.	Gardez bien le secret, afin que le mari ne le sache pas.
Oüy, oüy.	Oui, oui.
Pour moy ie vais faire ſemblant de rien, ie ſuis vn fin matois, & l’on ne diroit pas que i'y touche.	Pour moi je vais faire semblant de rien, je suis un fin matois, et l’on ne dirait pas que j’y touche.
HE bien, George Dandin, vous voyez de quel air voſtre femme vous traitte.	HÉ bien, George Dandin, vous voyez de quel air votre femme vous traite.
Voila ce que c’eſt d’auoir voulu épouſer vne Demoiſelle, l’on vous accommode de toutes pièces, ſans que vous puiſſiez vous vanger, & la Gentilhommerie vous tient les bras liez.	Voilà ce que c’est d’avoir voulu épouser une Demoiselle, l’on vous accommode de toutes pièces, sans que vous puissiez vous venger, et la Gentilhommerie vous tient les bras liés.
L’égalité de condition laiſſe du moins à l’honneur d’vn mary liberté de reſſentiment, & ſi c’eſtoit vne Païſanne, vous auriez maintenant toutes vos coudées franches à vous en faire la iuſtice à bons coups de baſton.	L’égalité de condition laisse du moins à l’honneur d’un mari liberté de ressentiment, et si c’était une Paysanne, vous auriez maintenant toutes vos coudées franches à vous en faire la justice à bons coups de bâton.
Mais vous auez voulu taſter de la Nobleſſe, & il vous ennuyoit d’eſtre maiſtre chez vous.	Mais vous avez voulu tâter de la Noblesse, et il vous ennuyait d’être maître chez vous.
Ah!	Ah!
i'enrage de tout mon coeur, & ie me donnerois volontiers des ſoufflets.	j’enrage de tout mon cœur, et je me donnerais volontiers des soufflets.
Quoy écouter impudemment l’amour d’vn Damoiſeau, & y promettre en meſme temps de la correspondance!	Quoi écouter impudemment l’amour d’un Damoiseau, et y promettre en même temps de la correspondance!
Morbleu ie ne veux point laiſſer paſſer vne occaſion de la ſorte.	Morbleu je ne veux point laisser passer une occasion de la sorte.
Il me faut de ce pas aller faire mes plaintes au pere &  à la mere, & les rendre témoins à telle fin que de raiſon, des ſujets de chagrin & de reſſentiment que leur fille me donne.	Il me faut de ce pas aller faire mes plaintes au père et à la mère, et les rendre témoins à telle fin que de raison, des sujets de chagrin et de ressentiment que leur fille me donne.
Mais les voicy l'vn & l’autre fort à propos.	Mais les voici l’un et l’autre fort à propos.
QV'eſt ce, mon gendre?	QU’est-ce, mon gendre?
vous me paroiſſez tout troublé.	vous me paraissez tout troublé.
Auſſi en ay-ie du ſuiet, &....	Aussi en ai-je du sujet, et…
Mon Dieu, noſtre gendre, que vous auez peu de ciuilité de ne pas ſalüer les gens quand vous les approchez.	Mon Dieu, notre gendre, que vous avez peu de civilité de ne pas saluer les gens quand vous les approchez.
Ma foy, ma belle-mere, c’eſt que i’ay d’autres choſes en teſte, & ..	Ma foi, ma belle-mère, c’est que j’ai d’autres choses en tête, et…
Encor!	Encor!
eſt il poſſible, noſtre gendre, que vous ſçachiez ſi peu voſtre monde, & qu’il n’y ait pas moyen de vous inſtruire de la maniere qu'il faut viure parmy les perſonnes de qualité.	est-il possible, notre gendre, que vous sachiez si peu votre monde, et qu’il n’y ait pas moyen de vous instruire de la manière qu’il faut vivre parmi les personnes de qualité.
Comment.	Comment.
Ne vous déferez-vous iamais auec moy de la familiarité de ce mot de ma belle mere, & ne ſçauriez-vous vous accouſtumer à me dire Madame.	Ne vous déferez-vous jamais avec moi de la familiarité de ce mot de ma belle-mère, et ne sauriez-vous vous accoutumer à me dire Madame.
Parbleu, ſi vous m'appellez voſtre gendre, il me ſemble que ie puis vous appeller ma belle-mere.	Parbleu, si vous m’appelez votre gendre, il me semble que je puis vous appeler ma belle-mère.
Il y a fort à dire, & les choſes ne ſont pas égales.	Il y a fort à dire, et les choses ne sont pas égales.
Apprenez, s'il vous plaiſt, que ce n’eſt pas à vous à vous ſeruir de ce mot là auec vne perſonne de ma condition;	Apprenez, s’il vous plaît, que ce n’est pas à vous à vous servir de ce mot là avec une personne de ma condition;
Que tout noſtre gendre que vous ſoyez, il y a grande difference de vous à nous, & que vous deuez vous connoiſtre.	Que tout notre gendre que vous soyez, il y a grande différence de vous à nous, et que vous devez vous connaître.
C’en eſt aſſez mamour, laiſſons cela.	C’en est assez mamour, laissons cela.
Mon Dieu, Monſieur de Sotenuille, vous auez des indulgences qui n’appartiennent qu'à vous, & vous ne ſçauez pas vous faire rendre par les gens ce qui vous eſt deu.	Mon Dieu, Monsieur de Sotenville, vous avez des indulgences qui n’appartiennent qu’à vous, et vous ne savez pas vous faire rendre par les gens ce qui vous est dû.
Corbleu, pardonnez-moy, on ne peut point me faire de leçons là-deſſus, & i'ay ſçeu montrer en ma vie par vingt actions de vigueur, que ie ne ſuis point homme à démordre iamais d’vne partie de mes pretentions.	Corbleu, pardonnez-moi, on ne peut point me faire de leçons là-dessus, et j’ai su montrer en ma vie par vingt actions de vigueur, que je ne suis point homme à démordre jamais d’une partie de mes prétentions.
Mais il ſuffit de luy auoir donné vn petit auertiſſement.	Mais il suffit de lui avoir donné un petit avertissement.
Sçachons vn peu, mon gendre, ce que vous auez dans l'eſprit.	Sachons un peu, mon gendre, ce que vous avez dans l’esprit.
Puiſqu’il faut donc parler cathegoriquement, ie vous diray, Monſieur de Sotenuille, que i’ay lieu de...	Puisqu’il faut donc parler catégoriquement, je vous dirai, Monsieur de Sotenville, que j’ai lieu de…
Doucement, mon gendre.	Doucement, mon gendre.
Apprenez qu'il n’eſt pas reſpectueux d’appeller les gens par leur nom, & qu'à ceux qui ſont au deſſus de nous il faut dire Monſieur tout court.	Apprenez qu’il n’est pas respectueux d’appeler les gens par leur nom, et qu’à ceux qui sont au dessus de nous il faut dire Monsieur tout court.
Hé bien, Monſieur tout court, & non plus Monſieur de Sotenuille, i’ay à vous dire que ma femme me donne...	Hé bien, Monsieur tout court, et non plus Monsieur de Sotenville, j’ai à vous dire que ma femme me donne…
Tout beau.	Tout beau.
Aprenez auſſi que vous ne deuez pas dire ma femme, quand vous parlez de noſtre fille.	Apprenez aussi que vous ne devez pas dire ma femme, quand vous parlez de notre fille.
I'enrage.	J’enrage.
Comment, ma femme n’eſt pas femme?	Comment, ma femme n’est pas femme?
Oüy, noſtre gendre, elle eſt voſtre femme, mais il ne vous eſt pas permis de l'appeller ainſi, & c'eſt tout ce que vous pourriez faire, ſi vous auiez eſpouſé vne de vos pareilles.	Oui, notre gendre, elle est votre femme, mais il ne vous est pas permis de l’appeler ainsi, et c’est tout ce que vous pourriez faire, si vous aviez épousé une de vos pareilles.
Ah!	Ah!
George Dandin, où t’es- tu fourré?	George Dandin, où t’es-tu fourré?
Et de grace, mettez pour vu moment voſtre Gentilhommerie à costé, & ſouffrez que ie vous parle maintenant comme ie pourray.	Et de grâce, mettez pour vu moment votre Gentilhommerie à côté, et souffrez que je vous parle maintenant comme je pourrai.
Au diantre ſoit la tyrannie de toutes ces hiſtoires-là.	Au diantre soit la tyrannie de toutes ces histoires-là.
Ie vous dy donc que ie ſuis mal ſatisfait de mon mariage.	Je vous dis donc que je suis mal satisfait de mon mariage.
Et la raiſon, mon gendre.	Et la raison, mon gendre.
Quoy parler ainſi d'vne choſe dont vous auez tiré de ſi grands auantages?	Quoi parler ainsi d’une chose dont vous avez tiré de si grands avantages?
Et quels auantages, Madame, puiſque Madame y a?	Et quels avantages, Madame, puisque Madame y a?
L’auanture n’a pas eſté mauuaiſe pour vous, car ſans moy vos affaires, auec voſtre permiſſiõ, eſtoient fort délabrées, & mon argent a ſeruy à reboucher d’aſſez bons trous;	L’aventure n’a pas été mauvaise pour vous, car sans moi vos affaires, avec votre permission, étaient fort délabrées, et mon argent a servi à reboucher d’assez bons trous;
mais moy dequoy y ay ie profité, ie vous prie, que d’vn alongement de nom, &  au lieu de George Dandin, d'auoir receu par vous le titre de Monſieur de la Dandiniere.	mais moi de quoi y ai-je profité, je vous prie, que d’un allongement de nom, et au lieu de George Dandin, d’avoir reçu par vous le titre de Monsieur de la Dandinière.
Ne contez-vous rien, mon gendre, l’auantage d’eſtre allié à la maiſon de Sotenuille.	Ne contez-vous rien, mon gendre, l’avantage d’être allié à la maison de Sotenville.
Et à celle de la Prudoterie, dont i’ay l’honneur d’eſtre iſſuë.	Et à celle de la Prudoterie, dont j’ai l’honneur d’être issue.
Maiſon où le ventre anoblit:	Maison où le ventre anoblit:
& qui par ce beau priuilege rendra vos enfans Gentilshommes.	et qui par ce beau privilège rendra vos enfants Gentilshommes.
Oüy, voila qui eſt bien, mes enfans ſeront Gentilshommes, mais ie ſeray cocu moy, ſi l’on n'y met ordre.	Oui, voilà qui est bien, mes enfants seront Gentilshommes, mais je serai cocu moi, si l’on n’y met ordre.
Que veut dire cela, mon gendre?	Que veut dire cela, mon gendre?
Cela veut dire que voſtre fille ne vit pas comme il faut qu'vne femme viue, & qu'elle fait des choſes qui ſont contre l’honneur.	Cela veut dire que votre fille ne vit pas comme il faut qu’une femme vive, et qu’elle fait des choses qui sont contre l’honneur.
Tout beau.	Tout beau.
Prenez garde à ce que vous dites.	Prenez garde à ce que vous dites.
Ma fille eſt d’vne race trop pleine de vertu pour ſe porter iamais à faire aucune choſe dont l’honneſteté ſoit bleſſée, & de la maiſon de la Prudoterie, il y a plus de trois cens ans qu'on n'a point remarqué qu’il y ait eu de femme, Dieu mercy, qui ait fait parler d’elle.	Ma fille est d’une race trop pleine de vertu pour se porter jamais à faire aucune chose dont l’honnêteté soit blessée, et de la maison de la Prudoterie, il y a plus de trois cents ans qu’on n’a point remarqué qu’il y ait eu de femme, Dieu merci, qui ait fait parler d’elle.
Corbleu, dans la maiſon de Sotenuille on n’a iamais veu de coquette, & la brauoure n’y eſt pas plus hereditaire aux maſles, que la chaſteté aux femelles.	Corbleu, dans la maison de Sotenville on n’a jamais vu de coquette, et la bravoure n’y est pas plus héréditaire aux mâles, que la chasteté aux femelles.
Nous auons eu vne Iacqueline de la Prudoterie qui ne voulut iamais eſtre la Maiſtreſſe d’vn Duc & Pair, Gouuerneur de noſtre Prouince.	Nous avons eu une Jacqueline de la Prudoterie qui ne voulut jamais être la Maîtresse d’un Duc et Pair, Gouverneur de notre Province.
Il y a eu vne Mathurine de Sotenuille qui refuſa vingt mille écus d'vn Fauory du Roy, qui ne luy demandoit ſeulement que la faueur de luy parler.	Il y a eu une Mathurine de Sotenville qui refusa vingt mille écus d’un Favori du Roi, qui ne lui demandait seulement que la faveur de lui parler.
Ho bien voſtre fille n’eſt pas ſi difficile que cela, & elle s’eſt appriuoiſée depuis qu'elle eſt chez moy.	Ho bien votre fille n’est pas si difficile que cela, et elle s’est apprivoisée depuis qu’elle est chez moi.
Expliquez vous, mon gendre, nous ne ſommes point gens à la ſupporter dans de mauuaiſes actions, & nous ſerons les premiers, ſa mere & moy, à vous en faire la iuſtice.	Expliquez-vous, mon gendre, nous ne sommes point gens à la supporter dans de mauvaises actions, et nous serons les premiers, sa mère et moi, à vous en faire la justice.
Nous n’entendons point raillerie ſur les matieres de l'honneur, & nous l’auons éleuée dans toute la ſeuerité poſſible.	Nous n’entendons point raillerie sur les matières de l’honneur, et nous l’avons élevée dans toute la sévérité possible.
Tout ce que ie vous puis dire, c’eſt qu’il y a icy vn certain Courtiſan que vous auez veu, qui eſt amoureux d’elle à ma barbe, & qui luy a fait faire des proteſtations d’amour, qu’elle a tres-humainement eſcoutées.	Tout ce que je vous puis dire, c’est qu’il y a ici un certain Courtisan que vous avez vu, qui est amoureux d’elle à ma barbe, et qui lui a fait faire des protestations d’amour, qu’elle a très humainement écoutées.
Iour de Dieu, ie l'étranglerois de mes propres mains, s’il falloit qu’elle forlignaſt de l’honneſteté de ſa mere.	Jour de Dieu, je l’étranglerais de mes propres mains, s’il fallait qu’elle forlignât de l’honnêteté de sa mère.
Corbleu, ie luy paſſerois mon épée au trauers du corps, à elle & au galant, ſi elle auoit forfait à ſon honneur.	Corbleu, je lui passerais mon épée au travers du corps, à elle et au galant, si elle avait forfait à son honneur.
Ie vous ay dit ce qui ſe paſſe pour vous faire mes plaintes, &  ie vous demande raiſon de cette affaire là.	Je vous ai dit ce qui se passe pour vous faire mes plaintes, et je vous demande raison de cette affaire-là.
Ne vous tourmentez point, ie vous la feray de tous deux, &  ie ſuis homme pour ſerrer le bouton à qui que ce puiſſe eſtre.	Ne vous tourmentez point, je vous la ferai de tous deux, et je suis homme pour serrer le bouton à qui que ce puisse être.
Mais eſtes-vous pas bien ſeur auſſi de ce que vous nous dites.	Mais êtes-vous pas bien sûr aussi de ce que vous nous dites.
Tres-ſeur.	Très sûr.
Prenez bien garde au moins, car entre Gentilshommes, ce ſont des choſes chatoüilleuſes, & il n'eſt pas queſtion d’aller faire icy vn pas de Clerc.	Prenez bien garde au moins, car entre Gentilshommes, ce sont des choses chatouilleuses, et il n’est pas question d’aller faire ici un pas de Clerc.
Ie ne vous ay rien dit, vous dis-ie, qui ne ſoit veritable.	Je ne vous ai rien dit, vous dis-je, qui ne soit véritable.
Mamour, allez-vous en parler à voſtre fille, tandis qu’auec mon gendre i’iray parler à l'homme.	Mamour, allez-vous en parler à votre fille, tandis qu’avec mon gendre j’irai parler à l’homme.
Se pourroit il, mon fils, quelle s’oubliait de la ſorte, apres le ſage exemple que vous ſçauez vous-meſme que ie luy ay donné.	Se pourrait-il, mon fils, qu'elle s’oubliait de la sorte, après le sage exemple que vous savez vous-même que je lui ai donné.
Nous allons éclaircir l’affaire.	Nous allons éclaircir l’affaire.
Suiuez moy, mon gendre, & ne vous mettez pas en peine, vous verrez de quel bois nous nous chauffons lors qu'õ s’attaque à ceux qui nous peuuent appartenir.	Suivez moi, mon gendre, et ne vous mettez pas en peine, vous verrez de quel bois nous nous chauffons lorsqu’on s’attaque à ceux qui nous peuvent appartenir.
Le voicy qui vient vers nous.	Le voici qui vient vers nous.
MOnſieur, ſuis-ie connu de vous?	MOnsieur, suis-je connu de vous?
Non pas que ie ſçache, Monſieur.	Non pas que je sache, Monsieur.
Ie m'appelle le Baron de Sotenuille.	Je m’appelle le Baron de Sotenville.
Ie m'en réjoüis fort.	Je m’en réjouis fort.
Mon nom eſt connu à la Cour, & i'eus l’honneur dans ma ieuneſſe de me ſignaler des premiers à l’arriere-ban de Nancy.	Mon nom est connu à la Cour, et j’eus l’honneur dans ma jeunesse de me signaler des premiers à l’arrière-ban de Nancy.
A la bonne heure.	À la bonne heure.
Monſieur, mon pere Iean-Gilles de Sotenuille eut la gloire d'aſſiſter en perſonne au grand ſiege de Montauban.	Monsieur, mon père Jean-Gilles de Sotenville eut la gloire d’assister en personne au grand siège de Montauban.
I'en ſuis rauy.	J’en suis ravi.
Et i’ay eu vn ayeul Bertrand de Sotenuille, qui fut ſi conſideré en ſon temps, que d'auoir permiſſion de vendre tout ſon bien pour le voyage d'outre-mer.	Et j’ai eu un aïeul Bertrand de Sotenville, qui fut si considéré en son temps, que d’avoir permission de vendre tout son bien pour le voyage d’outre-mer.
Ie le veux croire.	Je le veux croire.
Il m'a eſté rapporté, Monſieur, que vous aimez & pourſuiuez vne ieune perſonne, qui eſt ma fille pour laquelle ie m’intereſſe, & pour l’homme que vous voyez, qui a l’honneur d’eſtre mon gendre.	Il m’a été rapporté, Monsieur, que vous aimez et poursuivez une jeune personne, qui est ma fille pour laquelle je m’intéresse, et pour l’homme que vous voyez, qui a l’honneur d’être mon gendre.
Qui moy.	Qui moi.
Oüy.	Oui.
Et ie ſuis bien aiſe de vous parler, pour tirer de vous, s’il vous plaiſt, vn éclairciſſement de cette affaire.	Et je suis bien aise de vous parler, pour tirer de vous, s’il vous plaît, un éclaircissement de cette affaire.
Voila vne étrange médiſance.	Voilà une étrange médisance.
Qui vous a dit cela, Monſieur?	Qui vous a dit cela, Monsieur?
Quelqu'vn qui croit le bien ſçauoir.	Quelqu’un qui croit le bien savoir.
Ce quelqu'vn-là en a menty.	Ce quelqu’un-là en a menti.
Ie ſuis honneſte homme.	Je suis honnête homme.
Me croyez-vous capable, Monſieur, d’vne action auſſi laſche que celle-là?	Me croyez-vous capable, Monsieur, d’une action aussi lâche que celle-là?
Moy aimer vne ieune & belle perſonne, qui a l’honneur d’eſtre la fille de Monſieur le Baron de Sotenuille.	Moi aimer une jeune et belle personne, qui a l’honneur d’être la fille de Monsieur le Baron de Sotenville.
Ie vous reuere trop pour cela, & ſuis trop voſtre ſeruiteur.	Je vous révère trop pour cela, et suis trop votre serviteur.
Quiconque vous l'a dit, eſt vn ſot.	Quiconque vous l’a dit, est un sot.
Allons, mon gendre.	Allons, mon gendre.
Quoy?	Quoi?
C’eſt vn coquin & vn maraut.	C’est un coquin et un maraud.
Répondez.	Répondez.
Répondez vous-meſme.	Répondez vous-même.
Si ie ſçauois qui ſe peut eſtre, ie luy donnerois en voſtre preſence de l’épée dans le ventre.	Si je savais qui se peut être, je lui donnerais en votre présence de l’épée dans le ventre.
Souſtenez donc la choſe.	Soutenez donc la chose.
Elle eſt toute ſouſtenuë, cela eſt vray.	Elle est toute soutenue, cela est vrai.
Eſt-ce voſtre gendre.	Est-ce votre gendre.
Monſieur, qui...	Monsieur, qui…
Oüy, c’eſt luy-meſme qui s’en eſt plaint à moy.	Oui, c’est lui-même qui s’en est plaint à moi.
Certes, il peut remercier l’auantage qu’il a de vous appartenir, & ſans cela ie luy apprendrois bien à tenir de pareils diſcours d’vne perſonne comme moy.	Certes, il peut remercier l’avantage qu’il a de vous appartenir, et sans cela je lui apprendrais bien à tenir de pareils discours d’une personne comme moi.
POurce qui eſt de cela, la ialouſie eſt vne étrange choſe!	POurce qui est de cela, la jalousie est une étrange chose!
I'amene icy ma fille pour éclaircir l’affaire en preſence de tout le monde.	J’amène ici ma fille pour éclaircir l’affaire en présence de tout le monde.
Eſt ce donc vous, Madame, qui auez dit à voſtre mary que ie ſuis amoureux de vous.	Est-ce donc vous, Madame, qui avez dit à votre mari que je suis amoureux de vous.
Moy, & comment luy aurois-ie dit?	Moi, et comment lui aurais-je dit?
Eſt-ce que cela eſt?	Est-ce que cela est?
Ie voudrois bien le voir vrayment que vous fuſſiez amoureux de moy.	Je voudrais bien le voir vraiment que vous fussiez amoureux de moi.
Ioüez vous-y, ie vous en prie, vous trouuerez à qui parler.	Jouez-vous-y, je vous en prie, vous trouverez à qui parler.
C'eſt vne choſe que ie vous conſeille de faire.	C’est une chose que je vous conseille de faire.
Ayés recours pour voir à tous les détours des Amans.	Ayez recours pour voir à tous les détours des Amants.
Eſſayez vn peu par plaiſir à m'enuoyer des ambaſſades, à m’écrire ſecrettemẽt de petits billets doux, à épier les momens que mon mary n’y ſera pas, ou le temps que ie ſortiray pour me parler de voſtre amour.	Essayez un peu par plaisir à m’envoyer des ambassades, à m’écrire secrètement de petits billets doux, à épier les moments que mon mari n’y sera pas, ou le temps que je sortirai pour me parler de votre amour.
Vous n’auez qu'à y venir, ie vous promets que vous ſerez receu comme il faut.	Vous n’avez qu’à y venir, je vous promets que vous serez reçu comme il faut.
Hé là là, Madame, tout doucement.	Hé là là, Madame, tout doucement.
Il n’eſt pas neceſſaire de me faire tant de leçons, &  de vous tant ſcandaliſer.	Il n’est pas nécessaire de me faire tant de leçons, et de vous tant scandaliser.
Qui vous dit que ie ſonge à vous aimer?	Qui vous dit que je songe à vous aimer?
Que ſçay-ie moy ce qu'on me vient conter icy?	Que sais-je moi ce qu’on me vient conter ici?
On dira ce que l’on voudra.	On dira ce que l’on voudra.
Mais vous ſçauez ſi ie vous ay parlé d’amour lors que ie vous ay rencontrée.	Mais vous savez si je vous ai parlé d’amour lorsque je vous ai rencontrée.
Vous n’auiez qu'à le faire, vous auriez eſté bien venu.	Vous n’aviez qu’à le faire, vous auriez été bien venu.
Ie vous aſſeure qu’auec moy vous n’auez rien à craindre.	Je vous assure qu’avec moi vous n’avez rien à craindre.
Que ie ne ſuis point homme à donner du chagrin aux Belles, & que ie vous reſpecte trop, &  vous & Meſſieurs vos parens, pour auoir la penſée d’eſtre amoureux de vous.	Que je ne suis point homme à donner du chagrin aux Belles, et que je vous respecte trop, et vous et Messieurs vos parents, pour avoir la pensée d’être amoureux de vous.
Me DE SOTENVILLE. Hé bien vous le voyez.	Me DE SOTENVILLE. Hé bien vous le voyez.
Vous voila ſatisfait, mon gendre, que dites-vous à cela?	Vous voilà satisfait, mon gendre, que dites-vous à cela?
Ie dis que ce ſont là des contes à dormir debout.	Je dis que ce sont là des contes à dormir debout.
Que ie ſçay bien ce que ie ſçay, & que tantoſt, puiſqu'il faut parler, elle a receu vne ambaſſade de ſa part.	Que je sais bien ce que je sais, et que tantôt, puisqu’il faut parler, elle a reçu une ambassade de sa part.
Moy, i’ay receu vne ambaſſade.	Moi, j’ai reçu une ambassade.
I'ay enuoyé vne ambaſſade?	J’ai envoyé une ambassade?
Claudine.	Claudine.
Eſt-il vray?	Est-il vrai?
Par ma foy voila vne étrange fauſſeté.	Par ma foi voilà une étrange fausseté.
Taiſez vous, carogne que vous eſtes.	Taisez-vous, carogne que vous êtes.
Ie ſçay de vos nouuelles, & c'eſt vous qui tantoſt auez introduit le Courier.	Je sais de vos nouvelles, et c’est vous qui tantôt avez introduit le Courier.
Qui moy?	Qui moi?
Oüy vous.	Oui vous.
Ne faites point tant la ſucrée.	Ne faites point tant la sucrée.
Helas!	Hélas!
que le monde aujourd'huy eſt remply de meſchanceté, de m’aller ſoupçonner ainſi, moy qui ſuis l’innocence meſme.	que le monde aujourd’hui est rempli de méchanceté, de m’aller soupçonner ainsi, moi qui suis l’innocence même.
Taiſez-vous, bonne piece.	Taisez-vous, bonne pièce.
Vous faites la ſournoiſe.	Vous faites la sournoise.
Mais ie vous connois il y a long-temps, & vous eſtes vne deſſalée.	Mais je vous connais il y a longtemps, et vous êtes une dessalée.
Madame eſt-ce que...	Madame est-ce que…
Taiſez-vous, vous dis-ie, vous pourriez bien porter la folle-enchere de tous les autres.	Taisez-vous, vous dis-je, vous pourriez bien porter la folle enchère de tous les autres.
Et vous n’auez point de pere Gentilhomme.	Et vous n’avez point de père Gentilhomme.
C’eſt vne impoſture ſi grande, & qui me touche ſi fort au cœur, que ie ne puis pas meſme auoir la force d’y répondre; cela eſt bien horrible d’eſtre accuſée par vn mary lors qu'on ne luy fait rien qui ne ſoit à faire.	C’est une imposture si grande, et qui me touche si fort au cœur, que je ne puis pas même avoir la force d’y répondre; cela est bien horrible d’être accusée par un mari lorsqu’on ne lui fait rien qui ne soit à faire.
Helas!	Hélas!
ſi ie ſuis blaſmable de quelque choſe, c’eſt d’en vſer trop bien auec luy.	si je suis blâmable de quelque chose, c’est d’en user trop bien avec lui.
Aſſeurément.	Assurément.
Tout mon malheur eſt de le trop conſiderer, & pluſt au Ciel que ie fuſſe capable de ſouffrir, comme il dit, les galanteries de quelqu’vn, ie ne ſerois pas tant à plaindre.	Tout mon malheur est de le trop considérer, et plût au Ciel que je fusse capable de souffrir, comme il dit, les galanteries de quelqu’un, je ne serais pas tant à plaindre.
Adieu, ie me retire, & ie ne puis plus endurer qu’on m’outrage de cette ſorte.	Adieu, je me retire, et je ne puis plus endurer qu’on m’outrage de cette sorte.
Allez, vous ne meritez pas l'honneſte femme qu’on vous a donnée.	Allez, vous ne méritez pas l’honnête femme qu’on vous a donnée.
Par ma foy, il meriteroit qu’elle luy fiſt dire vray, & ſi i'eſtois en ſa place ie n’y marchanderois pas.	Par ma foi, il mériterait qu’elle lui fît dire vrai, et si j’étais en sa place je n’y marchanderais pas.
Oüy, Monſieur, vous deuez pour le punir, faire l’amour à ma Maiſtreſſe.	Oui, Monsieur, vous devez pour le punir, faire l’amour à ma Maîtresse.
Pouſſez, c’eſt moy qui vous le dy, ce ſera fort bien employé, & ie m’offre à vous y ſeruir, puiſqu’il m’en a deſia taxée.	Poussez, c’est moi qui vous le dis, ce sera fort bien employé, et je m’offre à vous y servir, puisqu’il m’en a déjà taxée.
Vous meritez, mon gendre, qu’on vous diſe ces choſes là, & voſtre procedé met tout le monde contre vous.	Vous méritez, mon gendre, qu’on vous dise ces choses là, et votre procédé met tout le monde contre vous.
Allez, ſongez à mieux traiter vne Demoiſelle bien née, & prenez garde deſormais à ne plus faire de pareilles beueuës.	Allez, songez à mieux traiter une Demoiselle bien née, et prenez garde désormais à ne plus faire de pareilles bévues.
I'enrage de bon cœur d’auoir tort, lors que i’ay raiſon.	J’enrage de bon cœur d’avoir tort, lorsque j’ai raison.
Monſieur, vous voyez comme i’ay eſté fauſſement accusé.	Monsieur, vous voyez comme j’ai été faussement accusé.
Vous eſtes homme qui ſçauez les maximes du point d’honneur, & ie vous demande raiſon de l'affront qui m’a eſté fait.	Vous êtes homme qui savez les maximes du point d’honneur, et je vous demande raison de l’affront qui m’a été fait.
Cela eſt iuſte, & c’eſt l’ordre des procedez.	Cela est juste, et c’est l’ordre des procédés.
Allons, mon gendre, faites ſatisfaction à Monſieur.	Allons, mon gendre, faites satisfaction à Monsieur.
Comment ſatisfaction.	Comment satisfaction.
Oüy.	Oui.
Cela ſe doit dans les regles pour l’auoir à tort accuſé.	Cela se doit dans les règles pour l’avoir à tort accusé.
C’eſt vne choſe moy dont ie ne demeure pas d’accord de l’auoir à tort accuſé, & ie ſçay bien ce que i’en penſe.	C’est une chose moi dont je ne demeure pas d’accord de l’avoir à tort accusé, et je sais bien ce que j’en pense.
Il n’importe.	Il n’importe.
Quelque penſée qui vous puiſſe reſter, il a nié, c’eſt ſatisfaire les perſonnes, & l'on n'a nul droit de ſe plaindre de tout homme qui ſe dédit.	Quelque pensée qui vous puisse rester, il a nié, c’est satisfaire les personnes, et l’on n’a nul droit de se plaindre de tout homme qui se dédit.
Si bien donc que ſi ie le trouuois couché auec ma femme, il en ſeroit quitte pour ſe dédire.	Si bien donc que si je le trouvais couché avec ma femme, il en serait quitte pour se dédire.
Point de raiſonnement.	Point de raisonnement.
Faites-luy les excuſes que ie vous dy.	Faites-lui les excuses que je vous dis.
Moy, ie luy feray encore des excuſes apres...	Moi, je lui ferai encore des excuses après…
Allons vous dy-ie.	Allons vous di-je.
Il n’y a rien à balancer, & vous n’auez que faire d’auoir peur d'en trop faire, puiſque c’eſt moy qui vous conduy.	Il n’y a rien à balancer, et vous n’avez que faire d’avoir peur d’en trop faire, puisque c’est moi qui vous conduis.
Ie ne ſçaurois...	Je ne saurais…
Corbleu, mon gendre, ne m'échauffez pas la bile, ie me mettrois auec luy contre vous.	Corbleu, mon gendre, ne m’échauffez pas la bile, je me mettrais avec lui contre vous.
Allons.	Allons.
Laiſſez-vous gouuerner par moy.	Laissez-vous gouverner par moi.
Ah George Dandin.	Ah George Dandin.
Voſtre bonnet à la main le premier, Monſieur eſt Gentilhomme, & vous ne l'eſtes pas.	Votre bonnet à la main le premier, Monsieur est Gentilhomme, et vous ne l’êtes pas.
I’enrage.	J’enrage.
Repetez apres moy.	Répétez après moi.
Monſieur.	Monsieur.
Monſieur.	Monsieur.
Il voit que ſon gendre fait difficulté de luy obeyr.	Il voit que son gendre fait difficulté de lui obéir.
Ie vous demande pardon. Ah.	Je vous demande pardon. Ah.
Ie vous demande pardon.	Je vous demande pardon.
Des mauuaiſes penſées que i’ay euës de vous.	Des mauvaises pensées que j’ai eues de vous.
Des mauuaiſes penſées que i’ay euës de vous.	Des mauvaises pensées que j’ai eues de vous.
C’eſt que ie n’auois pas l’honneur de vous connoiſtre.	C’est que je n’avais pas l’honneur de vous connaître.
C’eſt que ie n’auois pas l’honneur de vous connoiſtre.	C’est que je n’avais pas l’honneur de vous connaître.
Et ie vous prie de croire.	Et je vous prie de croire.
Et ie vous prie de croire.	Et je vous prie de croire.
Que ie ſuis voſtre ſeruiteur.	Que je suis votre serviteur.
Voulez vous que ie ſois ſeruiteur d’vn homme qui me veut faire cocu?	Voulez-vous que je sois serviteur d’un homme qui me veut faire cocu?
il le menace encore.	il le menace encore.
Ah.	Ah.
Il ſuffit, Monſieur.	Il suffit, Monsieur.
Non, ie veux qu’il acheue, & que tout aille dans les formes.	Non, je veux qu’il achève, et que tout aille dans les formes.
Que ie ſuis voſtre ſeruiteur.	Que je suis votre serviteur.
Que ie ſuis voſtre ſeruiteur.	Que je suis votre serviteur.
Monſieur, ie ſuis le voſtre de tout mon cœur, & ie ne ſonge plus à ce qui s’eſt paſſé.	Monsieur, je suis le vôtre de tout mon cœur, et je ne songe plus à ce qui s’est passé.
Pour vous, Monſieur, ie vous donne le bonjour, & ſuis faſché du petit chagrin que vous auez eu.	Pour vous, Monsieur, je vous donne le bonjour, et suis fâché du petit chagrin que vous avez eu.
Ie vous baiſe les mains, &  quand il vous plaira ie vous donneray le diuertiſſement de courre vn liévre.	Je vous baise les mains, et quand il vous plaira je vous donnerai le divertissement de courre un lièvre.
C’eſt trop de grace que vous me faites.	C’est trop de grâce que vous me faites.
Voila, mon gendre, comme il faut pouſſer les choſes.	Voilà, mon gendre, comme il faut pousser les choses.
Adieu.	Adieu.
Sçachez que vous eſtes entré dans vne famille qui vous donnera de l’appuy, &  ne ſouffrira point que l'on vous faſſe aucun affront.	Sachez que vous êtes entré dans une famille qui vous donnera de l’appui, et ne souffrira point que l’on vous fasse aucun affront.
Ah que le...	Ah que le…
vous l’auez voulu, vous l'auez voulu, George Dandin, vous l’auez voulu, cela vous ſied fort bien, & vous voila ajuſté comme il faut, vous auez iuſtement ce que vous meritez.	vous l’avez voulu, vous l’avez voulu, George Dandin, vous l’avez voulu, cela vous sied fort bien, et vous voilà ajusté comme il faut, vous avez justement ce que vous méritez.
Allons il s’agit ſeulement de deſabufer le pere & la mere, & ie pourray trouuer peut- eſtre quelque moyen d'y reüſſir.	Allons il s’agit seulement de désabuser le père et la mère, et je pourrai trouver peut-être quelque moyen d’y réussir.
UVy i'ay bien deuiné qu'il falloit que cela vinſt de toy, & que tu l'euſſes dit à quelqu’vn qui l'ait raporté à noſtre Maiſtre.	OUi j’ai bien deviné qu’il fallait que cela vint de toi, et que tu l’eusses dit à quelqu’un qui l’ait rapporté à notre Maître.
Par ma foy ie n’en ay touché qu’vn petit mot en paſſant à vn homme, afin qu’il ne diſt point qu’il m’auoit veu ſortir, & il faut que les gens en ce pays-cy ſoient de grands babillards.	Par ma foi je n’en ai touché qu’un petit mot en passant à un homme, afin qu’il ne dît point qu’il m’avait vu sortir, et il faut que les gens en ce pays-ci soient de grands babillards.
Vrayment ce Monſieur le Vicomte a bien choiſi ſon monde que de te prendre pour ſon Ambaſſadeur, & il s’eſt allé ſeruir là d’vn homme bien chanceux.	Vraiment ce Monsieur le Vicomte a bien choisi son monde que de te prendre pour son Ambassadeur, et il s’est allé servir là d’un homme bien chanceux.
Va, vne autre fois ie ſeray plus fin, & ie prendray mieux garde à moy.	Va, une autre fois je serai plus fin, et je prendrai mieux garde à moi.
Oüy, oüy, il ſera temps.	Oui, oui, il sera temps.
Ne parlons plus de cela, écoute.	Ne parlons plus de cela, écoute.
Que veux tu que i'écoute?	Que veux tu que j’écoute?
Tourne vn peu ton viſage deuers moy.	Tourne un peu ton visage devers moi.
Hé bien qu’eſt-ce?	Hé bien qu’est-ce?
Claudine.	Claudine.
Quoy?	Quoi?
Hé la, ne ſçais-tu pas bien ce que ie veux dire?	Hé la, ne sais-tu pas bien ce que je veux dire?
Non.	Non.
Morgué je t’aime.	Morgué je t’aime.
Tout de bon?	Tout de bon?
Oüy le diable m’emporte, tu me peux croire, puis que i’en iure.	Oui le diable m’emporte, tu me peux croire, puisque j’en jure.
A la bonne heure.	À la bonne heure.
Ie me ſens tout triboüiller le coeur quand ie te regarde.	Je me sens tout tribouiller le cœur quand je te regarde.
Ie m’en réjoüis.	Je m’en réjouis.
Comment eſt-ce que tu fais pour eſtre ſi jolie.	Comment est-ce que tu fais pour être si jolie.
Ie fais comme font les autres.	Je fais comme font les autres.
Vois tu, il ne faut point tant de beurre pour faire vn quarteron.	Vois-tu, il ne faut point tant de beurre pour faire un quarteron.
Si tu veux tu ſeras ma femme, ie ſeray ton mary, & nous ſerons tous deux mary & femme.	Si tu veux tu seras ma femme, je serai ton mari, et nous serons tous deux mari et femme.
Tu ſerois peut- eſtre ialoux comme noſtre Maiſtre.	Tu serais peut-être jaloux comme notre Maître.
Point.	Point.
Pour moy ie hais les maris ſoupçonneux, & i’en veux vn qui ne s’épouuante de rien, vn ſi plein de confiance, & ſi ſeur de ma chaſteté, qu’il me viſt ſans inquietude au milieu de trente hommes.	Pour moi je hais les maris soupçonneux, et j’en veux un qui ne s’épouvante de rien, un si plein de confiance, et si sûr de ma chasteté, qu’il me vît sans inquiétude au milieu de trente hommes.
Hé bien, ie ſeray tout comme cela.	Hé bien, je serai tout comme cela.
C’eſt la plus ſotte choſe du monde que de ſe deffier d'vne femme, & de la tourmenter.	C’est la plus sotte chose du monde que de se défier d'une femme, et de la tourmenter.
La verité de l’affaire eſt qu’on n’y gagne rien de bon.	La vérité de l’affaire est qu’on n’y gagne rien de bon.
cela nous fait ſonger à mal, & ce ſont ſouuent les marys qui auec leurs vacarmes ſe font eux-meſmes ce qu’ils ſont.	cela nous fait songer à mal, et ce sont souvent les maris qui avec leurs vacarmes se font eux-mêmes ce qu’ils sont.
Hé bien, ie te donneray la liberté de faire tout ce qu’il te plaira.	Hé bien, je te donnerai la liberté de faire tout ce qu’il te plaira.
Voila comme il faut faire pour n’eſtre point trompé.	Voilà comme il faut faire pour n’être point trompé.
Lors qu’vn mary ſe met à noſtre diſcretion, nous ne prenons de liberté que ce qu'il nous en faut, & il en eſt comme auec ceux qui nous ouurent leur bource &  nous diſent, prenez.	Lors qu’un mari se met à notre discrétion, nous ne prenons de liberté que ce qu’il nous en faut, et il en est comme avec ceux qui nous ouvrent leur bourse et nous disent, prenez.
Nous en vſons honneſtement, &  nous nous contentons de la raiſon.	Nous en usons honnêtement, et nous nous contentons de la raison.
Mais ceux qui nous chicanent, nous nous efforçons de les tondre, & nous ne les épargnons point.	Mais ceux qui nous chicanent, nous nous efforçons de les tondre, et nous ne les épargnons point.
Va.	Va.
Ie feray de ceux qui ouurent leur bource, & tu n’as qu’à te marier auec moy.	Je ferai de ceux qui ouvrent leur bourse, et tu n’as qu’à te marier avec moi.
Hé bien bien nous verrons.	Hé bien bien nous verrons.
Vien donc icy, Claudine.	Viens donc ici, Claudine.
Que veux-tu?	Que veux-tu?
Viens, te dis je.	Viens, te dis-je.
Ah!	Ah!
doucement.	doucement.
Ie n'aime pas les patineurs.	Je n’aime pas les patineurs.
Eh vn petit brin d’amitié.	Eh un petit brin d’amitié.
Laiſſe moy là, te dis-je, ie n'entends pas raillerie.	Laisse-moi là, te dis-je, je n’entends pas raillerie.
Claudine.	Claudine.
Ahy.	Ahi.
Ah!	Ah!
que tu es rude à pauures gens.	que tu es rude à pauvres gens.
Fy, que cela eſt mal honneſte de refuſer les perſonnes.	Fi, que cela est malhonnête de refuser les personnes.
N'as-tu point de honte d’eſtre belle, & de ne vouloir pas qu’on te careſſe?	N’as-tu point de honte d’être belle, et de ne vouloir pas qu’on te caresse?
Eh-là.	Eh là.
Ie te donneray ſur le nez.	Je te donnerai sur le nez.
Oh la farouche.	Oh la farouche.
La ſauuage.	La sauvage.
Fy poüa la vilaine qui eſt cruelle.	Fi poua la vilaine qui est cruelle.
Tu t'émancipes trop.	Tu t’émancipes trop.
Qu'eſt-ce que cela te couſteroit de me laiſſer vn peu faire.	Qu’est-ce que cela te coûterait de me laisser un peu faire.
Il faut que tu te donnes patience.	Il faut que tu te donnes patience.
Vn petit baiſer ſeulement en rabattant ſur noſtre mariage.	Un petit baiser seulement en rabattant sur notre mariage.
Ie ſuis voſtre Seruante.	Je suis votre Servante.
Claudine, ie t’en prie, ſur l'et-tant moins.	Claudine, je t’en prie, sur l’et-tant moins.
Eh que nenny.	Eh que nenni.
I'y ay deſia eſté attrappée.	J’y ai déjà été attrapée.
Adieu.	Adieu.
Va-t'en, & dis à Monſieur le Vicomte que i’auray ſoin de rendre ſon billet.	Va-t’en, et dis à Monsieur le Vicomte que j’aurai soin de rendre son billet.
Adieu beauté rude aſniere.	Adieu beauté rude ânière.
Le mot eſt amoureux.	Le mot est amoureux.
Adieu rocher, caillou, pierre de taille, & tout ce qu’il y a de plus dur au monde.	Adieu rocher, caillou, pierre de taille, et tout ce qu’il y a de plus dur au monde.
Ie vais remettre aux mains de ma Maiſtreſſe...	Je vais remettre aux mains de ma Maîtresse…
Mais la voicy auec ſon Mary, éloignons-nous, & attendons qu'elle ſoit ſeule.	Mais la voici avec son Mari, éloignons-nous, et attendons qu'elle soit seule.
NOn non, on ne m’abuſe pas auec tant de facilité, & ie ne ſuis que trop certain que le rapport que l’on m’a fait eſt veritable.	NOn non, on ne m’abuse pas avec tant de facilité, et je ne suis que trop certain que le rapport que l’on m’a fait est véritable.
I'ay de meilleurs yeux qu’on ne penſe, & voſtre galimatias ne m’a point tantoſt ébloüy.	J’ai de meilleurs yeux qu’on ne pense, et votre galimatias ne m’a point tantôt ébloui.
Ah la voila.	Ah la voilà.
Mais le mary eſt auec elle.	Mais le mari est avec elle.
Au trauers de toutes vos grimaces, i’ay veu la verité de ce que l’on m’a dit, & le peu de reſpect que vous auez pour le nœud qui nous ioint.	Au travers de toutes vos grimaces, j’ai vu la vérité de ce que l’on m’a dit, et le peu de respect que vous avez pour le nœud qui nous joint.
Mon Dieu laiſſez là voſtre reuerence, ce n’eſt pas de ces ſortes de reſpect dont ie vous parle, & vous n’auez que faire de vous moquer.	Mon Dieu laissez là votre révérence, ce n’est pas de ces sortes de respect dont je vous parle, et vous n’avez que faire de vous moquer.
Moy, me moquer!	Moi, me moquer!
en aucune façon.	en aucune façon.
Ie ſçay voſtre penſée, & connois...	Je sais votre pensée, et connais…
Encore?	Encore?
ah ne raillons pas dauantage!	ah ne raillons pas davantage!
ie n’ignore pas qu'à cauſe de voſtre nobleſſe vous me tenez fort au deſſous de vous, & le reſpect que ie vous veux dire ne regarde point ma perſonne.	je n’ignore pas qu’à cause de votre noblesse vous me tenez fort au dessous de vous, et le respect que je vous veux dire ne regarde point ma personne.
I’entens parler de celuy que vous deuez à des nœuds auſſi venerables que le ſont ceux du mariage.	J’entends parler de celui que vous devez à des nœuds aussi vénérables que le sont ceux du mariage.
Il ne faut point leuer les épaules, & ie ne dis point de ſottiſes.	Il ne faut point lever les épaules, et je ne dis point de sottises.
Qui ſonge à leuer les épaules?	Qui songe à lever les épaules?
Mon Dieu nous voyons clair.	Mon Dieu nous voyons clair.
Ie vous dis encore vne fois que le mariage eſt vne chaiſne à laquelle on doit porter toute ſorte de reſpect, & que c’eſt fort mal fait à vous d'en vſer comme vous faites.	Je vous dis encore une fois que le mariage est une chaîne à laquelle on doit porter toute sorte de respect, et que c’est fort mal fait à vous d’en user comme vous faites.
Oüy oüy mal fait à vous.	Oui oui mal fait à vous.
& vous n’auez que faire de hocher la teſte, & de me faire la grimace.	et vous n’avez que faire de hocher la tête, et de me faire la grimace.
Moy!	Moi!
ie ne ſçay ce que vous voulez dire.	je ne sais ce que vous voulez dire.
Ie le ſçay fort bien moy, &  vos mépris me ſont connus.	Je le sais fort bien moi, et vos mépris me sont connus.
Si ie ne ſuis pas né noble, au moins ſuis ie d’vne race où il n’y a point de reproche, &  la famille des Dandins...	Si je ne suis pas né noble, au moins suis-je d’une race où il n’y a point de reproche, et la famille des Dandins…
Derriere Angelique ſans eſtre apperceu de Dandin.	Derrière Angélique sans être aperçu de Dandin.
Vn moment d’entretien.	Un moment d’entretien.
Eh.	Eh.
Quoy?	Quoi?
Ie ne dis mot.	Je ne dis mot.
Le voila qui vient roder autour de vous.	Le voilà qui vient roder autour de vous.
Hé bien eſt-ce ma faute?	Hé bien est-ce ma faute?
Que voulez vous que i'y faſſe?	Que voulez-vous que j’y fasse?
Ie veux que vous y faſſiez ce que fait vne femme qui ne veut plaire qu'à ſon mary.	Je veux que vous y fassiez ce que fait une femme qui ne veut plaire qu’à son mari.
Quoy qu’on en puiſſe dire, les Galans n’obſedent iamais que quand on le veut bien, il y a vn certain air doucereux qui les attire ainſi que le miel fait les mouches, &  les honneſtes femmes ont des manieres qui les ſcauent chaſſer d’abord.	Quoi qu’on en puisse dire, les Galants n’obsèdent jamais que quand on le veut bien, il y a un certain air doucereux qui les attire ainsi que le miel fait les mouches, et les honnêtes femmes ont des manières qui les savent chasser d’abord.
Moy les chaſſer?	Moi les chasser?
& par quelle raiſon, ie ne me ſcandaliſe point qu’on me trouue bien faite, & cela me fait du plaiſir.	et par quelle raison, je ne me scandalise point qu’on me trouve bien faite, et cela me fait du plaisir.
Oüy.	Oui.
Mais quel perſonnage voulez-vous que ioüe vn mary pendant cette galanterie?	Mais quel personnage voulez-vous que joue un mari pendant cette galanterie?
Le perſonnage d’vn honneſte homme qui eſt bien aiſe de voir ſa femme conſiderée.	Le personnage d’un honnête homme qui est bien aise de voir sa femme considérée.
Ie ſuis voſtre valet.	Je suis votre valet.
Ce n'eſt pas là mon conte, & les Dandins ne ſont point accouſtumez à cette mode-là.	Ce n’est pas là mon compte, et les Dandins ne sont point accoutumés à cette mode-là.
Oh les Dandins s’y accouſtumeront s’ils veulent.	Oh les Dandins s’y accoutumeront s’ils veulent.
Car pour moy ie vous declare que mon deſſein n'eſt pas de renoncer au monde, & de m’enterrer toute viue dans vn mary.	Car pour moi je vous déclare que mon dessein n’est pas de renoncer au monde, et de m’enterrer toute vive dans un mari.
Comment, parce qu’vn homme s’auiſe de nous épouſer, il faut d’abord que toutes choſes ſoient finies pour nous, & que nous rompions tout commerce auec les viuans?	Comment, parce qu’un homme s’avise de nous épouser, il faut d’abord que toutes choses soient finies pour nous, et que nous rompions tout commerce avec les vivants?
c’eſt vne choſe merueilleuſe que cette tyrannie de Meſſieurs les marys, & ie les trouue bons de vouloir qu’on ſoit morte à tous les diuertiſſemens, & qu’on ne viue que pour eux.	c’est une chose merveilleuse que cette tyrannie de Messieurs les maris, et je les trouve bons de vouloir qu’on soit morte à tous les divertissements, et qu’on ne vive que pour eux.
Ie me moque de cela, & ne veux point mourir ſi ieune.	Je me moque de cela, et ne veux point mourir si jeune.
C’eſt ainſi que vous ſatisfaites aux engagemens de la foy que vous m’auez donnée publiquement.	C’est ainsi que vous satisfaites aux engagements de la foi que vous m’avez donnée publiquement.
Moy?	Moi?
ie ne vous l’ay point donnée de bon cœur, &  vous me l’auez arrachée.	je ne vous l’ai point donnée de bon cœur, et vous me l’avez arrachée.
M’auez-vous auant le mariage demandé mon conſentement, & ſi ie voulois bien de vous?	M’avez-vous avant le mariage demandé mon consentement, et si je voulais bien de vous?
Vous n’auez conſulté pour cela que mon pere, & ma mere, ce ſont eux proprement qui vous ont épouſé, & c'eſt pourquoy vous ferez bien de vous plaindre touſiours à eux des torts que l’on pourra vous faire.	Vous n’avez consulté pour cela que mon père, et ma mère, ce sont eux proprement qui vous ont épousé, et c’est pourquoi vous ferez bien de vous plaindre toujours à eux des torts que l’on pourra vous faire.
Pour moy qui ne vous ay point dit de vous marier auec moy, & que vous auez priſe ſans conſulter mes ſentimens, ie pretens n'eſtre point obligée à me ſoumettre en eſclaue à vos volontez, & ie veux iouyr, s’il vous plaiſt, de quelque nombre de beaux iours que m’offre la ieuneſſe; prendre les douces libertez, que que l'âge me permet, voir vn peu le beau monde, &  gouſter le plaiſir de m’ouyr dire des douceurs.	Pour moi qui ne vous ai point dit de vous marier avec moi, et que vous avez prise sans consulter mes sentiments, je prétends n’être point obligée à me soumettre en esclave à vos volontés, et je veux jouir, s’il vous plaît, de quelque nombre de beaux jours que m’offre la jeunesse; prendre les douces libertés, que que l’âge me permet, voir un peu le beau monde, et goûter le plaisir de m’ouïr dire des douceurs.
Preparez- vous y pour voſtre punition, & rendez graces au Ciel de ce que ie ne ſuis pas capable de quelque choſe de pis.	Préparez-vous y pour votre punition, et rendez grâces au Ciel de ce que je ne suis pas capable de quelque chose de pis.
Oüy!	Oui!
c’eſt ainſi que vous le prenez.	c’est ainsi que vous le prenez.
Ie ſuis voſtre mary, & ie vous dy que ie n’entens pas cela.	Je suis votre mari, et je vous dis que je n’entends pas cela.
Moy ie ſuis voſtre femme, & ie vous dy que ie l’entens.	Moi je suis votre femme, et je vous dis que je l’entends.
Il me prend des tentations d’accommoder tout ſon viſage à la compoſte, & le mettre en eſtat de ne plaire de ſa vie aux diſeurs de fleurettes. Ah!	Il me prend des tentations d’accommoder tout son visage à la compote, et le mettre en état de ne plaire de sa vie aux diseurs de fleurettes. Ah!
allons, George Dandin, ie ne pourrois me retenir, & il vaut mieux quitter la place.	allons, George Dandin, je ne pourrais me retenir, et il vaut mieux quitter la place.
I'Auois, Madame, impatience qu’il s’en allaſt pour vous rendre ce mot de la part que vous ſçauez.	J’Avais, Madame, impatience qu’il s’en allât pour vous rendre ce mot de la part que vous savez.
Voyons.	Voyons.
A ce que ie puis remarquer, ce qu’on luy dit ne luy déplaiſt pas trop.	À ce que je puis remarquer, ce qu’on lui dit ne lui déplaît pas trop.
Ah Claudine que ce billet s’explique d’vne façon galante!	Ah Claudine que ce billet s’explique d’une façon galante!
que dans tous leurs diſcours, & dans toutes leurs actions les gens de Cour ont vn air agreable, & qu’eſt-ce que c’eſt aupres d’eux que nos gens de Prouince?	que dans tous leurs discours, et dans toutes leurs actions les gens de Cour ont un air agréable, et qu’est-ce que c’est auprès d’eux que nos gens de Province?
Ie croy qu’apres les auoir veus, les Dandins ne vous plaiſent gueres.	Je crois qu’après les avoir vus, les Dandins ne vous plaisent guère.
Demeure icy, ie m’en vais faire la réponſe.	Demeure ici, je m’en vais faire la réponse.
Ie n'ay pas beſoin, que ie penſe, de luy recommander de la faire agreable.	Je n’ai pas besoin, que je pense, de lui recommander de la faire agréable.
Mais voicy...	Mais voici…
VRayment, Monſieur, vous auez pris là vn habile meſſager.	VRaiment, Monsieur, vous avez pris là un habile messager.
Ie n’ay pas oſé enuoyer de mes gens, mais, ma pauure Claudine, il faut que ie te recompenſe des bons offices que ie ſçay que tu m’as rendus.	Je n’ai pas osé envoyer de mes gens, mais, ma pauvre Claudine, il faut que je te récompense des bons offices que je sais que tu m’as rendus.
Eh!	Eh!
Monſieur il n'eſt pas neceſſaire.	Monsieur il n’est pas nécessaire.
Non, Monſieur, vous n’auez que faire de vous donner cette peine là, & ie vous rends ſeruice, parce que vous le meritez, & que ie me ſens au cœur de l’inclination pour vous.	Non, Monsieur, vous n’avez que faire de vous donner cette peine là, et je vous rends service, parce que vous le méritez, et que je me sens au cœur de l’inclination pour vous.
Ie te ſuis obligé.	Je te suis obligé.
Puis que nous ſerons mariez, donne moy cela que ie le mette auec le mien.	Puisque nous serons mariés, donne-moi cela que je le mette avec le mien.
Ie te le garde auſſi bien que le baiſer.	Je te le garde aussi bien que le baiser.
Dy-moy, as-tu rendu mon billet à ta belle Maiſtreſſe?	Dis-moi, as-tu rendu mon billet à ta belle Maîtresse?
Oüy, elle eſt allée y répondre.	Oui, elle est allée y répondre.
Mais, Claudine, n’y a-t’il pas moyen que ie la puiſſe entretenir?	Mais, Claudine, n’y a-t-il pas moyen que je la puisse entretenir?
Oüy, venez auec moy, ie vous feray parler à elle.	Oui, venez avec moi, je vous ferai parler à elle.
Mais le trouuera-t’elle bon, & n’y a-t’il rien à riſquer?	Mais le trouvera-t-elle bon, et n’y a-t-il rien à risquer?
Non non, ſon mary n’eſt pas au logis & puis, ce n’eſt pas luy qu'elle a le plus à ménager, c’eſt ſon pere & ſa mere, & pourueu qu’ils ſoient preuenus, tout le reſte n’eſt point à craindre.	Non non, son mari n’est pas au logis et puis, ce n’est pas lui qu’elle a le plus à ménager, c’est son père et sa mère, et pourvu qu’ils soient prévenus, tout le reste n’est point à craindre.
Ie m’abandonne à ta conduite.	Je m’abandonne à ta conduite.
Teſtiguenne que i'auray là vne habile femme, elle a de l’eſprit comme quatre.	Testiguenne que j’aurai là une habile femme, elle a de l’esprit comme quatre.
VOicy mon homme de tantoſt.	VOici mon homme de tantôt.
Pluſt au Ciel qu’il puſt ſe reſoudre à vouloir rendre témoignage au pere & à la mere de ce qu’ils ne veulent point croire.	Plût au Ciel qu’il pût se résoudre à vouloir rendre témoignage au père et à la mère de ce qu’ils ne veulent point croire.
Ah vous voila, Monſieur le babillard, à qui i’auois tant recommandé de ne point parler, & qui me l’aviez tant promis.	Ah vous voilà, Monsieur le babillard, à qui j’avais tant recommandé de ne point parler, et qui me l’aviez tant promis.
Vous eſtes donc vn cauſeur, & vous allez redire ce que l’on vous dit en ſecret.	Vous êtes donc un causeur, et vous allez redire ce que l’on vous dit en secret.
Moy?	Moi?
Ouy.	Oui.
Vous auez eſté tout raporter au mary.	Vous avez été tout rapporter au mari.
Et vous eſtes cauſe qu’il a fait du vacarme.	Et vous êtes cause qu’il a fait du vacarme.
Ie ſuis bien ayſe de ſçauoir que vous auez de la langue, & cela m’apprendra à ne vous plus rien dire.	Je suis bien aise de savoir que vous avez de la langue, et cela m’apprendra à ne vous plus rien dire.
Ecoute, mon amy.	Écoute, mon ami.
Si vous n’auiez point babillé, ie vous aurois conté ce qui ſe paſſe à cette heure, mais pour voſtre punition vous ne ſçaurez rien du tout.	Si vous n’aviez point babillé, je vous aurais conté ce qui se passe à cette heure, mais pour votre punition vous ne saurez rien du tout.
Comment.	Comment.
Qu’eſt-ce qui ſe paſſe?	Qu’est-ce qui se passe?
Rien, rien.	Rien, rien.
Voila ce que c’eſt d’auoir cauſé, vous n’en taſterez plus, & ie vous laiſſe ſur la bonne bouche.	Voilà ce que c’est d’avoir causé, vous n’en tâterez plus, et je vous laisse sur la bonne bouche.
Arreſte vn peu.	Arrête un peu.
Point.	Point.
Ie ne te veux dire qu’vn mot.	Je ne te veux dire qu’un mot.
Nennin, nennin, vous auez enuie de me tirer les vers du nez.	Nennin, nennin, vous avez envie de me tirer les vers du nez.
Non, ce n'eſt pas cela.	Non, ce n’est pas cela.
Eh quelque ſot.	Eh quelque sot.
Ie vous vois venir.	Je vous vois venir.
C’eſt autre choſe.	C’est autre chose.
Ecoute.	Écoute.
Point d’affaire.	Point d’affaire.
Vous voudriez que ie vous diſſe que Monſieur le Vicomte vient de donner de l’argent à Claudine, & qu’elle l’a mené chez ſa Maiſtreſſe.	Vous voudriez que je vous disse que Monsieur le Vicomte vient de donner de l’argent à Claudine, et qu’elle l’a mené chez sa Maîtresse.
Mais ie ne ſuis pas ſi beſte.	Mais je ne suis pas si bête.
De grace.	De grâce.
Non.	Non.
Ie te donneray...	Je te donnerai…
Tarare.	Tarare.
JE n’ay pû me ſeruir auec cét innocent de la penſée que i’auois.	JE n’ai pu me servir avec cet innocent de la pensée que j’avais.
Mais le nouuel auis qui luy eſt échapé feroit la meſme choſe, & ſi le Galant eſt chez moy, ce ſeroit pour auoir raiſon aux yeux du pere & de la mere, & le conuaincre pleinement de l’effronterie de leur fille.	Mais le nouvel avis qui lui est échappé ferait la même chose, et si le Galant est chez moi, ce serait pour avoir raison aux yeux du père et de la mère, et le convaincre pleinement de l’effronterie de leur fille.
Le mal de tout cecy c'eſt que ie ne ſçay comment faire pour profiter d’vn tel auis.	Le mal de tout ceci c’est que je ne sais comment faire pour profiter d’un tel avis.
Si ie rentre chez moy, ie feray éuader le droſle, & quelque choſe que ie puiſſe voir moy-meſme de mon des-honneur, ie n’en ſeray point creu a mon ſerment, & l’on me dira que ie reſve.	Si je rentre chez moi, je ferai évader le drôle, et quelque chose que je puisse voir moi-même de mon déshonneur, je n’en serai point cru à mon serment, et l’on me dira que je rêve.
Si d’autre part ie vay querir beau pere & belle-mere ſans eſtre ſeur de trouuer chez moy le Galant, ce ſera la meſme choſe, & ie retomberay dans l’incõuenient de tantoſt.	Si d’autre part je vai quérir beau-père et belle-mère sans être sûr de trouver chez moi le Galant, ce sera la même chose, et je retomberai dans l’inconvénient de tantôt.
Pourrois-ie point m’éclaircir doucement s’il y eſt encore?	Pourrais-je point m’éclaircir doucement s’il y est encore?
Ah Ciel!	Ah Ciel!
il n’en faut plus douter & ie viens de l’aperceuoir par le trou de la porte.	il n’en faut plus douter et je viens de l’apercevoir par le trou de la porte.
Le ſort me donne icy dequoy confondre ma partie, & pour acheuer l’auanture il fait venir à point nommé les Iuges dont i’auois beſoin.	Le sort me donne ici de quoi confondre ma partie, et pour achever l’aventure il fait venir à point nommé les Juges dont j’avais besoin.
ENfin vous ne m’auez pas voulu croire tantoſt, &  voſtre fille l’a emporté ſur moy.	ENfin vous ne m’avez pas voulu croire tantôt, et votre fille l’a emporté sur moi.
Mais i’ay en main dequoy vous faire voir comme elle m’accommode, & Dieu mercy mon des-honneur eſt ſi clair maintenant, que vous n’en pourrez plus douter.	Mais j’ai en main de quoi vous faire voir comme elle m’accommode, et Dieu merci mon déshonneur est si clair maintenant, que vous n’en pourrez plus douter.
Comment, mon Gendre, vous en eſtes encore là deſſus?	Comment, mon Gendre, vous en êtes encore là-dessus?
Ouy i’y ſuis, & iamais ie n’eus tant de ſuiet d’y eſtre.	Oui j’y suis, et jamais je n’eus tant de sujet d’y être.
Vous nous venez encore étourdir la teſte.	Vous nous venez encore étourdir la tête.
Ouy, Madame, & l’on fait bien pis à la mienne.	Oui, Madame, et l’on fait bien pis à la mienne.
Ne vous laſſez-vous point de vous rendre importun?	Ne vous lassez-vous point de vous rendre importun?
Non.	Non.
Mais ie me laſſe fort d’eſtre pris pour dupe.	Mais je me lasse fort d’être pris pour dupe.
Ne voulez vous point vous defaire de vos penſées extrauagantes?	Ne voulez-vous point vous défaire de vos pensées extravagantes?
Non, Madame, mais ie voudrois bien me defaire d’vne femme qui me des-honore.	Non, Madame, mais je voudrais bien me défaire d’une femme qui me déshonore.
Iour de Dieu, noſtre gendre, apprenez à parler.	Jour de Dieu, notre gendre, apprenez à parler.
Corbleu cherchez des termes moins offençans que ceux-là.	Corbleu cherchez des termes moins offensants que ceux-là.
Marchand qui perd ne peut rire.	Marchand qui perd ne peut rire.
Souuenez-vous que vous auez épouſé vne Demoiſelle.	Souvenez-vous que vous avez épousé une Demoiselle.
Ie m'en ſouuiens aſſez, &  ne m’en ſouuiendray que trop.	Je m’en souviens assez, et ne m’en souviendrai que trop.
Si vous vous en ſouuenez, ſongez donc à parler d’elle auec plus de reſpect.	Si vous vous en souvenez, songez donc à parler d’elle avec plus de respect.
Mais que ne ſonge-t'elle plutoſt à me traitter plus honneſtement?	Mais que ne songe-t-elle plutôt à me traiter plus honnêtement?
Quoy parce qu'elle eſt Demoiſelle, il faut qu’elle ait la liberté de me faire ce qui luy plaiſt, ſans que i’oſe ſouffler?	Quoi parce qu'elle est Demoiselle, il faut qu’elle ait la liberté de me faire ce qui lui plaît, sans que j’ose souffler?
Qu’auez vous donc, & que pouuez-vous dire?	Qu’avez-vous donc, et que pouvez-vous dire?
n’auez-vous pas veu ce matin qu'elle s’eſt deffenduë de connoiſtre celuy dont vous m’eſtiez venu parler?	n’avez-vous pas vu ce matin qu’elle s’est défendue de connaître celui dont vous m’étiez venu parler?
Ouy.	Oui.
Mais vous, que pourrez-vous dire, ſi ie vous fais voir maintenant que le Galant eſt auec elle?	Mais vous, que pourrez-vous dire, si je vous fais voir maintenant que le Galant est avec elle?
Auec elle?	Avec elle?
Ouy auec elle, & dans ma maiſon?	Oui avec elle, et dans ma maison?
Dans voſtre maiſon?	Dans votre maison?
Ouy.	Oui.
Dans ma propre maiſon.	Dans ma propre maison.
Si cela eſt, nous ſerons pour vous contr’elle.	Si cela est, nous serons pour vous contre elle.
Ouy.	Oui.
L’honneur de noſtre famille nous eſt plus cher que toute choſe, & ſi vous dites vray, nous la renoncerons pour noſtre ſang, & l’abandonnerons à voſtre colere.	L’honneur de notre famille nous est plus cher que toute chose, et si vous dites vrai, nous la renoncerons pour notre sang, et l’abandonnerons à votre colère.
Vous n’auez qu'à me ſuiure.	Vous n’avez qu’à me suivre.
Gardez de vous tromper.	Gardez de vous tromper.
N’allez pas faire comme tantoſt.	N’allez pas faire comme tantôt.
Mon Dieu, vous allez voir. Tenez.	Mon Dieu, vous allez voir. Tenez.
Ay-je menty?	Ai-je menti?
Dieu.	Dieu.
I’ay peur qu’on vous ſurprenne icy, &  i'ay quelques meſures à garder.	J’ai peur qu’on vous surprenne ici, et j’ai quelques mesures à garder.
Promettez-moy donc, Madame, que ie pourray vous parler cette nuit.	Promettez-moi donc, Madame, que je pourrai vous parler cette nuit.
I’y feray mes efforts.	J’y ferai mes efforts.
Approchons doucement par derriere, & taſchons de n’eſtre point veus.	Approchons doucement par derrière, et tâchons de n’être point vus.
Ah!	Ah!
Madame, tout eſt perdu.	Madame, tout est perdu.
Voila voſtre pere, & voſtre mere accompagnez de voſtre mary.	Voilà votre père, et votre mère accompagnés de votre mari.
Ah Ciel.	Ah Ciel.
Ne faites pas ſemblant de rien, & me laiſſez faire tous deux.	Ne faites pas semblant de rien, et me laissez faire tous deux.
Quoy vous oſez en vſer de la ſorte, apres l'affaire de tantoſt, & c'eſt ainſi que vous diſſimulez vos ſentimens?	Quoi vous osez en user de la sorte, après l’affaire de tantôt, et c’est ainsi que vous dissimulez vos sentiments?
On me vient raporter que vous auez de l’amour pour moy, & que vous faites des deſſeins de me ſolliciter.	On me vient rapporter que vous avez de l’amour pour moi, et que vous faites des desseins de me solliciter.
I’en témoigne mon dépit, & m'explique à vous clairement en preſence de tout le monde.	J’en témoigne mon dépit, et m’explique à vous clairement en présence de tout le monde.
Vous niez hautement la choſe, & me donnez parole de n’auoir aucune penſée de m’offencer, & cependant le meſme iour vous prenez la hardieſſe de venir chez moy me rendre viſite.	Vous niez hautement la chose, et me donnez parole de n’avoir aucune pensée de m’offenser, et cependant le même jour vous prenez la hardiesse de venir chez moi me rendre visite.
De me dire que vous m’aimez, & de me faire cent ſots contes pour me perſuader de répondre à vos extrauagances;	De me dire que vous m’aimez, et de me faire cent sots contes pour me persuader de répondre à vos extravagances;
comme ſi i’eſtois femme à violer la foy que i’ay donnée à vn mary, & m’éloigner jamais de la vertu que mes parens m’ont enſeignée.	comme si j’étais femme à violer la foi que j’ai donnée à un mari, et m’éloigner jamais de la vertu que mes parents m’ont enseignée.
Si mon pere ſçauoit cela, il vous apprendroit bien à tenter de ces entrepriſes.	Si mon père savait cela, il vous apprendrait bien à tenter de ces entreprises.
Mais vne honneſte femme n’ayme point les éclats.	Mais une honnête femme n’aime point les éclats.
Ie n’ay garde de luy en rien dire, & ie veux vous montrer que toute femme que ie ſuis, i’ay aſſez de courage pour me vanger moy-meſme des offences que l’on me fait.	Je n’ai garde de lui en rien dire, et je veux vous montrer que toute femme que je suis, j’ai assez de courage pour me venger moi-même des offenses que l’on me fait.
L’action que vous auez faite n'eſt pas d’vn Gentil homme, & ce 'eſt pas en Gentil homme auſſi que ie veux vous traitter.	L’action que vous avez faite n’est pas d’un Gentilhomme, et ce ’est pas en Gentilhomme aussi que je veux vous traiter.
Elle prend vn baton, & bat ſon mari au lieu de Clitandre qui ſe met entre deux.	Elle prend un bâton, et bat son mari au lieu de Clitandre qui se met entre deux.
Ah, ah, ah, ah, ah.	Ah, ah, ah, ah, ah.
Doucement.	Doucement.
Fort, Madame, frapez comme il faut.	Fort, Madame, frappez comme il faut.
S’il vous demeure quelque choſe ſur le cœur, ie ſuis pour vous répondre.	S’il vous demeure quelque chose sur le cœur, je suis pour vous répondre.
Aprenez à qui vous vous ioüez.	Apprenez à qui vous vous jouez.
Ah mon pere vous eſtes là.	Ah mon père vous êtes là.
Ouy, ma fille, & ie voy qu’en ſageſſe, & en courage tu te montres vn digne rejetton de ietton de la maiſon de Sotenuille.	Oui, ma fille, et je vois qu’en sagesse, et en courage tu te montres un digne rejeton de jeton de la maison de Sotenville.
Vien-ça, approche toy que ie t'embraſſe.	Viens ça, approche-toi que je t’embrasse.
Embraſſe moy auſſi ma fille.	Embrasse-moi aussi ma fille.
Las!	Las!
ie pleure de ioye, &  reconnois mon ſang aux choſes que tu viens de faire.	je pleure de joie, et reconnais mon sang aux choses que tu viens de faire.
Mon gendre, que vous deuez eſtre rauy & que cette auanture eſt pour vous pleine de douceurs.	Mon gendre, que vous devez être ravi et que cette aventure est pour vous pleine de douceurs.
Vous auiez vn iuſte ſuiet de vous allarmer, mais vos ſoupçons ſe trouuent diſſipez le plus auantageuſement du monde.	Vous aviez un juste sujet de vous alarmer, mais vos soupçons se trouvent dissipés le plus avantageusement du monde.
Sans doute, noſtre gendre, & vous deuez maintenant eſtre le plus content des hommes.	Sans doute, notre gendre, et vous devez maintenant être le plus content des hommes.
Aſſeurément.	Assurément.
Voila vne femme celle-là, vous eſtes trop heureux de l’auoir, &  vous deuriez baiſer les pas où elle paſſe.	Voilà une femme celle-là, vous êtes trop heureux de l’avoir, et vous devriez baiser les pas où elle passe.
Euh traiſtreſſe.	Euh traîtresse.
Qu'eſt ce, mon gendre?	Qu’est ce, mon gendre?
Que ne remerciez vous vn peu voſtre femme, de l’amitié que vous voyez qu'elle montre pour vous?	Que ne remerciez-vous un peu votre femme, de l’amitié que vous voyez qu’elle montre pour vous?
Non non, mon pere, il n’eſt pas neceſſaire.	Non non, mon père, il n’est pas nécessaire.
Il ne m’a aucune obligation de ce qu’il vient de voir, & tout ce que i’en fais n’eſt que pour l’amour de moy-meſme.	Il ne m’a aucune obligation de ce qu’il vient de voir, et tout ce que j’en fais n’est que pour l’amour de moi-même.
Où allez vous, ma fille?	Où allez-vous, ma fille?
Ie me retire, mon pere, pour ne me voir point obligée à receuoir ſes complimens.	Je me retire, mon père, pour ne me voir point obligée à recevoir ses compliments.
Elle a raiſon d’eſtre en colere.	Elle a raison d’être en colère.
C’eſt vne femme qui merite d’eſtre adorée, & vous ne la traittez pas comme vous deuriez.	C’est une femme qui mérite d’être adorée, et vous ne la traitez pas comme vous devriez.
Scelerate.	Scélérate.
C’eſt vn petit reſſentiment de l’affaire de tantoſt, & cela ſe paſſera auec vn peu de careſſe que vous luy ferez. Adieu, mon gendre, vous voila en eſtat de ne vous plus inquieter.	C’est un petit ressentiment de l’affaire de tantôt, et cela se passera avec un peu de caresse que vous lui ferez. Adieu, mon gendre, vous voilà en état de ne vous plus inquiéter.
Allez vous en faire la paix enſemble, & taſchez de l’apaiſer par des excuſes de voſtre emportement.	Allez-vous-en faire la paix ensemble, et tâchez de l’apaiser par des excuses de votre emportement.
Vous deuez conſiderer que c’eſt vne ieune fille éleuée à la vertu, & qui n’eſt point accouſtumée à ſe voir ſoupçonner d’aucune vilaine action.	Vous devez considérer que c’est une jeune fille élevée à la vertu, et qui n’est point accoutumée à se voir soupçonner d’aucune vilaine action.
Adieu.	Adieu.
Ie ſuis rauie de voir vos deſordres finis & des tranſports de ioye que vous doit donner ſa conduite.	Je suis ravie de voir vos désordres finis et des transports de joie que vous doit donner sa conduite.
Ie ne dis mot.	Je ne dis mot.
Car ie ne gagnerois rien à parler, & iamais il ne s’eſt rien veu d’égal à ma diſgrace, Ouy, i’admire mon mal-heur, & la ſubtile adreſſe de ma carogne de femme pour ſe donner touſiours raiſon, & me faire auoir tort.	Car je ne gagnerais rien à parler, et jamais il ne s’est rien vu d’égal à ma disgrâce, Oui, j’admire mon malheur, et la subtile adresse de ma carogne de femme pour se donner toujours raison, et me faire avoir tort.
Eſt-il poſſible que toujours i'auray du deſſous auec elle, que les apparences toujours tourneront contre moy, & que ie ne paruiendray point à conuaincre mon effrontee?	Est-il possible que toujours j’aurai du dessous avec elle, que les apparences toujours tourneront contre moi, et que je ne parviendrai point à convaincre mon effrontée?
ô Ciel!	ô Ciel!
ſeconde mes deſſeins, & m’accorde la grace de faire voir aux gens que l’on me deshonore.	seconde mes desseins, et m’accorde la grâce de faire voir aux gens que l’on me déshonore.
LA nuit eſt auancée, &  i’ay peur qu’il ne ſoit trop tard.	LA nuit est avancée, et j’ai peur qu’il ne soit trop tard.
Ie ne voy point à me conduire.	Je ne vois point à me conduire.
Lubin.	Lubin.
Monſieur?	Monsieur?
Eſt-ce par icy?	Est-ce par ici?
Ie penſe que ouy.	Je pense que oui.
Morgué voila vne ſotte nuit, d’eſtre ſi noire que cela.	Morgué voilà une sotte nuit, d’être si noire que cela.
Elle a tort aſſeurément.	Elle a tort assurément.
Mais ſi d’vn coſté elle nous empeſche de voir, elle empeſche de l’autre que nous ne ſoyons veus.	Mais si d’un côté elle nous empêche de voir, elle empêche de l’autre que nous ne soyons vus.
Vous auez raiſon.	Vous avez raison.
Elle n’a pas tant de tort.	Elle n’a pas tant de tort.
Ie voudrois bien ſçauoir, Monſieur, vous qui eſtes ſçauant, pourquoy il ne fait point iour la nuit?	Je voudrais bien savoir, Monsieur, vous qui êtes savant, pourquoi il ne fait point jour la nuit?
C’eſt vne grande queſtion, & qui eſt difficile.	C’est une grande question, et qui est difficile.
Tu es curieux, Lubin.	Tu es curieux, Lubin.
Ouy.	Oui.
Si i’auois eſtudié, i’aurois eſté ſonger à des choſes où on n’a iamais ſongé.	Si j’avais étudié, j’aurais été songer à des choses où on n’a jamais songé.
Ie le croy.	Je le crois.
Tu as la mine d’auoir l’eſprit ſubtil & pénétrant.	Tu as la mine d’avoir l’esprit subtil et pénétrant.
Cela eſt vray.	Cela est vrai.
Tenez.	Tenez.
I’explique du Latin, quoy que iamais ie ne l'aye appris, &  voyant l’autre iour ecrit ſur vne grande porte Collegium, ie deuinay que cela vouloit dire College.	J’explique du Latin, quoique jamais je ne l’aie appris, et voyant l’autre jour écrit sur une grande porte Collegium, je devinai que cela voulait dire Collège.
Cela eſt admirable!	Cela est admirable!
Tu ſçais donc lire, Lubin?	Tu sais donc lire, Lubin?
Ouy.	Oui.
Ie ſçay lire la lettre moulée, mais ie n’ay iamais ſceu apprendre à lire l’écriture.	Je sais lire la lettre moulée, mais je n’ai jamais su apprendre à lire l’écriture.
Nous voicy contre la maiſon.	Nous voici contre la maison.
C’eſt le ſignal que m'a donné Claudine.	C’est le signal que m’a donné Claudine.
Par ma foy c’eſt vne fille qui vaut de l’argent, & ie l’aime de tout mon cœur.	Par ma foi c’est une fille qui vaut de l’argent, et je l’aime de tout mon cœur.
Auſſi t’ay-ie amené auec moy pour l’entretenir.	Aussi t’ai-je amené avec moi pour l’entretenir.
Monſieur, ie vous ſuis...	Monsieur, je vous suis…
Chut.	Chut.
I’entens quelque bruit.	J’entends quelque bruit.
CLaudine.	CLaudine.
Hé bien?	Hé bien?
Laiſſe la porte entre-ouuerte.	Laisse la porte entr'ouverte.
Voila qui eſt fait.	Voilà qui est fait.
Ce ſont elles.	Ce sont elles.
St.	St.
St.	St.
St.	St.
St.	St.
A Claudine.	À Claudine.
Madame.	Madame.
A Lubin.	À Lubin.
Quoy.	Quoi.
A Angelique.	À Angélique.
Claudine.	Claudine.
Qu'eſt ce?	Qu’est ce?
A Claudine.	À Claudine.
Ah!	Ah!
Madame, que i'ay de ioye.	Madame, que j’ai de joie.
A Angelique.	À Angélique.
Claudine, ma pauure Claudine.	Claudine, ma pauvre Claudine.
A Clitandre.	À Clitandre.
Doucement, Monſieur.	Doucement, Monsieur.
A Lubin.	À Lubin.
Tout beau, Lubin.	Tout beau, Lubin.
Eſt-ce toy, Claudine?	Est-ce toi, Claudine?
Ouy.	Oui.
Eſt-ce vous, Madame?	Est-ce vous, Madame?
Ouy.	Oui.
Vous auez pris l’vne pour l’autre.	Vous avez pris l’une pour l’autre.
Ma foy la nuit on n’y voit goute.	Ma foi la nuit on n’y voit goute.
Eſt ce pas vous, Clitandre?	Est-ce pas vous, Clitandre?
Ouy, Madame.	Oui, Madame.
Mon mary ronfle comme il faut, & i’ay pris ce temps pour nous entretenir icy.	Mon mari ronfle comme il faut, et j’ai pris ce temps pour nous entretenir ici.
cherchons quelque lieu pour hous aſſeoir.	cherchons quelque lieu pour nous asseoir.
C'eſt fort bien auiſé.	C’est fort bien avisé.
Il vont s'aſſeoir au fond du theatre.	Il vont s’asseoir au fond du théâtre.
Claudine, où eſt-ce que tu es?	Claudine, où est-ce que tu es?
I'Ay entendu deſcendre ma femme, & ie me ſuis viſte habillé pour deſcendre apres elle.	J’Ai entendu descendre ma femme, et je me suis vite habillé pour descendre après elle.
Où peut-elle eſtre allée?	Où peut-elle être allée?
Seroit-elle ſortie?	Serait-elle sortie?
Il prend George Dandin pour Claudine.	Il prend George Dandin pour Claudine.
Où es-tu donc, Claudine?	Où es-tu donc, Claudine?
Ah te voila.	Ah te voilà.
Par ma foy ton Maiſtre eſt plaiſamment attrapé, & ie trouue cecy auſſi droſle que les coups de baſton de tantoſt dont on m’a fait recit.	Par ma foi ton Maître est plaisamment attrapé, et je trouve ceci aussi drôle que les coups de bâton de tantôt dont on m’a fait récit.
Ta Maiſtreſſe dit qu’il ronfle à cette heure comme tous les diantres, & il ne ſcait pas que Monſieur le Vicomte &  elle ſont enſemble pendant qu’il dort.	Ta Maîtresse dit qu’il ronfle à cette heure comme tous les diantres, et il ne sait pas que Monsieur le Vicomte et elle sont ensemble pendant qu’il dort.
Ie voudrois bien ſçauoir quel ſonge il fait maintenant.	Je voudrais bien savoir quel songe il fait maintenant.
Cela eſt tout a fait riſible!	Cela est tout à fait risible!
Dequoy s’auiſe-t’il auſſi d’eſtre ialoux de ſa femme, & de vouloir qu’elle ſoit à luy tout ſeul?	De quoi s’avise-t-il aussi d’être jaloux de sa femme, et de vouloir qu’elle soit à lui tout seul?
C’eſt vn impertinent, & Monſieur le Vicomte luy fait trop d’honneur.	C’est un impertinent, et Monsieur le Vicomte lui fait trop d’honneur.
Tu ne dis mot, Claudine.	Tu ne dis mot, Claudine.
Allons, ſuiuons les, & me donne ta petite menotte que ie la baiſe.	Allons, suivons-les, et me donne ta petite menotte que je la baise.
Ah que cela eſt doux.	Ah que cela est doux.
Il me ſemble que ie mange des confitures.	Il me semble que je mange des confitures.
Comme il baiſe la main de Dandin, Dandin la luy pouſſe rudement au viſage.	Comme il baise la main de Dandin, Dandin la lui pousse rudement au visage.
Tubleu, comme vous, y allez.	Tubleu, comme vous, y allez.
Voila vne petite menotte qui eſt vn peu bien rude.	Voilà une petite menotte qui est un peu bien rude.
Qui va là?	Qui va là?
Perſonne.	Personne.
Il fuit, & me laiſſe informé de la nouuelle perfidie de ma coquine.	Il fuit, et me laisse informé de la nouvelle perfidie de ma coquine.
Allons, il faut que ſans tarder, i'enuoye appeller ſon pere & ſa mere, &  que cette auanture me ſerue à me faire ſeparer d’elle.	Allons, il faut que sans tarder, j’envoie appeler son père et sa mère, et que cette aventure me serve à me faire séparer d’elle.
Hola, Colin, Colin.	Hola, Colin, Colin.
A la feneſtre.	À la fenêtre.
MOnſieur.	MOnsieur.
Allons, viſte, icy bas.	Allons, vite, ici bas.
En ſautant par la feneſtre. M’y voila.	En sautant par la fenêtre. M’y voilà.
On ne peut pas plus viſte.	On ne peut pas plus vite.
Tu es la?	Tu es là?
Ouy, Monſieur.	Oui, Monsieur.
Pendant qu'il les voit parler d'vn costé, Colin va de l’autre.	Pendant qu’il les voit parler d’un côté, Colin va de l’autre.
Doucement.	Doucement.
Parle bas.	Parle bas.
Ecoute.	Écoute.
Va-t’en chez mon beaupere, & ma belle mere, &  dy que ie les prie tres inſtamment de venir tout à l’heure icy.	Va-t-en chez mon beau-père, et ma belle mère, et dis que je les prie très instamment de venir tout à l’heure ici.
Entens tu?	Entends tu?
Eh?	Eh?
Colin, Colin.	Colin, Colin.
De l’autre coſté.	De l’autre côte.
Monſieur.	Monsieur.
Où diable es-tu?	Où diable es-tu?
Icy.	Ici.
Comme ils ſe vont tous deux chercher, l'vn paſſe d'vn coſté, & l’autre de l’autre.	Comme ils se vont tous deux chercher, l’un passe d’un côte, et l’autre de l’autre.
Peſte ſoit du maroufle qui s’éloigne de moy.	Peste soit du maroufle qui s’éloigne de moi.
Ie te dis que tu ailles de ce pas trouuer mon beau-pere, & ma belle-mere, & leur dire que ie les coniure de ſe rendre icy tout à l’heure.	Je te dis que tu ailles de ce pas trouver mon beau-père, et ma belle-mère, et leur dire que je les conjure de se rendre ici tout à l’heure.
M’entens- tu bien?	M’entends-tu bien?
Reſpon.	Responds.
Colin, Colin.	Colin, Colin.
De l'autre coſté.	De l’autre côté.
Monſieur.	Monsieur.
Voila vn pandard qui me fera enrager vien-t’en à moy.	Voilà un pandard qui me fera enrager viens-t-en à moi.
Ils ſe cognent.	Ils se cognent.
Ah le traiſtre!	Ah le traître!
il m’a eſtropié.	il m’a estropié.
Où eſt ce que tu es?	Où est-ce que tu es?
approche que ie te donne mille coups.	approche que je te donne mille coups.
Ie penſe qu’il me fuit.	Je pense qu’il me fuit.
Aſſeurément.	Assurément.
Veux-tu venir?	Veux-tu venir?
Nenny ma foy.	Nenni ma foi.
Vien, te dis-ie.	Viens, te dis-je.
Point, vous me voulez battre.	Point, vous me voulez battre.
Hé bien non.	Hé bien non.
Ie ne te feray rien.	Je ne te ferai rien.
Aſſeurément?	Assurément?
Ouy.	Oui.
Approche.	Approche.
Bon.	Bon.
Tu es bien heureux de ce que i’ay beſoin de toy.	Tu es bienheureux de ce que j’ai besoin de toi.
Va t’en viſte de ma part prier mon beau-pere & ma belle-mere de ſe rendre icy le plutoſt qu’ils pourront, & leur dis que c’eſt pour vne affaire de la derniere conſequence.	Va t’en vite de ma part prier mon beau-père et ma belle-mère de se rendre ici le plutôt qu’ils pourront, et leur dis que c’est pour une affaire de la dernière conséquence.
Et s’ils faiſoient quelque difficulté à cauſe de l’heure, ne manque pas de les preſſer, & de leur bien faire entendre qu’il eſt tres important qu’ils viennent, en quelque eſtat qu’ils ſoient.	Et s’ils faisaient quelque difficulté à cause de l’heure, ne manque pas de les presser, et de leur bien faire entendre qu’il est très important qu’ils viennent, en quelque état qu’ils soient.
Tu m’entens bien maintenant.	Tu m’entends bien maintenant.
Ouy, Monſieur.	Oui, Monsieur.
Va viſte, & revien de meſme.	Va vite, et reviens de même.
Et moy ie vay rentrer dans ma maiſon attendant que...	Et moi je vais rentrer dans ma maison attendant que…
Mais i’entens quelqu’vn.	Mais j’entends quelqu’un.
Ne ſeroit-ce point ma femme?	Ne serait-ce point ma femme?
Il faut que i'écoute, & me ſerue de l’obſcurité qu’il fait.	Il faut que j’écoute, et me serve de l’obscurité qu’il fait.
ADieu.	ADieu.
Il eſt temps de ſe retirer.	Il est temps de se retirer.
Quoy ſi toſt?	Quoi si tôt?
Nous nous ſommes aſſez entretenus.	Nous nous sommes assez entretenus.
Ah!	Ah!
Madame, puis-ie aſſez vous entretenir, & trouuer en ſi peu de temps toutes les paroles dont i’ay beſoin?	Madame, puis-je assez vous entretenir, et trouver en si peu de temps toutes les paroles dont j’ai besoin?
Il me faudroit des iournées entieres pour me bien expliquer à vous de tout ce que ie ſens;	Il me faudrait des journées entières pour me bien expliquer à vous de tout ce que je sens;
& ie ne vous ay pas dit encore la moindre partie de ce que i'ay à vous dire.	et je ne vous ai pas dit encore la moindre partie de ce que j’ai à vous dire.
Nous en écouterons vne autre fois dauantage.	Nous en écouterons une autre fois davantage.
Helas!	Hélas!
de quel coup me percez vous l'ame, lors que vous parlez de vous retirer, & auec combien de chagrins m’allez-vous laiſſer maintenant?	de quel coup me percez-vous l’âme, lorsque vous parlez de vous retirer, et avec combien de chagrins m’allez-vous laisser maintenant?
Nous trouuerons moyen de nous reuoir.	Nous trouverons moyen de nous revoir.
Ouy.	Oui.
Mais ie ſonge qu’en me quittant, vous allez trouuer vn mary.	Mais je songe qu’en me quittant, vous allez trouver un mari.
Cette penſée m’aſſaſſine, & les priuileges qu’ont les marys ſont des choſes cruelles pour vn Amant qui aime bien.	Cette pensée m’assassine, et les privilèges qu’ont les maris sont des choses cruelles pour un Amant qui aime bien.
Serez vous aſſez fort pour auoir auoir cette inquietude, &  penſez vous qu’on ſoit capable d’aimer de certains marys qu’il y a. On les prend, parce qu’on ne s’en peut deffendre, & que l’on dépend de parens qui n’ont des yeux que pour le bien, mais on ſçait leur rendre iuſtice, & l’on ſe mocque fort de les conſiderer au delà de ce qu’ils meritent.	Serez-vous assez fort pour avoir avoir cette inquiétude, et pensez-vous qu’on soit capable d’aimer de certains maris qu’il y a. On les prend, parce qu’on ne s’en peut défendre, et que l’on dépend de parents qui n’ont des yeux que pour le bien, mais on sait leur rendre justice, et l’on se moque fort de les considérer au delà de ce qu’ils méritent.
Voila nos carognes de femmes.	Voilà nos carognes de femmes.
Ah!	Ah!
qu'il faut auoüer que celuy qu’on vous a donné eſtoit peu digne de l’honneur qu’il a receu, & que c’eſt vne étrange choſe que l'aſſemblage qu’on a fait d’vne perſonne comme vous auec vn homme comme luy.	qu’il faut avouer que celui qu’on vous a donné était peu digne de l’honneur qu’il a reçu, et que c’est une étrange chose que l’assemblage qu’on a fait d’une personne comme vous avec un homme comme lui.
A part.	À part.
Pauures marys!	Pauvres maris!
Voila comme on vous traitte.	Voilà comme on vous traite.
Vous meritez ſans doute vne toute autre deſtinée, & le Ciel ne vous a point faite pour eſtre la femme d’vn payſan.	Vous méritez sans doute une toute autre destinée, et le Ciel ne vous a point faite pour être la femme d’un paysan.
Pluſt au Ciel!	Plût au Ciel!
fut elle la tienne, tu changerois bien de langage.	fut-elle la tienne, tu changerais bien de langage.
Rentrons.	Rentrons.
C’en eſt aſſez.	C’en est assez.
Il entre, & ferme la porte.	Il entre, et ferme la porte.
Madame, ſi vous auez à dire du mal de voſtre mary, depeſchez viſte, car il eſt tard.	Madame, si vous avez à dire du mal de votre mari, dépêchez vite, car il est tard.
Ah, Claudine, que tu es cruelle.	Ah, Claudine, que tu es cruelle.
Elle a raiſon.	Elle a raison.
Séparons-nous.	Séparons-nous.
Il faut donc s’y reſoudre puis que vous le voulez.	Il faut donc s’y résoudre puisque vous le voulez.
Mais au moins ie vous conjure de me plaindre vn peu, des méchans momens que ie vais paſſer.	Mais au moins je vous conjure de me plaindre un peu, des méchants moments que je vais passer.
Adieu.	Adieu.
Où es tu, Claudine que ie te donne le bonſoir.	Où es tu, Claudine que je te donne le bonsoir.
Va, va, ie le reçois de loin, & ie t’en renuoye autant.	Va, va, je le reçois de loin, et je t’en renvoie autant.
REntrons ſans faire de bruit.	REntrons sans faire de bruit.
La porte s’eſt fermée.	La porte s’est fermée.
I’ay le paſſe-par-tout.	J’ai le passe-partout.
Ouurez donc doucement.	Ouvrez donc doucement.
On a fermé en dedans, &  ie ne ſçay comment nous ferons.	On a fermé en dedans, et je ne sais comment nous ferons.
Appellez le garçon qui couche là.	Appelez le garçon qui couche là.
Colin, Colin, Colin.	Colin, Colin, Colin.
Mettant la teſte à ſa feneſtre.	Mettant la tête à sa fenêtre.
Colin, Colin?	Colin, Colin?
Ah ie vous y prens donc, Madame ma femme, & vous faites des eſcampatiuos pendant que ie dors.	Ah je vous y prends donc, Madame ma femme, et vous faites des escampativos pendant que je dors.
Ie ſuis bien ayſe de cela, & de vous voir dehors à l’heure qu’il eſt.	Je suis bien aise de cela, et de vous voir dehors à l’heure qu’il est.
Hé bien, quel grand mal eſt ce qu’il y a à prendre le frais de la nuit?	Hé bien, quel grand mal est-ce qu’il y a à prendre le frais de la nuit?
Ouy, ouy.	Oui, oui.
L’heure eſt bonne à prendre le frais.	L’heure est bonne à prendre le frais.
C’eſt bien plutoſt le chaud, Madame la Coquine;	C’est bien plutôt le chaud, Madame la Coquine;
& nous ſçauons toute l’intrigue du rendez- vous, & du Damoiſeau.	et nous savons toute l’intrigue du rendez-vous, et du Damoiseau.
Nous auons entendu voſtre galant entretien, & les beaux vers à ma loüange que vous auez dits l’vn & l’autre.	Nous avons entendu votre galant entretien, et les beaux vers à ma louange que vous avez dits l’un et l’autre.
Mais ma conſolation c'eſt que ie vais eſtre vangé, & que voſtre pere & voſtre mere ſeront conuaincus maintenant de la iuſtice de mes plaintes, & du dereglement de voſtre conduite.	Mais ma consolation c’est que je vais être vengé, et que votre père et votre mère seront convaincus maintenant de la justice de mes plaintes, et du dérèglement de votre conduite.
Ie les ay enuoyé querir, & ils vont eſtre icy dans vn moment.	Je les ai envoyé quérir, et ils vont être ici dans un moment.
Ah Ciel.	Ah Ciel.
Madame.	Madame.
Voila vn coup ſans doute où vous ne vous attendiez pas.	Voilà un coup sans doute où vous ne vous attendiez pas.
C’eſt maintenant que ie triomphe, & i’ay dequoy mettre à bas voſtre orgueil, &  détruire vos artifices.	C’est maintenant que je triomphe, et j’ai de quoi mettre à bas votre orgueil, et détruire vos artifices.
Iuſques icy vous auez ioüé mes accuſations, éblouy vos parens & plaſtré vos maluerſations.	Jusqu'ici vous avez joué mes accusations, ébloui vos parents et plâtré vos malversations.
I'ay eu beau voir, & beau dire, & voſtre adreſſe toujours l’a emporté ſur mon bon droit, &  touſiours vous auez trouué moyen d’auoir raiſon.	J’ai eu beau voir, et beau dire, et votre adresse toujours l’a emporté sur mon bon droit, et toujours vous avez trouvé moyen d’avoir raison.
Mais à cette fois, Dieu mercy, les choſes vont eſtre éclaircies, & voſtre effronterie ſera pleinement confonduë.	Mais à cette fois, Dieu merci, les choses vont être éclaircies, et votre effronterie sera pleinement confondue.
Hé ie vous prie, faites moy ouurir la porte.	Hé je vous prie, faites-moi ouvrir la porte.
Non, non il faut attendre la venuë de ceux que i’ay mandez, & ie veux qu’ils vous trouuent dehors à la belle heure qu’il eſt.	Non, non il faut attendre la venue de ceux que j’ai mandés, et je veux qu’ils vous trouvent dehors à la belle heure qu’il est.
En attendant qu’ils viennent, ſongez, ſi vous voulez à chercher dans voſtre teſte quelque nouueau détour pour vous tirer de cette affaire.	En attendant qu’ils viennent, songez, si vous voulez à chercher dans votre tête quelque nouveau détour pour vous tirer de cette affaire.
A inuenter quelque moyen de r’habiller voſtre eſcapade.	À inventer quelque moyen de rhabiller votre escapade.
A trouuer quelque belle ruſe pour eluder icy les gens & paroiſtre innocente.	À trouver quelque belle ruse pour éluder ici les gens et paraître innocente.
Quelque pretexte ſpecieux de pelerinage nocturne, ou d’amie en trauail d’enfant que vous veniez de ſecourir.	Quelque prétexte spécieux de pèlerinage nocturne, ou d’amie en travail d’enfant que vous veniez de secourir.
Non, mon intention n’eſt pas de vous rien déguiſer.	Non, mon intention n’est pas de vous rien déguiser.
Ie ne pretens point me deffendre, ny vous nier les choſes, puis que vous les ſçauez.	Je ne prétends point me défendre, ni vous nier les choses, puisque vous les savez.
C'eſt que vous voyez bien que tous les moyens vous en ſont fermez, & que dans cette affaire vous ne ſçauriez inuenter d’excuſe qu’il ne me ſoit facile de conuaincre de fauſſeté.	C’est que vous voyez bien que tous les moyens vous en sont fermés, et que dans cette affaire vous ne sauriez inventer d’excuse qu’il ne me soit facile de convaincre de fausseté.
Ouy.	Oui.
Ie confeſſe que i’ay tort, & que vous auez ſuiet de vous plaindre.	Je confesse que j’ai tort, et que vous avez sujet de vous plaindre.
Mais ie vous demande par grace de ne m'expoſer point maintenant à la mauuaiſe humeur de mes parens, & de me faire promptement ouurir.	Mais je vous demande par grâce de ne m’exposer point maintenant à la mauvaise humeur de mes parents, et de me faire promptement ouvrir.
Ie vous baiſe les mains.	Je vous baise les mains.
Eh mon pauure petit mary.	Eh mon pauvre petit mari.
Ie vous en coniure.	Je vous en conjure.
Ah mon pauure petit mary?	Ah mon pauvre petit mari?
Ie ſuis voſtre petit mary maintenant, parce que vous vous ſentez priſe.	Je suis votre petit mari maintenant, parce que vous vous sentez prise.
Ie ſuis bien aiſe de cela, & vous ne vous eſtiez iamais auiſée de me dire de ces douceurs.	Je suis bien aise de cela, et vous ne vous étiez jamais avisée de me dire de ces douceurs.
Tenez.	Tenez.
Ie vous promets de ne vous plus donner aucun ſuiet de déplaiſir, & de me...	Je vous promets de ne vous plus donner aucun sujet de déplaisir, et de me…
Tout cela n’eſt rien.	Tout cela n’est rien.
Ie ne veux point perdre cette auanture, & il m’importe qu’on ſoit vne fois éclaircy à fond de vos deportemens.	Je ne veux point perdre cette aventure, et il m’importe qu’on soit une fois éclairci à fond de vos déportements.
De grace, laiſſez moy vous dire.	De grâce, laissez-moi vous dire.
Ie vous demande vn moment d’audience.	Je vous demande un moment d’audience.
Hé bien quoy.	Hé bien quoi.
Il eſt vray que i’ay failly, ie vous l’auoüe encore vne fois:	Il est vrai que j’ai failli, je vous l’avoue encore une fois:
& que voſtre reſſentiment eſt iuſte.	et que votre ressentiment est juste.
Que i’ay pris le temps de ſortir pendant que vous dormiez, & que cette ſortie eſt vn rendez-vous que i’auois donné à la perſonne que vous dites.	Que j’ai pris le temps de sortir pendant que vous dormiez, et que cette sortie est un rendez-vous que j’avais donné à la personne que vous dites.
Mais enfin ce ſont des actions que vous deuez pardonner à mon âge; des emportemens de ieune perſonne qui n’a encore rien veu, & ne fait que d'entrer au monde.	Mais enfin ce sont des actions que vous devez pardonner à mon âge; des emportements de jeune personne qui n’a encore rien vu, et ne fait que d’entrer au monde.
Des libertez où l'on s’abandonne ſans y penſer de mal, & qui ſans doute dans le fond n’ont rien de	Des libertés où l’on s’abandonne sans y penser de mal, et qui sans doute dans le fond n’ont rien de
Ouy vous le dites, & ce ſont de ces choſes qui ont beſoin qu’on les croye pieuſement.	Oui vous le dites, et ce sont de ces choses qui ont besoin qu’on les croie pieusement.
Ie ne veux point m'excuſer par là d’eſtre coupable enuers vous, & ie vous prie ſeulement d’oublier vne offenſe, dont ie vous demande pardon de tout mon cœur;	Je ne veux point m’excuser par là d’être coupable envers vous, et je vous prie seulement d’oublier une offense, dont je vous demande pardon de tout mon cœur;
& de m’épargner en cette rencontre le déplaiſir que me pourroient cauſer les reproches faſcheux de mon pere & de ma mere.	et de m’épargner en cette rencontre le déplaisir que me pourraient causer les reproches fâcheux de mon père et de ma mère.
Si vous m’accordez genereuſement la grace que ie vous demande;	Si vous m’accordez généreusement la grâce que je vous demande;
ce procedé obligeant, cette bonté que vous me ferez voir, me gagnera entierement.	ce procédé obligeant, cette bonté que vous me ferez voir, me gagnera entièrement.
Elle touchera tout à fait mon cœur, & y fera naiſtre pour vous ce que tout le pouuoir de mes parens &  les liens du mariage n’auoient pû y ietter.	Elle touchera tout à fait mon cœur, et y fera naître pour vous ce que tout le pouvoir de mes parents et les liens du mariage n’avaient pu y jeter.
En vn mot, elle ſera cauſe que ie renonceray à toutes les galanteries, & n’auray de l’attachement que pour vous.	En un mot, elle sera cause que je renoncerai à toutes les galanteries, et n’aurai de l’attachement que pour vous.
Ouy, ie vous donne ma parole que vous m’allez voir deſormais la meilleure femme du monde, & que ie vous témoigneray tant d’amitié, tant d’amitié que vous en ſerez ſatisfait.	Oui, je vous donne ma parole que vous m’allez voir désormais la meilleure femme du monde, et que je vous témoignerai tant d’amitié, tant d’amitié que vous en serez satisfait.
Ah!	Ah!
Crocodile qui flate les gens pour les étrangler.	Crocodile qui flatte les gens pour les étrangler.
Accordez-moy cette faueur.	Accordez-moi cette faveur.
Point d’affaires.	Point d’affaires.
Ie ſuis inexorable.	Je suis inexorable.
Montrez vous genereux.	Montrez-vous généreux.
Non.	Non.
De grace.	De grâce.
Point.	Point.
Ie vous en coniure de tout mon cœur.	Je vous en conjure de tout mon cœur.
Non, non, non.	Non, non, non.
Ie veux qu’on ſoit détrompé de vous, & que voſtre confuſion éclate.	Je veux qu’on soit détrompé de vous, et que votre confusion éclate.
Hé bien ſi vous me reduiſez au deſeſpoir, ie vous auertis qu'vne femme en cét eſtat eſt capable de tout, & que ie feray quelque choſe icy dont vous vous repentirez.	Hé bien si vous me réduisez au désespoir, je vous avertis qu’une femme en cet état est capable de tout, et que je ferai quelque chose ici dont vous vous repentirez.
Et que ferez-vous, s’il vous plaiſt.	Et que ferez-vous, s’il vous plaît.
Mon cœur ſe portera iuſqu’aux extremes reſolutions, & de ce couſteau que voicy ie me tueray ſur la place.	Mon cœur se portera jusqu’aux extrêmes résolutions, et de ce couteau que voici je me tuerai sur la place.
Ah!	Ah!
ah!	ah!
à la bonne heure.	à la bonne heure.
Pas tant à la bonne heure pour vous, que vous vous imaginez.	Pas tant à la bonne heure pour vous, que vous vous imaginez.
On ſçait de tous coſtez nos differends, & les chagrins perpetuels que vous conceuez contre moy.	On sait de tous côtés nos différends, et les chagrins perpétuels que vous concevez contre moi.
Lors qu’on me trouuera morte, il n’y aura perſonne qui mette en doute que ce ne ſoit vous qui m’aurez tuée;	Lorsqu’on me trouvera morte, il n’y aura personne qui mette en doute que ce ne soit vous qui m’aurez tuée;
& mes parens ne ſont pas gens aſſeurément à laiſſer cette mort impunie, & ils en feront ſur voſtre perſonne toute la punition que leur pourront offrir, & les pourſuites de la Iuſtice, & la chaleur de leur reſſentiment.	et mes parents ne sont pas gens assurément à laisser cette mort impunie, et ils en feront sur votre personne toute la punition que leur pourront offrir, et les poursuites de la Justice, et la chaleur de leur ressentiment.
C’eſt par là que ie trouueray moyen de me vanger de vous, & ie ne ſuis pas la premiere qui ait ſceu recourir à de pareilles vangeances, qui n’ait pas fait difficulté de ſe donner la mort, pour perdre ceux qui ont la cruaute de nous pouſſer à la derniere extremité.	C’est par là que je trouverai moyen de me venger de vous, et je ne suis pas la première qui ait su recourir à de pareilles vengeances, qui n’ait pas fait difficulté de se donner la mort, pour perdre ceux qui ont la cruauté de nous pousser à la dernière extrémité.
Ie ſuis voſtre valet.	Je suis votre valet.
On ne s’auiſe plus de ſe tuer ſoy-meſme, & la mode en eſt paſſée il y a long-temps.	On ne s’avise plus de se tuer soi-même, et la mode en est passée il y a longtemps.
C’eſt vne choſe dont vous pouuez vous tenir ſeur, & ſi vous perſiſtez dans voſtre refus, ſi vous ne me faites ouurir, ie vous iure que tout à l’heure ie vais vous faire voir iuſques où peut aller la reſolution d’vne perſonne qu’on met au deſeſpoir.	C’est une chose dont vous pouvez vous tenir sûr, et si vous persistez dans votre refus, si vous ne me faites ouvrir, je vous jure que tout à l’heure je vais vous faire voir jusqu'où peut aller la résolution d’une personne qu’on met au désespoir.
Bagatelles, bagatelles.	Bagatelles, bagatelles.
C’eſt pour me faire peur.	C’est pour me faire peur.
Hé bien puis qu’il le faut, voicy qui nous contentera tous deux, & montrera ſi ie me moque.	Hé bien puis qu’il le faut, voici qui nous contentera tous deux, et montrera si je me moque.
Ah!	Ah!
c’en eſt fait.	c’en est fait.
Faſſe le Ciel que ma mort ſoit vangée comme ie le ſouhaite, & que celuy qui en eſt cauſe, reçoiue vn iuſte chaſtiment de la dureté qu’il a euë pour moy.	Fasse le Ciel que ma mort soit vengée comme je le souhaite, et que celui qui en est cause, reçoive un juste châtiment de la dureté qu’il a eue pour moi.
Oüais!	Ouais!
ſeroit-elle bien ſi malicieuſe que de s’eſtre tuée pour me faire pendre?	serait-elle bien si malicieuse que de s’être tuée pour me faire pendre?
Prenons vn bout de chandelle pour aller voir.	Prenons un bout de chandelle pour aller voir.
St.	St.
Paix.	Paix.
Rangeons-nous chacune immediatement contre vn des coſtez de la porte.	Rangeons-nous chacune immédiatement contre un des côtés de la porte.
La méchanceté d’vne femme iroit-elle bien iuſques là?	La méchanceté d’une femme irait-elle bien jusque là?
Il ſort auec vn bout de chandelle ſans les apperceuoir, elles entrent, auſſi toſt elles ferment la porte.	Il sort avec un bout de chandelle sans les apercevoir, elles entrent, aussitôt elles ferment la porte.
Il n’y a perſonne.	Il n’y a personne.
Eh ie m’en eſtois bien doute, & la pendarde s’eſt retirée, voyant qu’elle ne gagnoit rien apres moy, ny par prieres ny par menaces.	Eh je m’en étais bien doute, et la pendarde s’est retirée, voyant qu’elle ne gagnait rien après moi, ni par prières ni par menaces.
Tant mieux cela rendra ſes affaires encore plus mauuaiſes, & le pere & la mere qui vont venir en verront mieux ſon crime.	Tant mieux cela rendra ses affaires encore plus mauvaises, et le père et la mère qui vont venir en verront mieux son crime.
Ah ah la porte s’eſt fermée.	Ah ah la porte s’est fermée.
Hola ho quelqu’vn.	Hola ho quelqu’un.
Qu’on m’ouure promptement.	Qu’on m’ouvre promptement.
A la feneſtre auec Claudine.	À la fenêtre avec Claudine.
Comment c’eſt toy!	Comment c’est toi!
d’où viens tu bon pendart?	d’où viens tu bon pendard?
eſt-il l’heure de reuenir chez ſoy, quand le iour eſt preſt de paroiſtre, & cette maniere de vie eſt- elle celle que doit ſuiure vn honneſte mary?	est-il l’heure de revenir chez soi, quand le jour est prêt de paraître, et cette manière de vie est-elle celle que doit suivre un honnête mari?
Cela eſt-il beau d’aller yurogner toute la nuit?	Cela est-il beau d’aller ivrogner toute la nuit?
& de laiſſer ainſi toute ſeule vne pauure ieune femme dans la maiſon?	et de laisser ainsi toute seule une pauvre jeune femme dans la maison?
Comment vous auez....	Comment vous avez…
Va va, traiſtre, ie ſuis laſſe de tes déportemens, & ie m’en veux plaindre ſans plus tarder à mon pere & à ma mere.	Va va, traître, je suis lasse de tes déportements, et je m’en veux plaindre sans plus tarder à mon père et à ma mère.
Quoy c’eſt ainſi que vous oſez.	Quoi c’est ainsi que vous osez.
Mr & Me de Sotenuille ſont en des habits de nuit & conduits par Colin, qui porte vne lanterne.	Mr et Me de Sotenville sont en des habits de nuit et conduits par Colin, qui porte une lanterne.
AProchez de grace, &  venez me faire raiſon de l'inſolence la plus grande du monde, d’vn mary à qui le vin & la ialouſie ont troublé de telle ſorte la ceruelle, qu'il ne ſçait plus ny ce qu’il dit, ny ce qu’il fait, & vous a luy- meſme enuoyé querir pour vous faire témoin de l’extrauagance la plus étrange dont on ait iamais ouy parler.	APprochez de grâce, et venez me faire raison de l’insolence la plus grande du monde, d’un mari à qui le vin et la jalousie ont troublé de telle sorte la cervelle, qu’il ne sait plus ni ce qu’il dit, ni ce qu’il fait, et vous a lui-même envoyé quérir pour vous faire témoin de l’extravagance la plus étrange dont on ait jamais ouï parler.
Le voila qui reuient comme vous voyez, apres s’eſtre fait attendre toute la nuit, & ſi vous voulez l’écouter, il vous dira qu’il a les plus grandes plaintes du monde à vous faire de moy;	Le voilà qui revient comme vous voyez, après s’être fait attendre toute la nuit, et si vous voulez l’écouter, il vous dira qu’il a les plus grandes plaintes du monde à vous faire de moi;
que durant qu’il dormoit, ie me ſuis derobée d’auprés de luy pour m’en aller courir, & cent autres contes de meſme nature qu’il eſt allé reſver.	que durant qu’il dormait, je me suis dérobée d’auprès de lui pour m’en aller courir, et cent autres contes de même nature qu’il est allé rêver.
Voila vne méchante carogne.	Voilà une méchante carogne.
Oüy, il nous a voulu faire accroire qu’il eſtoit dans la maiſon, & que nous en eſtions dehors, & c’eſt vne folie qu’il n’y a pas moyen de luy oſter de la teſte.	Oui, il nous a voulu faire accroire qu’il était dans la maison, et que nous en étions dehors, et c’est une folie qu’il n’y a pas moyen de lui ôter de la tête.
Comment, qu’eſt-ce à dire cela?	Comment, qu’est-ce à dire cela?
Voila vne furieuſe impudence que de nous envoyer querir.	Voilà une furieuse impudence que de nous envoyer quérir.
Iamais.	Jamais.
Non, mon pere, ie ne puis plus ſouffrir vn mary de la ſorte.	Non, mon père, je ne puis plus souffrir un mari de la sorte.
Ma patience eſt pouſſée à bout, & il vient de me dire cent paroles iniurieuſes.	Ma patience est poussée à bout, et il vient de me dire cent paroles injurieuses.
Corbleu vous eſtes vn mal honneſte homme.	Corbleu vous êtes un mal honnête homme.
C’eſt vne conſcience de voir vne pauure ieune femme traittée de la façon, & cela crie vengeance au Ciel.	C’est une conscience de voir une pauvre jeune femme traitée de la façon, et cela crie vengeance au Ciel.
Peut-on....	Peut-on…
Allez, vous deuriez mourir de honte.	Allez, vous devriez mourir de honte.
Laiſſez moy vous dire deux mots.	Laissez-moi vous dire deux mots.
Vous n’auez qu’à l'ecouter, il va vous en conter de belles.	Vous n’avez qu’à l’écouter, il va vous en conter de belles.
Ie deſeſpere.	Je désespère.
Il a tant beu, que ie ne penſe pas qu’on puiſſe durer contre luy, & l’odeur du vin qu’il ſouffle eſt montée iuſqu’à nous.	Il a tant bu, que je ne pense pas qu’on puisse durer contre lui, et l’odeur du vin qu’il souffle est montée jusqu’à nous.
Monſieur mon beau pere, ie vous coniure...	Monsieur mon beau-père, je vous conjure…
Retirez-vous.	Retirez-vous.
Vous puez le vin à pleine bouche.	Vous puez le vin à pleine bouche.
Madame, ie vous prie...	Madame, je vous prie…
Fy ne m’approchez pas.	Fi ne m’approchez pas.
Voſtre haleine eſt empeſtée.	Votre haleine est empestée.
Souffrez que ie vous...	Souffrez que je vous…
Retirez-vous, vous dis-je.	Retirez-vous, vous dis-je.
On ne peut vous ſouffrir.	On ne peut vous souffrir.
Permettez de grace que.	Permettez de grâce que.
Poüas, vous m’engloutiſſez le cœur.	Pouas, vous m’engloutissez le cœur.
Parlez de loin, ſi vous voulez.	Parlez de loin, si vous voulez.
Hé bien ouy, ie parle de loin.	Hé bien oui, je parle de loin.
Ie vous iure que ie n’ay bougé de chez moy, & que c’eſt elle qui eſt ſortie.	Je vous jure que je n’ai bougé de chez moi, et que c’est elle qui est sortie.
Ne voila pas ce que ie vous ay dit.	Ne voilà pas ce que je vous ai dit.
Vous voyez quelle apparence il y a.	Vous voyez quelle apparence il y a.
Allez.	Allez.
Vous vous mocquez des gens.	Vous vous moquez des gens.
Deſcendez, ma fille, & venez icy.	Descendez, ma fille, et venez ici.
I’ateſte le Ciel, que i’eſtois dans la maiſon, & que...	J’atteste le Ciel, que j’étais dans la maison, et que…
Taiſez vous, c’eſt vne extrauagance qui n'eſt pas ſuportable.	Taisez-vous, c’est une extravagance qui n’est pas supportable.
Que la foudre m’écraſe tout à l’heure, ſi...	Que la foudre m’écrase tout à l’heure, si…
Ne nous rompez pas dauantage la teſte & ſongez à demander pardon à voſtre femme	Ne nous rompez pas davantage la tête et songez à demander pardon à votre femme
Moy demander pardon?	Moi demander pardon?
Ouy pardon, & ſur le champ.	Oui pardon, et sur le champ.
Quoy ie....	Quoi je…
Corbleu ſi vous me repliquez.	Corbleu si vous me répliquez.
Ie vous apprendray ce que c'eſt que de vous ioüer à nous.	Je vous apprendrai ce que c’est que de vous jouer à nous.
Ah George Dandin.	Ah George Dandin.
Allons, venez ma fille, que voſtre mary vous demande pardon.	Allons, venez ma fille, que votre mari vous demande pardon.
Deſcenduë	Descendue
Moy?	Moi?
luy pardonner tout ce qu’il m’a dit?	lui pardonner tout ce qu’il m’a dit?
Non, non mon pere, il m’eſt impoſſible de m'y reſoudre, & ie vous prie de me ſeparer d’vn mary auec lequel ie ne ſçaurois plus viure.	Non, non mon père, il m’est impossible de m’y résoudre, et je vous prie de me séparer d’un mari avec lequel je ne saurais plus vivre.
Le moyen d’y reſiſter?	Le moyen d’y résister?
Ma fille, de ſemblables ſeparations ne ſe font point ſans grand ſcandale, & vous deuez vous montrer plus ſage que luy, & patienter encore cette fois.	Ma fille, de semblables séparations ne se font point sans grand scandale, et vous devez vous montrer plus sage que lui, et patienter encore cette fois.
Comment patienter apres de telles indignitez?	Comment patienter après de telles indignités?
non, mon pere, c’eſt vne choſe où ie ne puis conſentir.	non, mon père, c’est une chose où je ne puis consentir.
Il le faut, ma fille, & c’eſt moy qui vous le commande.	Il le faut, ma fille, et c’est moi qui vous le commande.
Ce mot me ferme la bouche, & vous auez ſur moy vne puiſſance abſoluë.	Ce mot me ferme la bouche, et vous avez sur moi une puissance absolue.
Quelle douceur.	Quelle douceur.
Il eſt faſcheux d’eſtre contrainte d’oublier de telles iniures, mais quelle violence que ie me faſſe, c’eſt à moy de vous obeïr.	Il est fâcheux d’être contrainte d’oublier de telles injures, mais quelle violence que je me fasse, c’est à moi de vous obéir.
Pauure mouton.	Pauvre mouton.
Approchez.	Approchez.
Tout ce que vous me faites faire ne ſeruira de rien, & vous verrez que ce ſera dés demain à recommencer.	Tout ce que vous me faites faire ne servira de rien, et vous verrez que ce sera dès demain à recommencer.
Nous y donnerons ordre.	Nous y donnerons ordre.
Allons, mettez vous à genoux.	Allons, mettez-vous à genoux.
A genoux?	À genoux?
Ouy à genoux, & ſans tarder.	Oui à genoux, et sans tarder.
Il ſe met à genoux.	Il se met à genoux.
O Ciel!	O Ciel!
Que faut-il dire?	Que faut-il dire?
Madame, ie vous prie de me pardonner.	Madame, je vous prie de me pardonner.
Madame, ie vous prie de me pardonner.	Madame, je vous prie de me pardonner.
L’extrauagance que i’ay faite.	L’extravagance que j’ai faite.
L’extrauagance que i’ay faite.	L’extravagance que j’ai faite.
A part.	À part.
De vous épouſer.	De vous épouser.
Et ie vous promets de mieux viure à l’auenir.	Et je vous promets de mieux vivre à l’avenir.
Et ie vous promets de mieux viure à l’auenir.	Et je vous promets de mieux vivre à l’avenir.
Prenez-y garde, & ſçachez que c’eſt icy la derniere de vos impertinences que nous ſouffrirons.	Prenez-y garde, et sachez que c’est ici la dernière de vos impertinences que nous souffrirons.
Iour de Dieu, ſi vous y retournez, on vous apprendra le reſpect que vous deuez à voſtre femme;	Jour de Dieu, si vous y retournez, on vous apprendra le respect que vous devez à votre femme;
& à ceux de qui elle ſort.	et à ceux de qui elle sort.
Voila le iour qui va paroiſtre.	Voilà le jour qui va paraître.
Adieu. Rentrez chez vous, & ſongez bien à eſtre sage.	Adieu. Rentrez chez vous, et songez bien à être sage.
Et nous, mamour, allons nous mettre au lit.	Et nous, mamour, allons nous mettre au lit.
AH!	AH!
ie le quitte maintenant, & ie n’y voy plus de remede, lors qu’on a comme moy épouſé vne méchante femme, le meilleur party qu’on puiſſe prendre, c’eſt de s’aller ietter dans l’eau la teſte la premiere.	je le quitte maintenant, et je n’y vois plus de remède, lorsqu’on a comme moi épousé une méchante femme, le meilleur parti qu’on puisse prendre, c’est de s’aller jeter dans l’eau la tête la première.
