VOVS venez, dites-vous, pour luy donner la main?	VOUS venez, dites-vous, pour lui donner la main?
Oüy, ie veux terminer la choſe dans demain.	Oui, je veux terminer la chose dans demain.
Nous ſommes icy ſeuls, & l'on peut, ce me ſemble,	Nous sommes ici seuls, et l’on peut, ce me semble,
Sans craindre d’eſtre oüis, y diſcourir enſemble.	Sans craindre d’être ouïs, y discourir ensemble.
Voulez-vous qu’en Amy ie vous ouure mon cœur?	Voulez-vous qu’en Ami je vous ouvre mon cœur?
Voſtre deſſein, pour vous, me fait trembler de peur;	Votre dessein, pour vous, me fait trembler de peur;
Et de quelque façon que vous tourniez l’affaire,	Et de quelque façon que vous tourniez l’affaire,
Prendre Femme, eſt à vous vn coup bien temeraire.	Prendre Femme, est à vous un coup bien téméraire.
Il eſt vray, noſtre Amy. Peut-eſtre que chez vous	Il est vrai, notre Ami. Peut-être que chez vous
Vous trouuez des ſujets de craindre pour chez nous;	Vous trouvez des sujets de craindre pour chez nous;
Et voſtre front, ie croy, veut que du Mariage,	Et votre front, je crois, veut que du Mariage,
Les Cornes ſoient par tout l'infaillible apanage.	Les Cornes soient par tout l’infaillible apanage.
Ce ſont coups du Hazard, dõt on n’eſt point garand;	Ce sont coups du Hasard, dont on n’est point garant;
Et bien ſot, ce me ſemble, eſt le ſoin qu'on en prend.	Et bien sot, ce me semble, est le soin qu’on en prend.
Mais quand ie crains pour vous, c’eſt cette raillerie	Mais quand je crains pour vous, c’est cette raillerie
Dont cent pauures Maris ont ſouffert la furie:	Dont cent pauvres Maris ont souffert la furie:
Car enfin vous ſçauez, qu’il n'eſt grands, ny petits,	Car enfin vous savez, qu’il n’est grands, ni petits,
Que de voſtre critique on ait veus garantis;	Que de votre critique on ait vus garantis;
Car vos plus grãds plaiſirs sõt, par tout où vous eſtes,	Car vos plus grands plaisirs sont, partout où vous êtes,
De faire cent éclats des intrigues ſecrettes....	De faire cent éclats des intrigues secrètes…
Fort bien: Eſt-il au Monde vne autre Ville auſſi,	Fort bien: Est-il au Monde une autre Ville, aussi,
Où l’on ait des Maris ſi patients qu’icy?	Où l’on ait des Maris si patients qu’ici?
Eſt-ce qu’on n’en voit pas de toutes les eſpeces.	Est-ce qu’on n’en voit pas de toutes les espèces,
Qui ſont accommodez chez eux de toutes pieces?	Qui sont accommodés chez eux de toutes pièces?
L’vn amaſſe du bien, dont ſa Femme fait part	L’un amasse du bien, dont sa Femme fait part
A ceux qui prennent ſoin de le faire Cornard.	À ceux qui prennent soin de le faire Cornard.
L’autre vn peu plus heureux, mais non pas moins infame,	L’autre un peu plus heureux, mais non pas moins infâme,
Voit faire tous les jours des presẽs à ſa Fẽme,	Voit faire tous les jours des présents à sa Femme,
Et d’aucun ſoin jaloux n'a l’eſprit combattu,	Et d’aucun soin jaloux n’a l’esprit combattu,
Parce qu’elle luy dit que c'eſt pour ſa vertu.	Parce qu’elle lui dit que c’est pour sa vertu.
L’vn fait beaucoup de bruit, qui ne luy ſert de gueres;	L’un fait beaucoup de bruit, qui ne lui sert de guères;
L'autre, en toute douceur, laiſſe aller les affaires,	L’autre, en toute douceur, laisse aller les affaires,
Et voyant arriuer chez luy le Damoiſeau,	Et voyant arriver chez lui le Damoiseau,
Prend fort honneſtement ſes gands, & ſon manteau.	Prend fort honnêtement ses gants, et son manteau.
L'vne de ſon Galant, en adroite Femelle,	L’une de son Galant, en adroite Femelle,
Fait fauſſe confidence à ſon Eſpoux fidelle,	Fait fausse confidence à son Époux fidèle,
Qui dort en ſeureté ſur vn pareil appas,	Qui dort en sureté sur un pareil appas,
Et le plaint, ce Galant, des ſoins qu il ne perd pas.	Et le plaint, ce Galant, des soins qu’il ne perd pas.
L'autre, pour ſe purger de ſa magnificence,	L’autre, pour se purger de sa magnificence,
Dit qu'elle gagne au jeu l'argent qu'elle depenſe;	Dit qu’elle gagne au jeu l’argent qu’elle dépense;
Et le Mary beneſt, ſans ſonger à quel jeu,	Et le Mari benêt, sans songer à quel jeu,
Sur les gains qu'elle fait, rend des graces à Dieu,	Sur les gains qu’elle fait, rend des grâces à Dieu.
Enfin ce ſont par tout des ſujets de Satyre,	Enfin ce sont partout des sujets de Satire,
Et comme Spectateur, ne puis-je pas en rire?	Et comme Spectateur, ne puis-je pas en rire?
Puis-je pas de nos Sots....	Puis-je pas de nos Sots…
Oüy: mais qui rit d’autruy,	Oui: mais qui rit d'autrui,
Doit craindre, qu’en reuanche, on rie auſſi de luy.	Doit craindre, qu’en revanche, on rie aussi de lui.
I'entens parler le monde, & des gens ſe délaſſent	J’entends parler le monde, et des gens se délassent
A venir debiter les choſes qui ſe paſſent:	À venir débiter les choses qui se passent:
Mais quoy que l’on diuulgue aux endroits ou ie ſuis,	Mais quoi que l’on divulgue aux endroits où je suis,
Iamais on ne m’a veu triompher de ces bruits;	Jamais on ne m’a vu triompher de ces bruits;
I’y ſuis aſſez modeſte; & bien qu’aux occurences	J’y suis assez modeste; et bien qu’aux occurrences
Ie puiſſe condamner certaines tolerances;	Je puisse condamner certaines tolérances;
Que mon deſſein ne ſoit de ſouffrir nullement,	Que mon dessein ne soit de souffrir nullement,
Ce que d'aucuns Maris ſouffrent paiſiblement,	Ce que d’aucuns Maris souffrent paisiblement,
Pourtant ie n’ay iamais affecté de le dire;	Pourtant je n’ai jamais affecté de le dire;
Car enfin il faut craindre vn reuers de Satyre,	Car enfin il faut craindre un revers de Satire,
Et l'on ne doit iamais jurer, ſur de tels cas,	Et l’on ne doit jamais jurer, sur de tels cas,
De ce qu’on pourra faire, ou bien ne faire pas.	De ce qu’on pourra faire, ou bien ne faire pas.
Ainſi quand à mon front, par vn ſort qui tout meine,	Ainsi quand à mon front, par un sort qui tout mène,
Il ſeroit arriué quelque diſgrace humaine;	Il serait arrivé quelque disgrâce humaine;
Apres mon procedé, ie ſuis preſque certain	Après mon procédé, je suis presque certain
Qu'on ſe contentera de s’en rire ſous-main;	Qu’on se contentera de s’en rire sous-main;
Et peut-eſtre qu’encor i’auray cet auautage,	Et peut-être qu’encor j’aurai cet avantage,
Que quelques bonnes gens diront, que c’eſt dõmage!	Que quelques bonnes gens diront, que c’est dommage!
Mais de vous, cher Compere, il en eſt autrement;	Mais de vous, cher Compère, il en est autrement;
Ie vous le dis encor, vous riſquez diablement.	Je vous le dis encor, vous risquez diablement.
Comme ſur les Maris accuſez de ſouffrance,	Comme sur les Maris accusés de souffrance,
De tout temps voſtre langue a daubé d’importance,	De tout temps votre langue a daubé d’importance,
Qu’on vous a veu contr’eux vn Diable déchainé;	Qu’on vous a vu contre eux un Diable déchaîné;
Vous deuez marcher droit, pour n’eſtre point berné;	Vous devez marcher droit, pour n’être point berné;
Et s’il faut que ſur vous on ait la moindre priſe,	Et s’il faut que sur vous on ait la moindre prise,
Gare qu’aux Carrefours on ne vous tympaniſe,	Gare qu’aux Carrefours on ne vous tympanise,
Et....	Et…
Mon Dieu, noſtre Amy,ne vous tourmẽtez point;	Mon Dieu, notre Ami, ne vous tourmentez point;
Bien hupé qui pourra m’attraper ſur ce poinct.	Bien huppé qui pourra m’attraper sur ce point.
Ie ſçay les tours ruſez, & les ſubtiles trames,	Je sais les tours rusés, et les subtiles trames,
Dont, pour nous en plãter, ſçauent vſer les Femmes,	Dont, pour nous en planter, savent user les Femmes,
Et comme on eſt dupé par leurs dexteritez;	Et comme on est dupé par leurs dextérités;
Contre cet accident i'ay pris mes ſeuretez,	Contre cet accident j’ai pris mes sûretés,
Et celle que i'épouſe, a toute l’innocence	Et celle que j’épouse, a toute l’innocence
Qui peut ſauuer mon front de maligne influence.	Qui peut sauver mon front de maligne influence.
Et que pretendez-vous qu’vne Sotte en vn mot...	Et que prétendez-vous qu’une Sotte en un mot…
Epouſer vne Sotte, eſt pour n’eſtre point Sot:	Épouser une Sotte, est pour n’être point Sot:
Ie crois, en bon Chreſtien, voſtre moitié fort ſage;	Je crois, en bon Chrétien, votre moitié fort sage;
Mais vne Femme habile eſt vn mauuais préſage,	Mais une Femme habile est un mauvais présage,
Et ie ſçay ce qu’il couſte à de certaines gens,	Et je sais ce qu’il coûte à de certaines gens,
Pour auoir pris les leurs auec trop de talens.	Pour avoir pris les leurs avec trop de talents.
Moy i’irois me charger d'vne Spirituelle,	Moi j’irais me charger d’une Spirituelle,
Qui ne parleroit rien que Cercle, & que Ruelle?	Qui ne parlerait rien que Cercle, et que Ruelle?
Qui de Proſe, & de Vers, ſeroit de doux écrits,	Qui de Prose, et de Vers, ferait de doux écrits,
Et que viſiteroient Marquis, & beaux Eſprits,	Et que visiteraient Marquis, et beaux Esprits,
Tandis que, ſous le nom du Mary de Madame,	Tandis que, sous le nom du Mari de Madame,
Ie ſerois comme vn Saint, que pas-vn ne reclame?	Je serais comme un Saint, que pas un ne réclame?
Non, non, ie ne veux point d'vn Eſprit qui ſoit haut,	Non, non, je ne veux point d’un Esprit qui soit haut
Et Femme qui compoſe, en ſçait plus qu’il ne faut.	Et Femme qui compose, en sait plus qu’il ne faut.
Ie pretens que la mienne, en clartez peu ſublime,	Je prétends que la mienne, en clartés peu sublime,
Meſme ne ſçache pas ce que c'eſt qu’vne Rime;	Même ne sache pas ce que c’est qu’une Rime;
Et s’il faut qu’auec elle on jouë au Corbillon,	Et s’il faut qu’avec elle on joue au Corbillon,
Et qu’on vienne à luy dire, à ſon tour, qu’y met-on?	Et qu’on vienne à lui dire, à son tour, qu’y met-on?
Ie veux qu'elle réponde, vne tarte à la creme;	Je veux qu’elle réponde, une tarte à la crème;
En vn mot, qu’elle ſoit d'vne ignorance extréme;	En un mot, qu’elle soit d’une ignorance extrême;
Et c'eſt aſſez pour elle, à vous en bien parler,	Et c’est assez pour elle, à vous en bien parler,
De ſçauoir prier Dieu, m'aimer, coudre, & filer.	De savoir prier Dieu, m’aimer, coudre, et filer.
Vne Femme ſtupide eſt donc voſtre Marotte?	Une Femme stupide est donc votre Marotte?
Tant, que i'aimerois mieux vne laide, bien ſotte,	Tant, que j’aimerais mieux une laide, bien sotte,
Qn'vne Femme fort belle, auec beaucoup d’eſprit.	Qu’une Femme fort belle, avec beaucoup d’esprit.
L’eſprit, & la beauté...	L’esprit, et la beauté…
L’honneſteté ſuffit.	L’honnêteté suffit.
Mais comment voulez-vous, apres tout, qu’vne beſte	Mais comment voulez-vous, après tout, qu’une bête
Puiſſe iamais ſçauoir ce que c'eſt qu’eſtre honneſte?	Puisse jamais savoir ce que c’est qu’être honnête?
Outre qu'il eſt aſſez ennuyeux, que ie croy,	Outre qu’il est assez ennuyeux, que je crois,
D'auoir toute ſa vie vne beſte auec ſoy,	D’avoir toute sa vie une bête avec soi,
Penſez-vous le bien prendre, & que ſur voſtre idée	Pensez-vous le bien prendre, et que sur votre idée
La ſeureté d’vn front puiſſe eſtre bien fondée?	La sûreté d’un front peut être bien fondée?
Vne Femme d’eſprit peut trahir ſon deuoir;	Une Femme d’esprit peut trahir son devoir;
Mais il faut, pour le moins, qu’elle oſe le vouloir;	Mais il faut, pour le moins, qu’elle ose le vouloir;
Et la ſtupide au ſien peut manquer d'ordinaire,	Et la stupide au sien peut manquer d’ordinaire,
Sans en auoir l’enuie, & ſans penſer le faire.	Sans en avoir l’envie, et sans penser le faire.
A ce bel argument, à ce diſcours profond,	À ce bel argument, à ce discours profond,
Ce que Pantagruel à Panurge répond.	Ce que Pantagruel à Panurge répond.
Preſſez-moy de me joindre à Fẽme autre que ſotte;	Pressez-moi de me joindre à Femme autre que sotte;
Preſchez, patrocinez juſqu’à la Pentecoſte,	Prêchez, patrocinez jusqu’à la Pentecôte,
Vous ſerez ébahy, quand vous ſerez au bout,	Vous serez ébahi, quand vous serez au bout,
Que vous ne m’aurez rien perſuadé du tout.	Que vous ne m’aurez rien persuadé du tout.
Ie ne vous dis plus mot.	Je ne vous dis plus mot.
Chacun a ſa methode.	Chacun a sa méthode.
En Femme, comme en tout, ie veux ſuiure ma mode;	En Femme, comme en tout, je veux suivre ma mode;
Ie me voy riche aſſez, pour pouvoir, que ie croy,	Je me vois riche assez, pour pouvoir, que je crois,
Choiſir vne moitié, qui tienne tout de rnoy.	Choisir une moitié, qui tienne tout de moi,
Et de qui la ſoûmise, & pleine dépendance,	Et de qui la soumise, et pleine dépendance,
N'ait à me reprocher aucun bien, ny naiſſance.	N’ait à me reprocher aucun bien, ni naissance.
Vn air doux, & poſé, parmy d’autres enfans,	Un air doux, et posé, parmi d’autres enfants,
M'inſpira de l’amour pour elle, dés quatre ans:	M’inspira de l’amour pour elle, dès quatre ans:
Sa Mere ſe trouuant de pauureté preſſée,	Sa Mère se trouvant de pauvreté pressée,
De la luy demander il me vint la penſée.	De la lui demander il me vint la pensée,
Et la bonne Payſanne, apprenant mon deſir,	Et la bonne Paysanne, apprenant mon désir,
A s'oſter cette charge eut beaucoup de plaiſir.	À s’ôter cette charge eut beaucoup de plaisir.
Dans vn petit Couuent, loin de toute pratique,	Dans un petit Couvent, loin de toute pratique,
Ie la fis éleuer, ſelon ma politique,	Je la fis élever, selon ma politique,
C'eſt à dire ordonnant quels ſoins on employroit,	C’est-à-dire ordonnant quels soins on emploierait,
Pour la rendre idiote autant qu’il ſe pourroit.	Pour la rendre idiote autant qu’il se pourrait.
Dieu mercy, le ſuccés a ſuiuy mon attente,	Dieu merci, le succès a suivi mon attente,
Et grande, ie l'ay veuë à tel poinct innocente,	Et grande, je l’ai vue à tel point innocente,
Que i'ay beny le Ciel d'auoir trouué mon fait,	Que j’ai béni le Ciel d’avoir trouvé mon fait,
Pour me faire vne Femme au gré de mon ſouhait.	Pour me faire une Femme au gré de mon souhait.
Ie l'ay donc retirée; & comme ma demeure	Je l’ai donc retirée; et comme ma demeure
A cent ſortes de monde eſt ouuerte à toute heure,	À cent sortes de monde est ouverte à toute heure,
Ie l'ay miſe à l’écart, comme il faut tout préuoir.	Je l’ai mise à l’écart, comme il faut tout prévoir,
Dans cette autre Maiſon, où nul ne me vient voir;	Dans cette autre Maison, où nul ne me vient voir;
Et pour ne point gaſter ſa bonté naturelle,	Et pour ne point gâter sa bonté naturelle,
Ie n’y tiens que des gens tout auſſi ſimples qu'elle.	Je n’y tiens que des gens tout aussi simples qu’elle.
Vous me direz pourquoy cette narration?	Vous me direz pourquoi cette narration?
C'eſt pour vous rendre inſtruit de ma précaution.	C’est pour vous rendre instruit de ma précaution.
Le reſultat de tout, eſt qu’en Amy fidelle,	Le résultat de tout, est qu’en Ami fidèle,
Ce ſoir, ie vous inuite à ſouper auec elle:	Ce soir, je vous invite à souper avec elle:
Ie veux que vous puiſſiez vn peu l'examiner.	Je veux que vous puissiez un peu l’examiner,
Et voir, ſi de mon choix on me doit condamner.	Et voir, si de mon choix on me doit condamner.
I'y conſens.	J’y consens.
Vous pourrez, dans cette conference,	Vous pourrez, dans cette conférence,
Iuger de ſa perſonne, & de ſon innocence.	Juger de sa personne, et de son innocence.
Pour cette article là, ce que vous m’auez dit,	Pour cet article-là, ce que vous m’avez dit,
Ne peut....	Ne peut…
La verité paſſe encor mon recit.	La vérité passe encor mon récit.
Dans ſes ſimplicitez à tous coups ie l’admire,	Dans ses simplicités à tous coups je l’admire,
Et par fois elle en dit, dont ie pâme de rire.	Et parfois elle en dit, dont je pâme de rire.
L’autre jour (pourroit-on ſe le perſuader)	L’autre jour (pourrait-on se le persuader?)
Elle eſtoit fort en peine, & me vint demander,	Elle était fort en peine, et me vint demander,
Auec vne innocence à nulle autre pareille,	Avec une innocence à nulle autre pareille,
Si les enfans qu'on fait, ſe faiſoient par l'oreille.	Si les enfants qu’on fait, se faisaient par l’oreille.
Ie me réjoüis fort, Seigneur Arnolphe....	Je me réjouis fort, Seigneur Arnolphe…
Bon;	Bon;
Me voulez-vous toûjours appeller de ce nom?	Me voulez-vous toujours appeler de ce nom?
Ah! malgré que i’en aye, il me vient à la bouche,	Ah! malgré que j’en aie, il me vient à la bouche,
Et iamais ie ne ſonge à Monſieur de la Souche.	Et jamais je ne songe à Monsieur de la Souche.
Que diable vous a fait auſſi vous auiſer,	Qui diable vous a fait aussi vous aviser,
A quarante & deux ans, de vous débaptiſer?	À quarante et deux ans, de vous débaptiser?
Et d'vn vieux tronc pourry de voſtre Metairie,	Et d’un vieux tronc pourri de votre Métairie,
Vous faire dans le Monde vn nom de Seigneurie?	Vous faire dans le Monde un nom de Seigneurie?
Outre que la Maiſon par ce nom ſe connaiſt,	Outre que la Maison par ce nom se connaît,
La Souche, plus qu’Arnolphe, à mes oreilles plaiſt.	La , plus qu’Arnolphe, à mes oreilles plaît.
Quel abus, de quitter le vray nom de ſes Peres,	Quel abus, de quitter le vrai nom de ses Pères
Pour en vouloir prendre vn baſty ſur des chimeres?	Pour en vouloir prendre un bâti sur des chimères?
De la pluſpart des gens c’eſt la démangeaiſon;	De la plupart des gens c’est la démangeaison;
Et ſans vous embraſſer dans la comparaiſon,	Et sans vous embrasser dans la comparaison,
Ie ſçais vn Païſan, qu’on appelloit gros Pierre,	Je sais un Paysan, qu’on appelait gros Pierre,
Qui n’ayãt, pour tout biẽ, qu'vn ſeul quartier de terre;	Qui n’ayant, pour tout bien, qu’un seul quartier de terre,
Y fit tout à l’entour faire vn foſſé bourbeux,	Y fit tout à l’entour faire un fossé bourbeux,
Et de Monſieur de l'Iſle en prit le nom pompeux.	Et de Monsieur de l’Isle en prit le nom pompeux.
Vous pourriez vous paſſer d'exemples de la ſorte:	Vous pourriez vous passer d’exemples de la sorte:
Mais enfin de la Souche eſt le nom que ie porte;	Mais enfin de la Souche est le nom que je porte;
I’y vois de la raiſon, i'y trouue des appas,	J’y vois de la raison, j’y trouve des appas,
Et m'appeller de l’autre, eſt ne m’obliger pas.	Et m’appeler de l’autre, est ne m’obliger pas.
Cependant la pluſpart ont peine à s'y ſoûmettre,	Cependant la plupart ont peine à s’y soumettre,
Et ie voy meſme encor des adreſſes de Lettre...	Et je vois même encor des adresses de Lettre…
Ie le ſouffre aiſément de qui n’eſt pas inſtruit;	Je le souffre aisément de qui n’est pas instruit;
Mais vous....	Mais vous…
Soit. Là-deſſus nous n'aurons point de bruit,	Soit. Là-dessus nous n'aurons point de bruit,
Et ie prendray le ſoin d'accouſtumer ma bouche	Et je prendrai le soin d’accoutumer ma bouche
A ne plus vous nommer que Monſieur de la Souche.	À ne plus vous nommer que Monsieur de la Souche.
Adieu: Ie frape icy, pour donner le bon jour,	Adieu: Je frappe ici, pour donner le bonjour,
Et dire ſeulement, que ie ſuis de retour.	Et dire seulement, que je suis de retour.
Ma foy ie le tiens fou de toutes les manieres.	Ma foi je le tiens fou de toutes les manières.
Il eſt vn peu bleſſé ſur certaines matieres.	Il est un peu blessé sur certaines matières.
Choſe étrange de voir, comme auec paſſion,	Chose étrange de voir, comme avec passion,
Vn chacun eſt chauſſé de ſon opinion!	Un chacun est chaussé de son opinion!
Hola.	Holà…
QVi heurte?	QUi heurte?
Ouurez. On aura, que ie penſe,	Ouvrez. On aura, que je pense,
Grande joye à me voir, apres dix jours d'abſence.	Grande joie à me voir, après dix jours d’absence.
Qui va là?	Qui va là?
Moy.	Moi.
Georgette?	Georgette?
Hé bien?	Hé bien?
Ouure là bas.	Ouvre là-bas
Vas-y toy.	Vas-y toi.
Vas-y toy.	Vas-y toi.
Ma foy ie n’iray pas.	Ma foi je n’irai pas.
Ie n’iray pas auſſi.	Je n’irai pas aussi.
Belle ceremonie,	Belle cérémonie,
Pour me laiſſer dehors, Hola ho ie vous prie.	Pour me laisser dehors. Holà ho, je vous prie.
Qui frape?	Qui frappe?
Voſtre Maiſtre.	Votre Maître
Alain?	Alain?
Quoy?	Quoi?
C’eſt Monſieur,	C’est Monsieur,
Ouvre viſte.	Ouvre vite.
Ouure, toy.	Ouvre, toi.
Ie ſouffle noſtre feu.	Je souffle notre feu.
I'empeſche, peur du Chat, que mõ Moineau ne ſorte.	J’empêche, peur du Chat, que mon Moineau ne sorte.
Quiconque de vous deux n’ouurira pas la porte,	Quiconque de vous deux n’ouvrira pas la porte,
N'aura point à manger de plus de quatre jours.	N’aura point à manger de plus de quatre jours.
Ha.	Ha.
Par quelle raiſon y venir quand i'y cours.	Par quelle raison y venir quand j'y cours.
Pourquoy plutoſt que moy? le plaiſant ſtrodagéme!	Pourquoi plutôt que moi? le plaisant stratagème!
Oſte-toy donc de là.	Ôte-toi donc de là.
Non, oſte-toy, toy-méme.	Non, ôte-toi, toi-même.
Ie veux ouurir la porte.	Je veux ouvrir la porte.
Et ie veux l'ouurir, moy.	Et je veux l'ouvrir, moi.
Tu ne l'ouuriras pas.	Tu ne l’ouvriras pas.
Ny toy non plus.	Ni toi non plus.
Ny toy.	Ni toi
Il faut que i'aye icy l'ame bien patiente.	Il faut que j’aie ici l’âme bien patiente.
Au moins c’eſt moy, Monſieur.	Au moins c’est moi, Monsieur.
Ie ſuis voſtre Seruante,	Je suis votre Servante,
C'eſt moy.	C’est moi.
Sans le reſpect de Monſieur que voila,	Sans le respect de Monsieur que voilà,
Ie te ....	Je te…
Peſte.	Peste
Pardon	Pardon
Voyez ce lourdaut là.	Voyez ce lourdaud-là.
C’eſt elle auſſi, Monſieur....	C’est elle aussi, Monsieur…
Que tous deux on ſe taiſe.	Que tous deux on se taise.
Songez à me répondre, & laiſſons la fadaiſe.	Songez à me répondre, et laissons la fadaise.
Hé bien, Alain, comment ſe porre-t'on icy?	Hé bien, Alain, comment se porte-t-on ici?
Monſieur, nous nous... Monſieur, nous nous por... Dieu mercy;	Monsieur, nous nous… Monsieur, nous nous por… Dieu merci;
Nous nous...	Nous nous…
Qui vous apprend, impertinente beſte,	Qui vous apprend, impertinente bête,
A parler deuant moy, le chapeau ſur la teſte?	À parler devant moi, le chapeau sur le tête?
Vous faites bien, i'ay tort.	Vous faites bien, j’ai tort.
Faites deſcendre Agnés.	Faites descendre Agnès.
Lors que ie m’en allay, fut-elle triſte aprés?	Lorsque je m’en allai, fut-elle triste après?
Triſte! Non.	Triste? Non.
Non!	Non!
Sifait.	Si fait.
Pourquoy donc....	Pourquoi donc…
Oüy, ie meure,	Oui, je meure,
Elle vous croyoit voir de retour à toute heure;	Elle vous croyait voir de retour à toute heure;
Et nous n’oyions iamais paſſer deuant chez nous,	Et nous n’oyions jamais passer devant chez nous,
Cheual, Aſne, ou Mulet, qu’elle ne priſt pour vous.	Cheval, Âne, ou Mulet, qu’elle ne prît pour vous.
LA beſogne à la main, c’eſt vn bon témoignage.	LA besogne à la main, c’est un bon témoignage.
Hé bien, Agnés, ie ſuis de retour du voyage,	Hé bien, Agnès, je suis de retour du voyage,
En eſtes-vous bien aiſe?	En êtes-vous bien aise?
Oüy, Monſieur, Dieu mercy.	Oui, Monsieur, Dieu merci.
Et moy de vous reuoir, ie ſuis bien aiſe auſſi:	Et moi de vous revoir, je suis bien aise aussi:
Vous vous eſtes toûjours, cõme on voit, bien portée?	Vous vous êtes toujours, comme on voit, bien portée?
Hors les puces, qui m'ont la nuit inquietée.	Hors les puces, qui m’ont la nuit inquiétée.
Ah! vous aurez dans peu quelqu'vn pour les chaſſer.	Ah! vous aurez dans peu quelqu’un pour les chasser.
Vous me ferez plaiſir.	Vous me ferez plaisir.
Ie le puis bien penſer.	Je le puis bien penser.
Que faites-vous donc là?	Que faites-vous donc là?
Ie me fais des Cornettes,	Je me fais des Cornettes,
Vos Chemiſes de nuit, & vos Coiffes ſont faites.	Vos Chemises de nuit, et vos Coiffes sont faites.
Ha! voila qui va bien; allez, montez là-haut,	Ha! voila qui va bien; allez, montez là haut,
Ne vous ennuyez point, ie reuiendray tantoſt,	Ne vous ennuyez point, je reviendrai tantôt,
Et ie vous parleray d'affaires importantes.	Et je vous parlerai d’affaires importantes.
Héroïnes du temps, Meſdames les Sçauantes,	Héroïnes du temps, Mesdames les Savantes,
Pouſſeuſes de tendreſſe & de beaux ſentimens,	Pousseuses de tendresse et de beaux sentiments,
Ie défie à la fois tous vos Vers, vos Romans,	Je défie à la fois tous vos Vers, vos Romans,
Vos Lettres, Billets doux, toute voſtre Science,	Vos Lettres, Billets doux, toute votre Science,
De valoir cette honneſte & pudique ignorance.	De valoir cette honnête et pudique ignorance.
CE n’eſt point par le bien qu’il faut eſtre ébloüy;	Ce n’est point par le bien qu’il faut être ébloui;
Et pourueu que l’honneur ſoit.... Que vois-je? Eſt-ce?... Oüy.	Et pourvu que l’honneur soit… Que vois-je? Est-ce?… Oui.
Ie me trompe. Nenny. Sifait. Non, c’eſt luy-même.	Je me trompe. Nenni. Si fait. Non, c’est lui-même.
Hor....	Hor…
Seigneur Ar....	Seigneur Ar…
Horace.	Horace.
Arnolphe.	Arnolphe.
Ah! joye extréme!	Ah! joie extrême!
Et depuis quand icy?	Et depuis quand ici?
Depuis neuf jours.	Depuis neuf jours.
Vrayment....	Vraiment…
Ie fus d'abord chez vous, mais inutilement.	Je fus d’abord chez vous, mais inutilement.
I'eſtois à la campagne.	J’étais à la campagne.
Oüy, depuis deux journées.	Oui, depuis deux journées.
O comme les enfans croiſſent en peu d’années!	Ô comme les enfants croissent en peu d’années!
I’admire de le voir au poinct où le voila,	J’admire de le voir au point où le voilà,
Apres que ie l’ay veu pas plus grand que cela.	Après que je l’ai vu pas plus grand que cela.
Vous voyez.	Vous voyez.
Mais, de grâce, Oronte voſtre Pere,	Mais, de grâce, Oronte votre Père,
Mon bon & cher Amy, que i’eſtime & reuere,	Mon bon et cher Ami, que j’estime et révère,
Que fait-il? que dit-il? eſt-il toûjours gaillard?	Que fait-il? que dit-il ? est-il toujours gaillard?
A tout ce qui le touche, il ſçait que ie prens part.	À tout ce qui le touche, il sait que je prends part.
Nous ne nous sõmes veus depuis quatre ans ensẽble,	Nous ne nous sommes vus depuis quatre ans ensemble.
Ny, qui plus eſt, écrit l'vn à l'autre, me ſemble.	Ni, qui plus est, écrit l’un à l’autre, me semble.
Il eſt, Seigneur Arnolphe, encor plus gay que nous,	Il est, Seigneur Arnolphe, encore plus gai que nous,
Et i'auois de ſa part vne Lettre pour vous;	Et j’avais de sa part une Lettre pour vous;
Mais depuis par vne autre il m’apprend ſa venuë,	Mais depuis par une autre il m’apprend sa venue,
Et la raiſon encor ne m’en eſt pas connuë.	Et la raison encor ne m’en est pas connue.
Sçauez-vous qui peut-eſtre vn de vos Citoyens,	Savez-vous qui peut être un de vos Citoyens,
Qui retourne en ces lieux auec beaucoup de biens,	Qui retourne en ces lieux avec beaucoup de biens,
Qu'il s'eſt en quatorze ans acquis dans l'Amerique?	Qu’il s’est en quatorze ans acquis dans l’Amérique?
Non: Vous a-t'on point dit cõme on le nomme?	Non: vous a-t-on point dit comme on le nomme?
Enrique.	Enrique.
Non.	Non.
Mon Pere m'en parle, & qu’il eſt reuenu,	Mon Père m'en parle, et qu'il est revenu,
Comme s'il deuoit m'eſtre entierement connu,	Comme s’il devait m’être entièrement connu,
Et m’écrit qu’en chemin enſemble ils ſe võt mettre,	Et m’écrit qu’en chemin ensemble ils se vont mettre,
Pour vn fait important que ne dit point ſa Lettre,	Pour un fait important que ne dit point sa Lettre.
I’auray certainement grande joye à le voir,	J’aurai certainement grande joie à le voir,
Et pour le regaler, ie feray mon pouuoir.	Et pour le régaler, je ferai mon pouvoir.
Il faut, pour des Amis, des Lettres moins ciuiles,	Il faut, pour des Amis, des Lettres moins civiles,
Et tous ces complims ſont choſes inutiles;	Et tous ces compliments sont choses inutiles;
Sans qu'il priſt le ſoucy de m’en écrire rien,	Sans qu’il prît le souci de m’en écrire rien,
Vous pouuez librement diſpoſer de mon bien.	Vous pouvez librement disposer de mon bien.
Ie ſuis Homme à ſaiſir les gens par leurs parole,	Je suis Homme à saisir les gens par leurs paroles,
Et i'ay preſentement beſoin de cent piſtoles.	Et j’ai présentement besoin de cent pistoles.
Ma foy, c’eſt m'obliger, que d’en vſer ainſi,	Ma foi, c’est m’obliger, que d’en user ainsi,
Et ie me réjoüis de les auoir icy.	Et je me réjouis de les avoir ici.
Gardez auſſi la bourſe.	Gardez aussi la bourse.
Il faut....	Il faut…
Laiſſons ce ſtile.	Laissons ce style.
Hé bien, comment encor trouuez-vous cette Ville?	Hé bien, comment encor trouvez-vous cette Ville?
Nombreuſe en Citoyens, ſuperbe en baſtimens,	Nombreuse en Citoyens, superbe en bâtiments,
Et i’en croy merueilleux les diuertiſſemens.	Et j’en crois merveilleux les divertissements.
Chacun a ſes plaiſirs, qu’il ſe fait à ſa guiſe:	Chacun a ses plaisirs, qu’il se fait à sa guise:
Mais pour ceux que du nom de Galans on baptiſe,	Mais pour ceux que du nom de Galants on baptise,
Ils ont en ce Païs dequoy ſe contenter,	Ils ont de ce Pays de quoi se contenter,
Car les Femmes y ſont faites à coquetter.	Car les Femmes y sont faites à coqueter.
On trouue d’humeur douce & la brune, & la blonde,	On trouve d’humeur douce et la brune, et la blonde,
Et les Maris auſſi les plus benins du monde:	Et les Maris aussi les plus bénins du monde:
C’eft vn plaiſir de Prince, & des tours que ie voy,	C’est un plaisir de Prince, et des tours que je vois,
Ie me donne ſouuent la Comedie à moy.	Je me donne souvent la Comédie à moi.
Peut-eſtre en auez-vous déja féru quelqu’vne:	Peut-être en avez-vous déjà féru quelqu’une:
Vous eſt-il point encor arriué de fortune?	Vous est-il point encore arrivé de fortune?
Les gens faits comme vous, font plus que les écus,	Les gens faits comme vous, font plus que les écus,
Et vous eſtes de taille à faire des Cocus.	Et vous êtes de taille à faire des Cocus.
A ne vous rien cacher de la verité pure,	À ne vous rien cacher de la vérité pure,
I’ay d’amour en ces lieux eu certaine auanture,	J’ai d’amour en ces lieux eu certaine aventure,
Et l'amitié m'oblige à vous en faire part.	Et l’amitié m’oblige à vous faire part.
Bon, voicy de nouueau quelque conte gaillard,	Bon, voici de nouveau quelque conte gaillard,
Et ce ſera dequoy mettre ſur mes tablettes.	Et ce sera de quoi mettre sur mes tablettes.
Mais, de grace, qu’au moins ces choſes ſoiẽt ſecrettes.	Mais, de grâce, qu’au moins ces choses soient secrètes.
Oh.	Oh.
Vous n’ignorez pas qu'en ces occaſions	Vous n’ignorez pas qu'en ces occasions
Vn ſecret éuenté rompt nos pretentions.	Un secret éventé rompt nos prétentions.
Ie vous auoüeray donc auec pleine franchiſe,	Je vous avouerai donc avec pleine franchise,
Qu'icy d’vne Beauté mon ame s’eſt épriſe:	Qu’ici d’une Beauté mon âme s’est éprise.
Mes petits ſoins d’abord ont eu tant de ſuccés,	Mes petits soins d’abord ont eu tant de succès,
Que ie me ſuis chez elle ouvert vn doux accés;	Que je me suis chez elle ouvert un doux accès;
Et ſans trop me vanter, ny luy faire vne injure,	Et sans trop me vanter ni lui faire une injure,
Mes affaires y ſont en fort bonne poſture.	Mes affaires y sont en fort bonne posture.
Et c’eſt?	Et c’est?
Vn jeune objet qui loge en ce logis,	Un jeune objet qui loge en ce logis,
Dont vous voyez d’icy que les murs ſont rougis,	Dont vous voyez d’ici que les murs sont rougis;
Simple à la vérité, par l’erreur ſans ſeconde	Simple à la vérité, par l’erreur sans seconde
D’vn Homme qui la cache au commerce du monde,	D’un Homme qui la cache au commerce du monde,
Mais qui dans l’ignorance où l’on veut l’aſſeruir,	Mais qui dans l’ignorance où l’on veut l’asservir,
Fait briller des attraits capables de rauir,	Fait briller des attraits capables de ravir,
Vn air tout engageant, ie ne ſçay quoy de tendre,	Un air tout engageant, je ne sais quoi de tendre,
Dont il n’eſt point de cœur qui ſe puiſſe defendre:	Dont il n’est point de cœur qui se puisse défendre:
Mais, peut-eſtre, il n’eſt pas que vous n’ayez bien veu	Mais, peut-être, il n’est pas que vous n’ayez bien vu
Ce jeune Aſtre d'amour de tant d'attraits pourueu:	Ce jeune Astre d’amour de tant d’attraits pourvu:
C'eſt Agnés qu'on l'appelle.	C’est Agnès qu’on l’appelle.
Ah! ie creue.	Ah! je crève.
Pour l'Homme,	Pour l'Homme,
C’eſt, ie croy, de la Zouſſe, ou Souche, qu'on le nõme,	C’est, je crois, de la Zousse, ou Source, qu’on le nomme,
Ie ne me ſuis pas fort arreſté ſur le nom;	Je ne me suis pas fort arrêté sur le nom;
Riche, à ce qu’on m'a dit, mais des plus ſenſez, non,	Riche, à ce qu’on m’a dit, mais des plus sensés, non,
Et l'on m'en a parlé comme d'vn Ridicule.	Et l’on m’en a parlé comme d’un Ridicule.
Le connoiſſez-vous point?	Le connaissez-vous point?
La fâcheuſe pilule!	La fâcheuse pilule!
Eh! vous ne dites mot.	Eh! vous ne dites mot?
Eh oüy, ie le connoy.	Eh oui, je le connais.
C’eſt vn fou, n’eſt-ce pas?	C’est un fou, n’est-ce pas?
Eh....	Eh…
Qu'en dites-vous? quoy?	Qu'en dites-vous? quoi?
Eh? c’eſt à dire oüy. Ialoux? à faire rire.	Eh? c’est-à-dire oui. Jaloux? à faire rire.
Sot? ie voy qu'il en eſt ce que l'on m'a pû dire.	Sot? je vois qu’il en est ce que l’on m’a pu dire.
Enfin l'aimable Agnés a ſceu m’aſſujettir,	Enfin l’aimable Agnès a su m’assujettir.
C'eſt vn joly bijou, pour ne vous point mentir,	C’est un joli bijou, pour ne vous point mentir,
Et ce ſeroit peché, qu’vne Beauté ſi rare	Et ce serait péché, qu’une Beauté si rare
Fut laiſſée au pouuoir de cet Homme bizarre.	Fût laissée au pouvoir de cet Homme bizarre.
Pour moy, tous mes efforts, to9 mes vœux les pl9 doux,	Pour moi, tous mes efforts, tous mes vœux les plus doux,
Vont à m'en rendre maiſtre, en dépit du jaloux;	Vont à m’en rendre maître, en dépit du jaloux;
Et l'argent que de vous i'emprunte auec franchiſe,	Et l’argent que de vous j’emprunte avec franchise,
N'eſt que pour mettre à bout cette juſte entrepriſe.	N’est que pour mettre à bout cette juste entreprise.
Vo9 ſçauez mieux que moi quelsque ſoiẽt nos efforts,	Vous savez mieux que moi quels que soient nos efforts,
Que l'argent eſt la clef de tous les grands reſſorts,	Que l’argent est la clef de tous les grands ressorts,
Et que ce doux metal qui frape tant de teſtes,	Et que ce doux métal qui frappe tant de têtes,
En amour, comme en guerre, auance les conqueſtes.	En amour, comme en guerre, avance les conquêtes.
Vous me ſemblez chagrin; ſeroit-ce qu’en effet	Vous me semblez chagrin; serait-ce qu’en effet
Vous deſaprouueriez le deſſein que i’ay fait?	Vous désapprouveriez le dessein que j’ai fait?
Non, c’eſt que ie ſongeois....	Non, c’est que je songeais…
Cet entretien vous laſſe;	Cet entretien vous lasse;
Adieu, i'iray chez vous tantoſt vous rendre grace.	Adieu, j’irai chez vous tantôt vous rendre grâce.
Ah! faut-il....	Ah! faut-il…
Derechef, veuillez eſtre diſcret,	Derechef, veuillez être discret,
Et n’allez pas, de grace, éuenter mon ſecret.	Et n’allez pas, de grâce, éventer mon secret.
Que ie ſens dans mon ame....	Que je sens dans mon âme…
Et ſur tout à mon Pere,	Et sur tout à mon Père,
Qui s'en feroit peut-eſtre vn ſujet de colere.	Qui s’en ferait peut-être un sujet de colère.
Oh.... Oh que i'ay ſouffert durant cet entretien!	Oh… Oh que j’ai souffert durant cet entretien!
Jamais trouble d’eſprit ne fut égal au mien.	Jamais trouble d’esprit ne fut égal au mien.
Auec quelle imprudence, & quelle haſte extréme,	Avec quelle imprudence, et quelle hâte extrême,
Il m'eſt venu conter cette affaire à moy-méme!	Il m’est venu conter cette affaire à moi-même!
Bien que mon autre nom le tienne dans l’erreur,	Bien que mon autre nom le tienne dans l’erreur,
Etourdy, montra-t'il iamais tant de fureur?	Étourdi, montra-t-il jamais tant de fureur?
Mais ayant tant ſouffert, ie deuois me contraindre,	Mais ayant tant souffert, je devais me contraindre,
Iuſques à m'éclaircir de ce que ie dois craindre,	Jusques à m’éclaircir de ce que je dois craindre,
A pouſſer juſqu'au bout ſon caquet indiſcret,	À pousser jusqu’au bout son caquet indiscret,
Et ſçauoir pleinement leur commerce ſecret.	Et savoir pleinement leur commerce secret.
Tâchons à le rejoindre, il n’eſt pas loin ie penſe,	Tâchons à le rejoindre, il n’est pas loin, je pense,
Tirons-en de ce fait l'entiere confidence;	Tirons-en de ce fait l’entière confidence;
Ie tremble du malheur qui m'en peut arriuer,	Je tremble du malheur qui m’en peut arriver,
Et l'on cherche ſouuent plus qu’on ne veut trouuer.	Et l’on cherche souvent plus qu’on ne veut trouver.
IL m’eſt, lors que i’y penſe, auantageux ſans doute,	Il m’est, lorsque j’y pense, avantageux sans doute,
D’auoir perdu mes pas, & pû manquer ſa route:	D’avoir perdu mes pas, et pu manquer sa route:
Car enfin, de mon cœur le trouble imperieux,	Car enfin, de mon cœur le trouble impérieux,
N’euſt pu ſe renfermer tout entier à ſes yeux,	N’eût pu se renfermer tout entier à ses yeux,
Il euſt fait éclater l’ennuy qui me deuore,	Il eût fait éclater l’ennui qui me dévore,
Et ie ne voudrois pas qu'il ſceût ce qu'il ignore.	Et je ne voudrais pas qu’il sût ce qu’il ignore.
Mais ie ne ſuis pas Homme à gober le morceau,	Mais je ne suis pas Homme à gober le morceau,
Et laiſſer vn champ libre aux vœux du Damoiſeau,	Et laisser un champ libre aux vœux du Damoiseau,
I’en veux rompre le cours, & ſans tarder, apprendre	J’en veux rompre le cours, et sans tarder, apprendre
luſqu'où l'intelligence entr'eux a pû s’étendre:	Jusqu’où l’intelligence entre eux a pu s’étendre:
I’y prens, pour mon honneur, vn notable intereſt,	J’y prends, pour mon honneur, un notable intérêt;
Ie la regarde en femme, aux termes quelle en eſt,	Je la regarde en Femme, aux termes qu’elle en est,
Elle n’a pû faillir, ſans me couurir de honte,	Elle n’a pu faillir, sans me couvrir de honte,
Et tout ce qu’elle a fait, enfin eſt ſur mon compte.	Et tout ce qu’elle a fait, enfin est sur mon compte.
Eloignement fatal! Voyage malheureux!	Éloignement fatal! Voyage malheureux!
AH! Monſieur, cette fois..	Ah! Monsieur, cette fois…
Paix. Venez-çà tous deux:	Paix. Venez-çà tous deux:
Paſſez-là, paſſez-là. Venez-là, venez dis-je.	Passez-là, passez-là. Venez-là, venez dis-je.
Ah! vous me faites peur, & tout mon ſang ſe fige.	Ah! vous me faites peur, et tout mon sang se fige.
C’eſt donc ainſi, qu'abſent, vous m’auez obey,	C’est donc ainsi, qu’absent, vous m’avez obéi,
Et tous deux, de concert, vous m’auez donc trahy?	Et tous deux, de concert, vous m’avez donc trahi?
Eh ne me mangez pas, Monſieur, ie vous conjure.	Eh ne me mangez pas, Monsieur, je vous conjure.
Quelque Chien enragé l'a mordu, ie m’aſſeure.	Quelque Chien enragé l’a mordu, je m’assure.
Ouf. le ne puis parler, tant ie ſuis préuenu,	Ouf. Je ne puis parler, tant je suis prévenu,
Ie ſuffoque, & voudrois me pouuoir mettre nû.	Je suffoque, et voudrais me pouvoir mettre nu.
Vous auez donc ſouffert, ô canaille maudite,	Vous avez donc souffert, ô canaille maudite,
Qu'vn Hõme soit venu.... Tu veux prendre la fuite?	Qu’un Homme soit venu… Tu veux prendre la fuite?
Il faut que ſur le champ... Si tu bouges.... Ie veux	Il faut que sur-le-champ… Si tu bouges… Je veux
Que vous me diſiez... Euh? Oüy, ie veux que to9 deux...	Que vous me disiez… Euh? Oui, je veux que tous deux…
Quiconque remûra, par la mort, ie l'aſſomme.	Quiconque remuera, par la mort, je l’assomme.
Cõme eſt-ce que chez moy s’eſt introduit cet Hõme?	Comme est-ce que chez moi s’est introduit cet Homme?
Eh? parlez, dépeſchez, viſte, promptement, toſt,	Eh? parlez, dépêchez, vite, promptement, tôt,
Sans reſver, veut-on dire?	Sans rêver, veut-on dire?
Ah, ah.	Ah, ah.
Le cœur me faut,	Le cœur me faut,
Ie meurs.	Je meurs.
Ie ſuis en eau, prenons vn peu d'haleine,	Je ſuis en eau, prenons un peu d'haleine,
Il faut que ie m'éuente, & que ie me promeine.	Il faut que je m’évente, et que je me promène.
Aurois-je deuiné, quand ie l'ay veu petit,	Aurais-je deviné, quand je l’ai vu petit,
Qu'il croiſtroit pour cela? Ciel! que mõ cœur pâtit!	Qu’il croîtrait pour cela? Ciel! que mon cœur pâtit!
Ie penſe qu'il vaut mieux que de ſa propre bouche	Je pense qu’il vaut mieux que de sa propre bouche
Ie tire auec douceur l'affaire qui me touche:	Je tire avec douceur l’affaire qui me touche:
Tâchons à modérer noſtre reſſentiment.	Tâchons à modérer notre ressentiment.
Patience, mon cœur, doucement, doucement,	Patience, mon cœur, doucement, doucement.
Leuez-vous, & rentrant, faites qu’Agnés deſcende.	Levez-vous, et rentrant, faites qu’Agnès descende.
Arreſtez. Sa ſurpriſe en deuiendroit moins grande.	Arrêtez. Sa surprise en deviendrait moins grande,
Du chagrin qui me trouble, ils iroient l'auertir;	Du chagrin qui me trouble, ils iraient l’avertir;
Et moy-méme ie veux l'aller faire ſortir.	Et moi-même je veux l’aller faire sortir.
Que l'on m'attende icy.	Que l’on m’attende ici.
MOn Dieu, qu’il eſt terrible!	MOn Dieu, qu'il es terrible!
Ses regards m'ont fait peur, mais vne peur horrible,	Ses regards m’ont fait peur, mais une peur horrible,
Et iamais ie ne vis vn plus hideux Chreſtien.	Et jamais je ne vis un plus hideux Chrétien.
Ce Monſieur l’a fâché, ie te le diſois bien.	Ce Monsieur l’a fâché, je te le disais bien.
Mais que diantre eſt-ce là, qu’auec tant de rudeſſe	Mais que diantre est-ce là, qu’avec tant de rudesse
Il nous fait au logis garder noſtre Maiſtreſſe?	Il nous fait au logis garder notre Maîtresse?
D'où vient qu’à tout le monde il veut tant la cacher,	D’où vient qu’à tout le monde il veut tant la cacher,
Et qu'il ne ſçauroit voir perſonne en approcher?	Et qu’il ne saurait voir personne en approcher?
C’eſt que cette action le met en jalouſie.	C’est que cette action le met en jalousie.
Mais d'où vient qu’il eſt pris de cette fantaiſie?	Mais d’où vient qu’il est pris de cette fantaisie?
Cela vient.... Cela vient, de ce qu'il eſt jaloux.	Cela vient… Cela vient, de ce qu’il est jaloux.
Oüy: mais pourquoy l’eſt-il? & pourquoy ce couroux?	Oui: mais pourquoi l’est-il? et pourquoi ce courroux?
C’eſt que la jalouſie.... Entens-tu bien, Georgette,	C’est que la jalousie… Entends-tu bien, Georgette,
Eſt vne choſe.... la.... qui fait qu’on s’inquiete....	Est une chose… là… qui fait qu’on s’inquiète…
Et qui chaſſe les gens d’autour d'vne maiſon.	Et qui chasse les gens d’autour d’une maison.
Ie m'en vais te bailler vne comparaiſon,	Je m’en vais te bailler une comparaison,
Afin de conceuoir la choſe dauantage.	Afin de concevoir la chose davantage.
Dis-moy, n'eſt-il pas vray, quãd tu tiens ton potage,	Dis-moi, n’est-il pas vrai, quand tu tiens ton potage,
Que ſi quelque affamé venoit pour en manger,	Que si quelque affamé venait pour en manger,
Tu ſerois en colere, & voudrois le charger?	Tu serais en colère, et voudrais le charger?
Oüy, ie comprens cela.	Oui, je comprends cela.
C’eſt juſtement tout comme.	C’est justement tout comme.
La Femme eſt en effet le potage de l'Homme;	La Femme est en effet le potage de l’Homme;
Et quand vn Homme voit d'autres Hõmes par fois,	Et quand un Homme voit d’autres Hommes parfois,
Qui veulent dans ſa ſoupe aller tremper leurs doigts,	Qui veulent dans sa soupe aller tremper leurs doigts,
Il en montre auſſi-toſt vne colere extréme.	Il en montre aussitôt une colère extrême.
Oüy: mais pourquoy chacun n'ẽ fait-il pas de méme?	Oui: mais pourquoi chacun n’en fait-il pas de même?
Et que nous en voyons qui paroiſſent joyeux,	Et que nous en voyons qui paraissent joyeux,
Lors que leurs Femmes ſont auec les biaux Monſieux?	Lorsque leurs Femmes sont avec les beaux Monsieurs?
C’eſt que chacun n’a pas cette amitié gouluë,	C’est que chacun n’a pas cette amitié goulue,
Qui n'en veut que pour ſoy.	Qui n’en veut que pour soi.
Si ie n’ay la berluë,	Si je n’ai la berlue,
Ie le voy qui reuient.	Je le vois qui revient.
Tes yeux ſont bons, c’eſt luy.	Tes yeux sont bons, c’est lui.
Voy comme il eſt chagrin.	Vois comme il est chagrin.
C’eſt qu’il a de l’ennuy.	C’est qu’il a de l’ennui.
VN certain Grec, diſoit à l’Empereur Auguſte,	Un certain Grec, disait à l’Empereur Auguste,
Comme vne inſtruction vtile, autant que iuſte,	Comme une instruction utile, autant que juste,
Que lors qu’vne auanture en colere nous met,	Que lorsqu’une aventure en colère nous met,
Nous deuons auant tout; dire noſtre Alphabet.	Nous devons, avant tout, dire notre Alphabet.
Afin que dans ce temps la bile ſe tempere,	Afin que dans ce temps la bile se tempère,
Et qu’on ne faſſe rien que l'on ne doiue faire.	Et qu’on ne fasse rien que l’on ne doive faire.
I'ay ſuiui ſa leçon ſur le ſujet d’Agnes;	J’ai suivi sa leçon sur le sujet d’Agnès;
Et ie la fais venir dans ce lieu tout exprés,	Et je la fais venir dans ce lieu tout exprès,
Sous pretexte d’y faire vn tour de promenade;	Sous prétexte d’y faire un tour de promenade;
Afin que les ſoupçons de mon eſprit malade	Afin que les soupçons de mon esprit malade
Puiſſent ſur le diſcours la mettre adroitement:	Puissent sur le discours la mettre adroitement:
Et luy ſondant le cœur s’éclaircir doucement.	Et lui sondant le cœur s’éclaircir doucement.
Venez, Agnés. Rentrez.	Venez, Agnès. Rentrez.
La promenade eſt belle.	La promenade est belle.
Fort belle.	Fort belle.
Le beau iour!	Le beau jour!
Fort beau!	Fort beau!
Quelle nouuelle?	Quelle nouvelle?
Le petit chat eſt mort.	Le petit chat est mort.
C’eſt dommage: mais quoy	C’est dommage: mais quoi
Nous ſommes tous mortels, & chacun eſt pour ſoy.	Nous sommes tous mortels, et chacun est pour soi.
Lors que i’eſtois aux champs n’a-t’il point fait de pluye?	Lorsque j’étais aux champs n’a-t-il point fait de pluie?
Non.	Non.
Vous ennuyoit-il?	Vous ennuyait-il?
Iamais ie ne m’ennuye.	Jamais je ne m'ennuie.
Qu'auez-vous fait encor ces neuf ou dix iours-ci?	Qu’avez-vous fait encor ces neuf ou dix jours-ci?
Six chemiſes, ie penſe, & ſix coiffes auſſi.	Six chemises, je pense, et six coiffes aussi.
Le monde, chere Agnes, eſt vne eſtrange choſe.	Le monde, chère Agnès, est une étrange chose.
Voyez la médiſance, & comme chacun cauſe.	Voyez la médisance, et comme chacun cause.
Quelques Voiſins m’ont dit: qu’vn ieune homme inconnu,	Quelques voisins m’ont dit: qu’un jeune homme inconnu,
Eſtoit en mon abſence à la maiſon venu;	Était en mon absence à la maison venu;
Que vous auiez ſouffert ſa veuë & ſes harangues.	Que vous aviez souffert sa vue et ses harangues.
Mais ie nay point pris foy ſur ces méchantes langues;	Mais je n’ai point pris foi sur ces méchantes langues;
Et i’ay voulu gager que c’eſtoit fauſſement....	Et j’ai voulu gager que c’était faussement…
Mon Dieu, ne gagez pas, vous perdriez vrayment.	Mon Dieu, ne gagez pas, vous perdriez vraiment.
Quoy! c’eſt la vérité qu'vn homme...	Quoi! c’est la vérité qu’un homme…
Choſe ſeure.	Chose sûre.
Il n'a preſque bougé de chez nous, ie vous iure.	Il n’a presque bougé de chez nous, je vous jure.
Cet adueu qu’elle fait auec ſincerité,	Cet aveu qu’elle fait avec sincérité,
Me marque pour le moins ſon ingenuité.	Me marque pour le moins son ingénuité.
Mais il me ſemble, Agnes, ſi ma memoire eſt bonne,	Mais il me semble, Agnès, si ma mémoire est bonne,
Que i'auois defendu que vous viſſiez perſonne.	Que j’avais défendu que vous vissiez personne.
Oüy: mais quand ie l'ay veu, vous ignorez pourquoy,	Oui: mais quand je l’ai vu, vous ignorez pourquoi,
Et vous en auriez fait, ſans doute, autant que moy.	Et vous en auriez fait, sans doute, autant que moi.
Peut-eſtre: mais enfin, contez-moy cette Hiſtoire.	Peut-être: mais enfin, contez-moi cette Histoire.
Elle eſt fort eſtonnante & difficile à croire.	Elle est fort étonnante et difficile à croire.
I’eſtois ſur le Balcon à trauaiiler au frais:	J’étais sur le Balcon à travailler au frais:
Lors que ie vis paſſer ſous les arbres d'auprés	Lorsque je vis passer sous les arbres d’auprès
Vn ieune homme bien fait,qui rẽcontrant ma veuë,	Un jeune homme bien fait, qui rencontrant ma vue,
D’vne humble reuerence auſſi-toſt me ſaluë,	D’une humble révérence aussitôt me salue:
Moy, pour ne point manquera la ciuilité,	Moi, pour ne point manquer à la civilité
Ie fis la reuerence auſſi de mon coſté.	Je fis la révérence aussi de mon côté.
Soudain, il me refait vne autre reuerence.	Soudain, il me refait une autre révérence.
Moy, i'en refais de meſme vne autre en diligence;	Moi, j’en refais de même une autre en diligence;
Et luy d’vne troiſieſme auſſi-toſt repartant,	Et lui d’une troisième aussitôt repartant,
D’vne troiſieſme auſſi i’y repars à l’inſtant.	D’une troisième aussi j’y repars à l’instant.
Il paſſe, vient,repaſſe, & touſiours de plus belle	Il passe, vient, repasse, et toujours de plus belle
Me fait à chaque fois reuerence nouuelle.	Me fait à chaque fois révérence nouvelle.
Et moy, qui tous ces tours fixement regardois.	Et moi, qui tous ces tours fixement regardais,
Nouuelle reuerence auſſi ie luy rendois.	Nouvelle révérence aussi je lui rendais.
Tant, que ſi ſur ce point la nuit ne fut venuë,	Tant, que si sur ce point la nuit ne fut venue,
Toûjours comme cela ie me ſerois tenuë.	Toujours comme cela je me serais tenue.
Ne voulant point ceder & receuoir l’ennuy,	Ne voulant point céder et recevoir l’ennui,
Qu'il me puſt eſtimer moins ciuile que luy.	Qu’il me pût estimer moins civile que lui.
Fort bien.	Fort bien.
Le lendemain eſtant ſur noſtre porte,	Le lendemain étant sur notre porte,
Vne vieille m’aborde en parlant de la ſorte.	Une vieille m’aborde en parlant de la sorte.
Mon enfant, le bon-Dieu puiſſe-t'il vous benir,	Mon enfant, le bon Dieu puisse-t-il vous bénir,
Et dans tous vos attraits long-tẽps vous maintenir.	Et dans tous vos attraits longtemps vous maintenir.
Une vous a pas faite vne belle perſonne;	Il ne vous a pas faite une belle personne,
Afin de mal-vſer des choſes qu’il vous donne.	Afin de mal user des choses qu’il vous donne.
Et vous deuez ſçauoir que vous auez bleſſé	Et vous devez savoir que vous avez blessé
Vn cœur, qui de s'en plaindre eſt auiourd’huy forcé.	Un cœur, qui de s’en plaindre est aujourd’hui forcé.
Ah ſupoſt de Sathan, execrable damnée.	Ah suppôt de Satan, exécrable damnée.
Moy, i’ay bleſſé quelqu’vn? fis-je toute eſtonnée,	Moi, j’ai blessé quelqu’un? fis-je toute étonnée,
Oüy, dit-elle, bleſſé, mais bleſſe tout de bon;	Oui, dit-elle, blessé, mais blessé tout de bon;
Et c’eſt l’homme qu’hier vous viſtes du Balcon.	Et c’est l’homme qu’hier vous vîtes du Balcon.
Helas! qui pourroit, dis-je, en auoir eſté cauſe?	Hélas! qui pourrait, dis-je, en avoir été cause?
Sur luy ſans y penſer, fis-je choir quelque choſe?	Sur lui sans y penser, fis-je choir quelque chose?
Non, dit-elle, vos yeux ont fait ce coup fatal,	Non, dit-elle, vos yeux ont fait ce coup fatal,
Et c’eſt de leurs regards qu’eſt venu tout ſon mal.	Et c’est de leurs regards qu’est venu tout son mal.
Hé, mon Dieu! ma ſurpriſe eſt, fis-je, ſans ſeconde.	Hé, mon Dieu! ma surprise est, fis-je, sans seconde.
Mes yeux ont-ils du mal pour en donner au monde?	Mes yeux ont-ils du mal pour en donner au monde?
Oüy, fit-elle, vos yeux, pour cauſer le trépas	Oui, fit-elle, vos yeux, pour causer le trépas
Ma fille, ont vn venin que vous ne ſçauez pas.	Ma fille, ont un venin que vous ne savez pas.
En vn mot, il languit le pauure miſerable.	En un mot, il languit le pauvre misérable.
Et s’il faut, pourſuiuit la vieille charitable,	Et s’il faut, poursuivit la vieille charitable,
Que voſtre cruauté luy refuſe vn ſecours,	Que votre cruauté lui refuse un secours,
C’eſt vn homme à porter en terre dans deux iours.	C’est un homme à porter en terre dans deux jours.
Mon Dieu! i'en aurois, dy-je, vne douleur bien grãde.	Mon Dieu! j’en aurais, dis-je, une douleur bien grande.
Mais pour le ſecourir, qu’eſt-ce qu’il me demande?	Mais pour le secourir, qu’est-ce qu’il me demande?
Mon enfant, me dit-elle, il ne veut obtenir,	Mon enfant, me dit-elle, il ne veut obtenir,
Que le bien de vous voir & vous entretenir.	Que le bien de vous voir et vous entretenir.
Vos yeux peuuent eux ſeuls empeſcher ſa ruine,	Vos yeux peuvent eux seuls empêcher sa ruine,
Et du mal qu’ils ont fait eſtre la medecine.	Et du mal qu’ils ont fait être la médecine.
Helas! volontiers, dis-je, & puis qu’il eſt ainſi,	Hélas! volontiers, dis-je, et puisqu’il est ainsi,
Il peut tant qu’il voudra me venir voir icy.	Il peut tant qu’il voudra me venir voir ici.
Ah ſorciere maudite, empoiſonneuſe d'ames,	Ah! sorcière maudite, empoisonneuse d’âmes,
Puiſſe l’Enfer payer tes charitables trames.	Puisse l’Enfer payer tes charitables trames.
Voila comme il me vit & receut gueriſon.	Voilà comme il me vit et reçut guérison.
Vous-meſme, à voſtre aduis,n'ay-je pas eu raiſon?	Vous-même, à votre avis, n’ai-je pas eu raison?
Et pouuois-je apres tout auoir la conſcience	Et pouvais-je, après tout, avoir la conscience
De le laiſſer mourir faute d’vne aſſiſtance?	De le laisser mourir faute d’une assistance?
Moy qui compâtis tant aux gens qu’on fait ſouffrir,	Moi qui compatis tant aux gens qu’on fait souffrir,
Et ne puis ſans pleurer voir vn poulet mourir.	Et ne puis sans pleurer voir un poulet mourir.
Tout cela n’eſt party que d’vne ame innocente:	Tout cela n’est parti que d’une âme innocente:
Et i’en dois accuſer mon abſence imprudente,	Et j’en dois accuser mon absence imprudente,
Qui ſans guide a laiſſé cette bonté de mœurs	Qui sans guide a laissé cette bonté de mœurs
Expoſée aux aguets des ruſez ſeducteurs.	Exposée aux aguets des rusés séducteurs.
Ie crains que le pendart, dans ſes vœux temeraires,	Je crains que le pendard, dans ses vœux téméraires,
Vn peu plus fort que jeu n’ait pouſſé les affaires.	Un peu plus fort que jeu n’ait poussé les affaires.
Qu'auez-vous? vous grondez, ce me ſemble, vn petit.	Qu’avez-vous; vous grondez, ce me semble, un petit.
Eſt-ce que c’eſt mal fait ce que ie vous ay dit?	Est-ce que c’est mal fait ce que je vous ai dit?
Non. Mais de cette veuë apprenez-moy les ſuites,	Non. Mais de cette vue apprenez-moi les suites,
Et comme le ieune homme a paſſé ſes viſites.	Et comme le jeune homme a passé ses visites.
Helas! ſi vous ſçauiez, comme il eſtoit rauy.	Hélas! si vous saviez, comme il était ravi.
Comme il perdit ſon mal, ſi toſt que ie le vy;	Comme il perdit son mal, sitôt que je le vis;
Le preſent qu’il m’a fait d’vne belle caſſette,	Le présent qu’il m’a fait d’une belle cassette,
Et l’argent qu’en ont eu noſtre Alain & Georgette.	Et l’argent qu’en ont eu notre Alain et Georgette.
Vous l’aymeriez ſans doute, & diriez comme nous...	Vous l’aimeriez sans doute, et diriez comme nous…
Oüy; mais que faiſoit-il eſtant ſeul auec vous?	Oui; mais que faisait-il étant seul avec vous?
Il iuroit, qu’il m’aimoit d’vne amour ſans ſeconde:	Il jurait qu’il m’aimait d’une amour sans seconde:
Et me diſoit des mots les plus gentils du monde:	Et me disait des mots les plus gentils du monde:
Des choſes que iamais rien ne peut égaler.	Des choses que jamais rien ne peut égaler;
Et dont, toutes les fois que ie l'entends parler,	Et dont, toutes les fois que je l’entends parler,
La douceur me chatoüille, & là dedans remuë	La douceur me chatouille, et là-dedans remue
Cettain ie ne ſçay quoy, dont ie ſuis toute émeuë.	Certain je ne sais quoi, dont je suis toute émue.
O fâcheux examen d'vn myftere fatal,	Ô fâcheux examen d’un mystère fatal,
Où l’examinateur ſouffre ſeul tout le mal!	Où l’examinateur souffre seul tout le mal!
Outre tous ces diſcours, toutes ces gentilleſſes,	Outre tous ces discours, toutes ces gentillesses,
Ne vous faiſoit-il point auſſi quelques careſſes?	Ne vous faisait-il point aussi quelques caresses?
Oh tant; il me prenoit & les mains & les bras,	Oh tant; il me prenait et les mains et les bras,
Et de me les baiſer il n’eſtoit iamais las.	Et de me les baiser il n’était jamais las.
Ne vous a-t-il point pris, Agnés, quelqu’autre choſe	Ne vous a-t-il point pris, Agnès, quelque autre chose…
Ouf.	Ouf.
Hé, il m'a...	Hé, il m'a...
Quoy?	Quoi?
Pris...	Pris…
Euh!	euh!
Le...	Le…
Plaiſt-il?	Plaît-il?
Ie n’oſe,	Je n'ose,
Et vous vous faſcherez peut-eſtre contre moy.	Et vous vous fâcherez peut-être contre moi.
Non.	Non.
Si fait.	Si fait
Mon-dieu! non.	Mon dieu! non.
Iurez donc voſtre foy.	Jurez donc votre foi.
Ma foy, ſoit.	Ma foi, soit.
Il m'a pris..... vous ſerez en colere.	Il m’a pris… vous serez en colère.
Non.	Non.
Si.	Si.
Non, non, non, non! Diantre! que de myſtere!	Non, non, non, non! Diantre! que de mystère!
Qu'eſt-ce qu’il vous a pris?	Qu’est-ce qu’il vous a pris?
Il...	Il…
Ie ſouffre en damné.	Je souffre en damné.
Il m'a pris le ruban que vous m’auiez donné.	Il m’a pris le ruban que vous m’aviez donné.
A vous dire le vray, ie n’ay pû men deffendre.	À vous dire le vrai, je n’ai pu m’en défendre.
Paſſe pour le ruban. Mais ie voulois apprendre,	Passe pour le ruban. Mais je voulais apprendre,
S’il ne vous a rien fait que vous baiſer les bras.	S’il ne vous a rien fait que vous baiser les bras.
Comment. Eſt-ce qu’on fait d’autres choſes?	Comment. Est-ce qu’on fait d’autres choses?
Non pas.	Non pas.
Mais pour guerir du mal qu’il dit qui le poſſede,	Mais pour guérir du mal qu’il dit qui le possède,
N’a-t’il point exigé de vous d’autre remede?	N’a-t-il point exigé de vous d’autre remède?
Non. Vous pouuez iuger s’il en euſt demandé,	Non. Vous pouvez juger s’il en eût demandé,
Que pour le ſecourir i’aurois tout accordé.	Que pour le secourir j’aurais tout accordé.
Grace aux bontez du Ciel, i’en ſuis quitte à bon cõte.	Grâce aux bontés du Ciel, j’en suis quitte à bon compte.
Si i’y retombe plus ie veux bien qu’on m’affronte.	Si j’y retombe plus je veux bien qu’on m’affronte.
Chut. De voſtre innocence, Agnés, c’eſt vn effet,	Chut. De votre innocence, Agnès, c’est un effet,
Ie ne vous en dis mot, ce qui s’eſt fait eſt fait.	Je ne vous en dis mot, ce qui s’est fait est fait.
Ie ſçay qu’en vous flattant le Galand ne deſire	Je sais qu’en vous flattant le Galant ne désire
Que de vous abuſer, & puis apres s’en rire.	Que de vous abuser, et puis après s’en rire.
Oh! point. Il me l’a dit plus de vingt fois à moy.	Oh! point. Il me l’a dit plus de vingt fois à moi.
Ah! vous ne ſçauez pas ce que c’eſt que ſa foy.	Ah! vous ne savez pas ce que c’est que sa foi.
Mais enfin: apprenez qu’accepter des caſſettes,	Mais enfin: apprenez qu’accepter des cassettes,
Et de ces beaux blondins écouter les ſornettes:	Et de ces beaux blondins écouter les sornettes:
Que ſe laiſſer par eux à force de langueur	Que se laisser par eux à force de langueur
Baiſer ainſi les mains, & chatoüiller le cœur:	Baiser ainsi les mains, et chatouiller le cœur:
Eſt vn peché mortel des plus gros qu’il ſe faſſe.	Est un péché mortel des plus gros qu’il se fasse.
Vn peché, dites-vous, & la raiſon de grace?	Un péché, dites-vous, et la raison de grâce?
La raiſon? la raiſon, eſt l'arreſt prononcé,	La raison? la raison, est l’arrêt prononcé,
Que par ces actions le Ciel eſt courroucé.	Que par ces actions le Ciel est courroucé.
Courroucé. Mais pourquoy faut-il qu’il s’en courrouce?	Courroucé. Mais pourquoi faut-il qu’il s’en courrouce?
C’eſt vne choſe, helas! ſi plaiſante & ſi douce.	C’est une chose, hélas! si plaisante et si douce.
I’admire quelle ioye on gouſte à tout cela.	J’admire quelle joie on goûte à tout cela.
Et ie ne ſçauois point encor ces choſes-là.	Et je ne savais point encor ces choses-là.
Oüy. C’eſt vn grand plaiſir que toutes ces tendreſſes,	Oui. C’est un grand plaisir que toutes ces tendresses,
Ces propos ſi gentils, & ces douces careſſes:	Ces propos si gentils, et ces douces caresses:
Mais il faut le gouſter en toute honneſteté,	Mais il faut le goûter en toute honnêteté,
Et qu’en ſe mariant le crime en ſoit oſté.	Et qu’en se mariant le crime en soit ôté.
N’eſt-ce plus vn peché lors que l’on ſe marie?	N’est-ce pas un péché lorsque l’on se marie?
Non,	Non.
Mariez-moy donc promptement, ie vous prie.	Mariez-moi donc promptement, je vous prie.
Si vous le ſouhaitez, ie le ſouhaite auſſi,	Si vous le souhaitez, je le souhaite aussi,
Et pour vous marier on me reuoit icy.	Et pour vous marier on me revoit ici.
Eſt-il poſſible?	Est-il possible?
Oüy.	Oui.
Que vous me ferez aiſe!	Que vous me ferez aise!
Oüy; ie ne doute point que l’hymen ne vous plaiſe.	Oui; je ne doute point que l’hymen ne vous plaise.
Vous nous voulez nous deux...	Vous nous voulez nous deux…
Rien de plus aſſeuré.	Rien de plus assuré.
Que ſi cela ſe fait, ie vous careſſeray!	Que si cela se fait, je vous caresserai!
Hé, la choſe ſera de ma part reciproque.	Hé, la chose sera de ma part réciproque.
Ie ne reconnois point pour moy, quand on ſe mocque.	Je ne reconnais point, pour moi, quand on se moque.
Parlez-vous tout de bon?	Parlez-vous tout de bon?
Oüy, vous le pourrez voir.	Oui, vous le pourrez voir.
Nous ſerons mariez?	Nous serons mariés?
Oüy.	Oui.
Mais quand?	Mais quand?
Dés ce ſoir?	Dès ce soir?
Dés ce ſoir.	Dès ce soir.
Dés ce ſoir. Ce la vous fait donc rire?	Dès ce soir. Cela vous fait donc rire?
Oüy.	Oui.
Vous voir bien contente, eſt ce que ie deſire.	Vous voir bien contente, est ce que je désire.
Helas! que ie vous ay grande obligation!	Hélas! que je vous ai grande obligation!
Et, qu’auec luy i'auray de ſatisfaction!	Et qu’avec lui j’aurai de satisfaction!
Auec qui?	Avec qui?
Auec... là.	Avec… là.
Là... là n’eſt pas mon compte.	Là… là n’est pas mon compte.
A choiſir vn mary, vous eſtes vn peu prompte.	À choisir un mari, vous êtes un peu prompte.
C’eſt vn autre en vn mot que ie vous tiens tout preſt,	C’est un autre en un mot que je vous tiens tout prêt,
Et quant au Monſieur, là. Ie pretens, s’il vous plaiſt,	Et quant au Monsieur, là… Je prétends, s’il vous plaît,
Deuſt le mettre au tombeau le mal dõt il vous berce,	Dût le mettre au tombeau le mal dont il vous berce,
Qu'auec luy deſormais vous rompiez tout cõmerce;	Qu’avez lui désormais vous rompiez tout commerce;
Que venant au logis pour voſtre compliment	Que venant au logis, pour votre compliment
Vous luy fermiez au nez la porte honneſtement,	Vous lui fermiez au nez la porte honnêtement,
Et luy iettant, s’il heurte, vn grez par la feneſtre,	Et lui jetant, s’il heurte, un grès par la fenêtre,
L’obligiez tout de bon a ne plus y pareſtre.	L’obligiez tout de bon à ne plus y paraître.
M’entendez-vous, Agnés? moy, caché dans vn coin,	M’entendez-vous, Agnès? Moi, caché dans un coin,
De voſtre procedé ie ſeray le témoin.	De votre procédé je serai le témoin.
Las! il eſt ſi bien fait. C’eſt...	Las! il est si bien fait. c’est…
Ah que de langage!	Ah que de langage!
Ie n'auray pas le cœur...	Je n’aurai pas le cœur…
Point de bruit dauantage.	Point de bruit davantage.
Montez là-haut.	Montez là-haut.
Mais quoy, voulez-vous...	Mais quoi, voulez-vous…
C’eſt aſſez.	C'est assez.
Ie ſuis Maiſtre, ie parle, allez, obeïſſez.	Je suis Maître, je parle, allez, obéissez.
OVY: tout a bien eſté, ma ioye eſt ſans pareille.	OUI: tout a bien été, ma joie est sans pareille.
Vous auez là ſuiui mes ordres à merueille:	Vous avez là suivi mes ordres à merveille:
Confondu de tout poinct le blondin ſeducteur;	Confondu de tout point le blondin séducteur;
Et voila dequoy ſert vn ſage directeur.	Et voilà de quoi sert un sage directeur.
Voſtre innocence, Agnés, auoit eſté ſurpriſe,	Votre innocence, Agnès, avait été surprise,
Voyez, ſans y penſer où vous vous eſtiez miſe.	Voyez, sans y penser où vous vous étiez mise.
Vous enfiliez tout droit, ſans mon inſtruction,	Vous enfiliez tout droit, sans mon instruction,
Le grand chemin d’Enfer & de perdition.	Le grand chemin d’Enfer et de perdition.
De tous ces Damoizeaux on ſçait trop les couſtumes.	De tous ces Damoiseaux on sait trop les coutumes.
Ils ont de beaux canons, force rubans, & plumes,	Ils ont de beaux canons, force rubans, et plumes,
Grãds cheueux, belles dents, & des propos fort doux:	Grands cheveux, belles dents, et des propos fort doux:
Mais comme ie vous dis la griffe eſt là deſſous.	Mais comme je vous dis la griffe est là-dessous.
Et ce ſont vrais Sathans, dont la gueule alterée	Et ce sont vrais Satans, dont la gueule altérée
De l’honneur feminin cherche à faire curée.	De l’honneur féminin cherche à faire curée.
Mais encore vne fois, grace au ſoin apporté,	Mais encore une fois, grâce au soin apporté,
Vous en eſtes ſortie auec honneſteté.	Vous en êtes sortie avec honnêteté.
L’air dont ie vous ay veu luy ietter cette pierre,	L’air dont je vous ai vu lui jeter cette pierre,
Qui de tous ſes deſſeins a mis l’eſpoir par terre,	Qui de tous ses desseins a mis l’espoir par terre,
Me confirme encor mieux à ne point differer	Me confirme encore mieux à ne point différer
Les Nopces, où ie dis qu’il vous faut preparer.	Les Noces, où je dis qu’il vous faut préparer.
Mais auant toute choſe il eſt bon de vous faire	Mais avant toute chose il est bon de vous faire
Quelque petit diſcours, qui vous ſoit ſalutaire.	Quelque petit discours, qui vous soit salutaire.
Vn ſiege au frais icy. Vous, ſi iamais en rien...	Un siège au frais ici. Vous, si jamais en rien…
De toutes vos leçons nous nous ſouuiendrons bien.	De toutes vos leçons nous nous souviendrons bien.
Cet autre Monſieur là nous en faiſoit accroire.	Cet autre Monsieur-là nous en faisait accroire.
Mais....	Mais…
S’il entre iamais, ie veux iamais ne boire.	S’il entre jamais, je veux jamais ne boire.
Auſſi bien eſt-ce vn ſot, il nous a l’autre fois	Aussi bien est-ce un sot, il nous a l’autre fois
Donné deux eſcus d’or qui n’eſtoient pas de poids.	Donné deux écus d’or qui n’étaient pas de poids.
Ayez donc pour ſouper tout ce que ie deſire.	Ayez donc pour souper tout ce que je désire.
Et pour noſtre contract, comme ie viens de dire,	Et pour notre contrat, comme je viens de dire,
Faites venir icy l’vn ou l’autre au retour,	Faites venir ici l’un ou l’autre au retour,
Le Notaire qui loge au coin de ce carfour.	Le Notaire qui loge au coin de ce carrefour.
AGnés, pour m’écouter, laiſſez-là voſtre ouurage.	AGnès, pour m’écouter, laissez-là votre ouvrage.
Leuez vn peu la teſte, & tournez le viſage.	Levez un peu la tête, et tournez le visage.
Là, regardez-moy là, durant cet entretien:	Là, regardez-moi là, durant cet entretien:
Et iuſqu’au moindre mot imprimez-le vous bien.	Et jusqu’au moindre mot imprimez-le-vous bien.
Ie vous épouſe, Agnés, & cent fois la iournée	Je vous épouse, Agnès, et cent fois la journée
Vous deuez benir l’heur de voftre deftinée:	Vous devez bénir l’heur de votre destinée:
Contempler la baſſeſſe où vous auez eſté,	Contempler la bassesse où vous avez été,
Et dans le meſme temps admirer ma bonté,	Et dans le même temps admirer ma bonté,
Qui de ce vil eſtat de pauure Villageoiſe,	Qui de ce vil état de pauvre Villageoise,
Vous fait monter au rang d’honorable Bourgeoiſe:	Vous fait monter au rang d’honorable Bourgeoise:
Et ioüyr de la couche & des embraſſemens,	Et jouir de la couche et des embrassements,
D'vn homme qui fuyoit tous ces engagemens;	D’un homme qui fuyait tous ces engagements;
Et dont à vingt partis fort capables de plaire,	Et dont à vingt partis fort capables de plaire,
Le cœur a refuſé l’honneur qu’il vous veut faire.	Le cœur a refusé l’honneur qu’il vous veut faire.
Vous deuez touſiours, dis-je, auoir deuant les yeux	Vous devez toujours, dis-je, avoir devant les yeux
Le peu que vous eſtiez ſans ce nœud glorieux;	Le peu que vous étiez sans ce nœud glorieux;
Afin que cet obiet d’autant mieux vous inſtruiſe,	Afin que cet objet d’autant mieux vous instruise,
A mériter l’eſtat où ie vous auray miſe;	À mériter l’état où je vous aurai mise;
A touſiours vous connoiſtre, & faire qu’à iamais	À toujours vous connaître, et faire qu’à jamais
Je puiſſe me louër de l’acte que ie fais.	Je puisse me louer de l’acte que je fais.
Le mariage, Agnés, n’eſt pas vn badinage.	Le mariage, Agnès, n’est pas un badinage.
A d'auſteres deuoirs le rang de femme engage:	À d’austères devoirs le rang de femme engage:
Et vous n’y montez pas, à ce que ie pretens,	Et vous n’y montez pas, à ce que je prétends,
Pour eſtre libertine & prendre du bon temps.	Pour être libertine et prendre du bon temps.
Voſtre ſexe n’eſt là que pour la dépendance.	Votre sexe n’est là que pour la dépendance.
Du coſté de la barbe eſt la toute-puiſſance.	Du côté de la barbe est la toute-puissance.
Bien qu’on ſoit deux moitiez de la ſocieté,	Bien qu’on soit deux moitiés de la société,
Ces deux moitiez pourtant n’ont point d’égalité:	Ces deux moitiés pourtant n’ont point d’égalité:
L’vne eſt moitié ſupréme, & l’autre ſubalterne:	L’une est moitié suprême, et l’autre subalterne:
L’vne en tout eſt ſoumiſe à l'autre qui gouuerne.	L’une en tout est soumise à l’autre qui gouverne.
Et ce que le ſoldat dans ſon deuoir inſtruit	Et ce que le soldat dans son devoir instruit
Monſtre d’obeïſſance au Chef qui le conduit,	Montre d’obéissance au Chef qui le conduit,
Le Valet à ſon Maiſtre, vn Enfant à ſon Pere,	Le Valet à son Maître, un Enfant à son Père,
A ſon Superieur le moindre petit Frere,	À son Supérieur le moindre petit Frère,
N’approche point encor de la docilité,	N’approche point encor de la docilité,
Et de l’obeïſſance, & de l’humilité,	Et de l’obéissance, et de l’humilité,
Et du profond reſpect, où la femme doit eſtre	Et du profond respect, où la femme doit être
Pour ſon mari, ſon Chef, ſon Seigneur & ſon Maiſtre.	Pour son mari, son Chef, son Seigneur et son Maître.
Lors qu’il iette ſur elle vn regard ſerieux,	Lors qu’il jette sur elle un regard sérieux,
Son deuoir auſſi-toſt eſt de baiſſer les yeux;	Son devoir aussitôt est de baisser les yeux;
Et de n’oſer iamais le regarder en face	Et de n’oser jamais le regarder en face
Que quand d’vn doux regard il luy veut faire grace.	Que quand d’un doux regard il lui veut faire grâce.
C’eſt ce qu’étendent mal les femmes d’auiourd'huy:	C’est ce qu’entendent mal les femmes d’aujourd’hui:
Mais ne vous gaſtez pas ſur l’exemple d’autruy.	Mais ne vous gâtez pas sur l’exemple d’autrui.
Gardez-vous d’imiter ces coquettes vilaines,	Gardez-vous d’imiter ces coquettes vilaines,
Dont par toute la Ville on chante les fredaines:	Dont par toute la Ville on chante les fredaines:
Et de vous laiſſer prendre aux aſſauts du malin,	Et de vous laisser prendre aux assauts du malin,
C’eſt à dire, d’oüyr aucun ieune blondin.	C’est-à-dire, d’ouïr aucun jeune blondin.
Songez qu’en vous faiſant moitié de ma perſonne;	Songez qu’en vous faisant moitié de ma personne;
C’eſt mon honneur, Agnés, que ie vous abandonne:	C’est mon honneur, Agnès, que je vous abandonne:
Que cet honneur eſt tendre, & ſe bleſſe de peu;	Que cet honneur est tendre, et se blesse de peu;
Que ſur vn tel ſujet il ne fant point de jeu:	Que sur un tel sujet il ne fait point de jeu:
Et qu’il eſt aux Enfers des chaudieres boüillantes,	Et qu’il est aux Enfers des chaudières bouillantes,
Où l’on plonge a iamais les femmes mal viuantes.	Où l’on plonge à jamais les femmes mal vivantes.
Ce que ie vous dis là ne ſont pas des chanſons:	Ce que je vous dis là ne sont pas des chansons:
Et vous deuez du cœur deuorer ces leçons.	Et vous devez du cœur dévorer ces leçons.
Si voſtre ame les ſuit & fuit d’eſtre coquette,	Si votre âme les suit et fuit d’être coquette,
Elle ſera toùjours comme vn lis blanche & nette:	Elle sera toujours comme un lis blanche et nette:
Mais s’il faut qu’à l’honneur elle faſſe vn faux-bon,	Mais s’il faut qu’à l’honneur elle fasse un faux bond,
Elle deuiendra lors noire comme vn charbon.	Elle deviendra lors noire comme un charbon.
Vous paroiſtrez à tous vn obiet effroyable,	Vous paraîtrez à tous un objet effroyable,
Et vous irez vn iour, vray partage du diable,	Et vous irez un jour, vrai partage du diable,
Boüillir dans les Enfers à toute eternité:	Bouillir dans les Enfers à toute éternité:
Dont vous veüille garder la Celeſte bonté.	Dont vous veuille garder la Céleste bonté.
Faites la reuerence. Ainſi qu’vne Nouice	Faites la révérence. Ainsi qu’une Novice
Par cœur dans le Couuent doit ſçauoir ſon office,	Par cœur dans le Couvent doit savoir son office,
Entrant au mariage il en faut faire autant:	Entrant au mariage il en faut faire autant:
Et voicy dans ma poche vn écrit important	Et voici dans ma poche un écrit important
Qui vous enſeignera l’office de la femme.	Qui vous enseignera l’office de la femme.
I’en ignore l’Autheur: mais c'eſt quelque bonne ame.	J’en ignore l’Auteur: mais c’est quelque bonne âme.
Et ie veux que ce ſoit voſtre vnique entretien.	Et je veux que ce soit votre unique entretien.
Tenez: voyons vn peu ſi vous le lirez bien.	Tenez: voyons un peu si vous le lirez bien.
CElle qu'vn lien honneſte,	CElle qu’un lien honnête,
Fait entrer au lict d'autruy:	Fait entrer au lit d’autrui:
Doit ſe mettre dans la teſte,	Doit se mettre dans la tête,
Malgré le train d'auiourd’huy,	Malgré le train d’aujourd’hui,
Que l'hõme qui la prend, ne la prend que pour luy.	Que l’homme qui la prend, ne la prend que pour lui.
Ie vous expliqueray ce que cela veut dire.	Je vous expliquerai ce que cela veut dire.
Mais pour l’heure preſente il ne faut rien que lire.	Mais pour l’heure présente il ne faut rien que lire.
Elle ne ſe doit parer,	Elle ne se doit parer,
Qu'autant que peut deſirer	Qu’autant que peut désirer
Le mari qui la poßede.	Le mari qui la possède.
C'eſt luy que touche ſeul le ſoin de ſa beauté;	C’est lui que touche seul le soin de sa beauté;
Et pour rien doit eſtre conté:	Et pour rien doit être conté:
Que les autres la trouuent laide.	Que les autres la trouvent laide.
Loin, ces eſtudes d'œillades,	Loin, ces études d’œillades,
Ces eaux, ces blancs, ces pommades,	Ces eaux, ces blancs, ces pommades,
Et mille ingrediens qui font des teints fleuris.	Et mille ingrédients qui font des teints fleuris.
A lhonneur tous ler iours ce ſont drogues mortelles.	À l’honneur tous les jours ce sont drogues mortelles.
Et les ſoins de paroiſtre belles	Et les soins de paraître belles
Se prennent peu pour les maris.	Se prennent peu pour les maris.
Sous ſa coiffe en ſortant, comme l'honneur l’ordonne,	Sous sa coiffe en sortant, comme l’honneur l’ordonne,
Il faut que de ſes yeux elle estouffe les coups.	Il faut que de ses yeux elle étouffe les coups
Car pour bien plaire à ſon Eſpoux,	Car pour bien plaire à son Époux,
Elle ne doit plaire à perſonne.	Elle ne doit plaire à personne.
Hors ceux, dont au mari la viſite ſe rend,	Hors ceux dont au mari la visite se rend,
La bonne regle deffend	La bonne règle défend
De receuoir aucune ame.	De recevoir aucune âme.
Ceux qui de galante humeur,	Ceux qui de galante humeur,
N’ont affaire qu'à Madame,	N’ont affaire qu’à Madame,
N'accommodent pas Monſieur.	N’accommodent pas Monsieur.
Il faut des preſens des hommes	Il faut des présents des hommes
Qu'elle ſe deffende bien.	Qu’elle se défende bien.
Car dans le ſiecle où nous ſommes	Car dans le siècle où nous sommes
On ne donne rien pour rien.	On ne donne rien pour rien.
Pans ſes meubles, deus-elle en auoir de l'ennui,	Dans ses meubles, dût-elle en avoir de l’ennui,
Il ne faut eſcritoire, ancre, papier ny plumes.	Il ne faut écritoire, encre, papier ni plumes.
Le mari doit, dans les bonnes couſtumes,	Le mari doit, dans les bonnes coutumes,
Eſcrire tout ce qui s’écrit chez lui.	Écrire tout ce qui s’écrit chez lui.
Ces ſocietez déreglées,	Ces sociétés déréglées,
Qu'on nomme belles aſſemblées,	Qu’on nomme belles assemblées,
Des femmes, tous les iours corrompent les eſprits.	Des femmes, tous les jours corrompent les esprits.
En bonne Politique on les doit interdire;	En bonne Politique on les doit interdire;
Car c'est là, que l'on conſpire	Car c’est là que l’on conspire
Contre les pauures maris.	Contre les pauvres maris.
Toute femme qui veut à l’honneur ſe voüer,	Toute femme qui veut à l’honneur se vouer,
Doit ſe deffendre de ioüer,	Doit se défendre de jouer,
Comme d'vne choſe funeste.	Comme d’une chose funeste.
Car le ieu fort deceuant	Car le jeu fort décevant
Pouſſe vne femme ſouuent,	Pousse une femme souvent,
A ioüer de tout ſon reſte.	À jouer de tout son reste.
Des promenades du temps,	Des promenades du temps,
Ou repas qu'on donne aux champs	Ou repas qu’on donne aux champs
Il ne faut point quelle eſſaye.	Il ne faut point qu’elle essaye.
Selon les prudens cerueaux,	Selon les prudents cerveaux,
Le mari dans ces cadeaux	Le mari dans ces cadeaux
Eſt touſiours ceiuy qui paye.	Est toujours celui qui paye.
Vous acheuerez ſeule, & pas à pas tantoſt	Vous achèverez seule, et pas à pas, tantôt
Ie vous expliqueray ces choſes comme il faut.	Je vous expliquerai ces choses comme il faut.
Ie me ſuis ſouuenu d’vne petite affaire.	Je me suis souvenu d’une petite affaire.
Ie n’ay qu’vn mot à dire, & ne tarderay guere.	Je n’ai qu’un mot à dire, et ne tarderai guère.
Rentrez: & conſeruez ce Liure cherement.	Rentrez: et conservez ce Livre chèrement.
Si le Notaire vient, qu’il m’attende vn moment.	Si le Notaire vient, qu’il m’attende un moment.
IE ne puis faire mieux que d’en faire ma femme.	Je ne puis faire mieux que d’en faire ma femme.
Ainſi que ie voudray, ie tourneray cette ame.	Ainsi que je voudrai, je tournerai cette âme.
Cõme vn morceau de cire entre mes mains elle eſt,	Comme un morceau de cire entre mes mains elle est,
Et ie luy puis donner la forme qui me plaiſt.	Et je lui puis donner la forme qui me plaît.
Il s’en eſt peu fallu que, durant mon abſence,	Il s’en est peu fallu que, durant mon absence,
On ne m’ait attrapé par ſon trop d’innocence,	On ne m’ait attrapé par son trop d’innocence,
Mais il vaut beaucoup mieux, à dire verité,	Mais il vaut beaucoup mieux, à dire vérité,
Que la femme qu’on a pêche de ce coſté.	Que la femme qu’on a pèche de ce côté.
De ces ſortes d’erreurs le remede eſt facile.	De ces sortes d’erreur le remède est facile.
Toute perſonne ſimple aux leçons eſt docile:	Toute personne simple aux leçons est docile:
Et ſi du bon chemin on l’a fait écarter	Et si du bon chemin on l’a fait écarter
Deux mots incontinent l’y peuuent rejetter.	Deux mots incontinent l’y peuvent rejeter.
Mais vne femme habile eſt bien vne autre beſte.	Mais une femme habile est bien une autre bête.
Noſtre ſort ne dépend que de ſa ſeule teſte:	Notre sort ne dépend que de sa seule tête:
De ce qu’elle s’y met, rien ne la fait gauchir,	De ce qu’elle s’y met, rien ne la fait gauchir,
Et nos enſeignemens ne font là que blanchir.	Et nos enseignements ne font là que blanchir.
Son bel eſprit luy ſert a railler nos maximes,	Son bel esprit lui sert à railler nos maximes,
A ſe faire ſouuent des vertus de ſes crimes;	À se faire souvent des vertus de ses crimes;
Et trouuer, pour venir à ſes coupables fins,	Et trouver, pour venir à ses coupables fins,
Des détours à duper l’adreſſe des plus fins.	Des détours à duper l’adresse des plus fins.
Pour ſe parer du coup en vain on ſe fatigue.	Pour se parer du coup en vain on se fatigue.
Vne femme d’eſprit eſt vn diable en intrigue:	Une femme d’esprit est un diable en intrigue:
Et dés que ſon caprice a prononcé tout bas	Et dès que son caprice a prononcé tout bas
L’arreſt de noſtre honneur, il faut paſſer le pas.	L’arrêt de notre honneur, il faut passer le pas.
Beaucoup d’honneſtes gens en pourroient bien que dire.	Beaucoup d’honnêtes gens en pourraient bien que dire.
Enfin mon eſtourdy n’aura pas lieu d’en rire.	Enfin mon étourdi n’aura pas lieu d’en rire.
Par ſon trop de caquet il a ce qu’il luy faut.	Par son trop de caquet il a ce qu’il lui faut.
Voila de nos François l’ordinaire defaut.	Voilà de nos Français l’ordinaire défaut.
Dans la poſſeſſion d’vne bonne fortune,	Dans la possession d’une bonne fortune,
Le ſecret eſt toûjours ce qui les importune;	Le secret est toujours ce qui les importune;
Et la vanité ſotte a pour eux tant d’appas,	Et la vanité sotte a pour eux tant d’appas,
Qu'ils ſe pendroient plutoſt que de ne cauſer pas.	Qu’ils se pendraient plutôt que de ne causer pas.
O que les femmes ſont du diable bien tentées,	Ô que les femmes sont du diable bien tentées,
Lors qu’elles vont choiſir ces teſtes éuentées!	Lorsqu’elles vont choisir ces têtes éventées!
Et que... Mais le voici: cachons-nous toûjours bien,	Et que… Mais le voici: cachons-nous toujours bien,
Et découurons vn peu quel chagrin eſt le ſien.	Et découvrons un peu quel chagrin est le sien.
JE reuiens de chez vous, & le deſtin me montre	Je reviens de chez vous, et le destin me montre
A Qu'il n’a pas reſolu que ie vous y rencontre.	Qu’il n’a pas résolu que je vous y rencontre.
Mais i’iray tant de fois qu’enfin quelque moment...	Mais j’irai tant de fois qu’enfin quelque moment…
Hé mon Dieu! n’entrons point dans ce vain compliment.	Hé mon Dieu! n’entrons point dans ce vain compliment.
Rien ne me faſche tant que ces ceremonies,	Rien ne me fâche tant que ces cérémonies,
Et ſi l’on m’en croyoit, elles ſeroient bannies.	Et si l’on m’en croyait, elles seraient bannies.
C’eſt vn maudit vſage, & la pluſpart des gens	C’est un maudit usage, et la plupart des gens
Y perdent ſottement les deux tiers de leur temps.	Y perdent sottement les deux tiers de leur temps.
Mettons donc ſans façons. Hé bien. vos amourettes.	Mettons donc sans façon. Hé bien vos amourettes.
Puis-ie, Seigneur Horace, apprẽdre où vous en eſtes?	Puis-je, Seigneur Horace, apprendre où vous en êtes?
I’eſtois tantoſt diſtrait par quelque viſion:	J’étais tantôt distrait par quelque vision:
Mais depuis là-deſſus i’ay fait reflexion.	Mais depuis là-dessus j’ai fait réflexion.
De vos premiers progrez i’admire la viteſſe,	De vos premiers progrès j’admire la vitesse,
Et dans l’éuenement mon ame s’intereſſe.	Et dans l’événement mon âme s’intéresse.
Ma foy, depuis qu’à vous s’eſt découuert mon cœur,	Ma foi, depuis qu’à vous s’est découvert mon cœur,
Il eſt à mon amour arriué du malheur.	Il est à mon amour arrivé du malheur.
Oh, oh! comment cela?	Oh, oh! comment cela?
La fortune cruelle,	La fortune cruelle,
A ramené des champs le patron de la belle.	A ramené des champs le patron de la belle.
Quel malheur!	Quel malheur!
Et de plus, à mon tres-grand regret,	Et de plus, à mon très grand regret,
Il a ſceu de nous deux le commerce ſecret.	Il a su de nous deux le commerce secret.
D’où diantre! a-t-il ſi toſt appris cette auanture?	D’où, diantre! a-t-il sitôt appris cette aventure?
Ie ne ſçay. Mais enfin c’eſt vne choſe ſeure.	Je ne sais. Mais enfin c’est une chose sûre.
Ie penſois aller rendre, à mon heure à peu prés,	Je pensais aller rendre, à mon heure, à peu prés,
Ma petite viſite à ſes ieunes attraits.	Ma petite visite à ses jeunes attraits,
Lors que changeant pour moy de ton & de viſage,	Lorsque changeant pour moi de ton et de visage
Et Seruante & Valet m’ont bouché le paſſage,	Et Servante et Valet m’ont bouché le passage,
Et d’vn: retirez-vous, vous nous importunez.	Et d’un: retirez vous, vous nous importunez.
M’ont aſſez rudement fermé la porte au nez.	M’ont assez rudement fermé la porte au nez.
La porte au nez!	La porte au nez!
Au nez.	Au nez.
La choſe eſt vn peu forte.	La chose est un peu forte.
I'ay voulu leur parler au trauers de la porte:	J’ai voulu leur parler au travers de la porte:
Mais à tous mes propos ce qu’ils ont répondu	Mais à tous mes propos ce qu’ils ont répondu
C'eſt, vous n'entrerez point, Monſieur l'a defendu.	C’est, vous n’entrerez point, Monsieur l’a défendu.
Ils n’ont donc point ouuert?	Ils n’ont donc point ouvert?
Non. Et de la feneſtre	Non. Et de la fenêtre
Agnés m’a confirmé le retour de ce Maiſtre;	Agnès m’a confirmé le retour de ce Maître;
En me chaſſant de là d’vn ton plein de fierté,	En me chassant de là d’un ton plein de fierté,
Accompagné d’vn grez que ſa main a ietté.	Accompagné d’un grès que sa main a jeté.
Comment d’vn grez?	Comment d’un grès?
D’vn grez de taille non petite,	D’un grès de taille non petite,
Dont on a par ſes mains regalé ma viſite.	Dont on a par ses mains régalé ma visite.
Diantre! ce ne ſont pas des prunes que cela;	Diantre! ce ne sont pas des prunes que cela;
Et ie trouue faſcheux l’eſtat où vous voila.	Et je trouve fâcheux l’état où vous voilà.
Il eſt vray, ie ſuis mal par ce retour funeſte.	Il est vrai, je suis mal par ce retour funeste.
Certes i’en ſuis faſché pour vous, ie vous proteſte.	Certes j’en suis fâché pour vous, je vous proteste.
Cet homme me rompt tout.	Cet homme me rompt tout.
Oüy, mais cela n’eſt rien,	Oui, mais cela n'est rien,
Et de vous racrocher vous trouuerez moyen.	Et de vous raccrocher vous trouverez moyen.
Il faut bien eſſayer par quelque intelligence	Il faut bien essayer par quelque intelligence
De vaincre du jaloux l'exacte vigilance.	De vaincre du jaloux l’exacte vigilance.
Cela vous eſt facile, & la fille apres tout	Cela vous est facile, et la fille, après tout,
Vous aime.	Vous aime.
Aſſeurément.	Assurément.
Vous en viendrez à bout.	Vous en viendrez à bout.
Ie l’eſpere,	Je l’espère.
Le grés vous a mis en déroute,	Le grès vous a mis en déroute,
Mais cela ne doit pas vous eſtonner.	Mais cela ne doit pas vous étonner.
Sans doute,	Sans doute,
Et i’ay compris d’abord que mon homme eſtoit là,	Et j’ai compris d’abord que mon homme était là,
Qui ſans ſe faire voir conduiſoit tout cela:	Qui sans se faire voir conduisait tout cela:
Mais ce qui m’a ſurpris & qui va vous ſurprendre,	Mais ce qui m’a surpris et qui va vous surprendre,
C’eſt vn autre incident que vous allez entendre,	C’est un autre incident que vous allez entendre,
Vn trait hardy qu’a fait cette ieune beauté,	Un trait hardi qu’a fait cette jeune beauté,
Et qu’on n’attendroit point de ſa ſimplicité;	Et qu’on n’attendrait point de sa simplicité;
Il le faut auoüer, l’amour eſt vn grand maiſtre,	Il le faut avouer, l’amour est un grand maître,
Ce qu’on ne fut iamais il nous enſeigne à l’eſtre,	Ce qu’on ne fut jamais il nous enseigne à l’être,
Et ſouuent de nos mœurs l’abſolu changement	Et souvent de nos mœurs l’absolu changement
Deuient par ſes leçons l’ouurage d’vn moment.	Devient par ses leçons l’ouvrage d’un moment.
De la nature en nous il force les obſtacles,	De la nature en nous il force les obstacles,
Et ſes effets ſoudains ont de l’air des miracles,	Et ses effets soudains ont de l’air des miracles,
D’vn auare à l’inſtant il fait vn liberal:	D’un avare à l’instant il fait un libéral:
Vn Vaillant d’vn Poltron, vn Ciuil d’vn Brutal.	Un Vaillant d’un Poltron, un Civil d’un Brutal.
Il rend agile à tout l’ame la plus peſante,	Il rend agile à tout l’âme la plus pesante,
Et donne de l’eſprit à la plus innocente:	Et donne de l’esprit à la plus innocente:
Ouy, ce dernier miracle éclatte dans Agnés,	Oui, ce dernier miracle éclate dans Agnès,
Car tranchant auec moy par ces termes exprés,	Car tranchant avec moi par ces termes exprès,
Retirez-vous, mon ame aux viſites renonce,	Retirez-vous, mon âme aux visites renonce,
Ie ſçay tous vos diſcours: Et voilà ma reſponce.	Je sais tous vos discours: Et voila ma réponse.
Cette pierre ou ce grés dont vous vous eſtonniez,	Cette pierre ou ce grès dont vous vous étonniez,
Auec vn mot de lettre eſt tombée à mes pieds,	Avec un mot de lettre est tombée à mes pieds,
Et i’admire de voir cette lettre ajuſtée,	Et j’admire de voir cette lettre ajustée,
Auec le ſens des mots; Et la pierre iettée;	Avec le sens des mots; Et la pierre jetée;
D’vne telle action n’eſtes-vous pas ſurpris?	D’une telle action n’êtes-vous pas surpris?
L’amour ſçait-il pas l’art d’aiguiſer les eſprits?	L’Amour sait-il pas l’art d’aiguiser les esprits?
Et peut-on me nier que ſes flames puiſſantes,	Et peut-on me nier que ses flammes puissantes,
Ne faſſent dans vn cœur des choſes eſtonnantes?	Ne fassent dans un cœur des choses étonnantes?
Que dites-vous du tour, & de ce mot d’eſcrit?	Que dites-vous du tour, et de ce mot d’écrit?
Euh! n’admirez-vous point cette adreſſe d’eſprit?	Euh! n’admirez-vous point cette adresse d’esprit?
Trouuez-vous pas plaiſant de voir quel Perſonnage	Trouvez-vous pas plaisant de voir quel Personnage
A ioüé mon jaloux dans tout ce badinage.	A joué mon jaloux dans tout ce badinage.
Dites,	Dites,
Oüy fort plaiſant,	Oui fort plaisant.
Riez-en donc vn peu,	Riez-en donc un peu,
Cét homme gendarmé d’abord contre mon feu,	Cet homme gendarmé d’abord contre mon feu,
Qui chez luy ſe retranche, & de grés fait parade,	Qui chez lui se retranche, et de grès fait parade,
Comme ſi i’y voulois entrer par eſcalade,	Comme si j’y voulais entrer par escalade,
Qui pour me repouſſer dans ſon bizarre effroy,	Qui pour me repousser dans son bizarre effroi,
Anime du dedans tous ſes gens contre moy,	Anime du dedans tous ses gens contre moi,
Et qu’abuſe à ſes yeux par ſa machine meſme,	Et qu’abuse à ses yeux par sa machine même,
Celle qu’il veut tenir dans l’ignorance extréme:	Celle qu’il veut tenir dans l’ignorance extrême:
Pour moy ie vous l’auouë, encor que ſon retour	Pour moi je vous l’avoue, encor que son retour
En vn grand embarras jette icy mon amour,	En un grand embarras jette ici mon amour,
Ie tiens cela plaiſant autant qu’on ſçauroit dire,	Je tiens cela plaisant autant qu’on saurait dire,
Ie ne puis y ſonger ſans de bon cœur en rire.	Je ne puis y songer sans de bon cœur en rire.
Et vous n’enriez pas aſſez à mon auis.	Et vous n’en riez pas assez à mon avis.
Pardonnez-moy, i’en ris tout autant que ie puis.	Pardonnez-moi, j’en ris tout autant que je puis.
Mais il faut qu’en amy ie vous montre la lettre.	Mais il faut qu’en ami je vous montre la lettre.
Tout ce que ſon cœur ſent, ſa main a ſçeu l’y mettre:	Tout ce que son cœur sent, sa main a su l’y mettre:
Mais en termes touchans, & tous pleins de bonté,	Mais en termes touchants, et tous pleins de bonté,
De tendreſſe innocente, & d’ingenuité,	De tendresse innocente, et d’ingénuité,
De la maniere enfin que la pure nature	De la manière enfin que la pure nature
Exprime de l’amour la premiere bleſſure.	Exprime de l’amour la première blessure.
Voilà, friponne, à quoy l’eſcriture te fert,	Voilà, friponne, à quoi l’écriture te sert,
Et contre mon deſſein l’art t’en fut découuert.	Et contre mon dessein l’art t’en fut découvert.
Hom chienne.	Hom chienne.
Qu'auez-vous?	Qu'avez-vous?
Moy? rien; c’eſt que ie touſſe,	Moi? rien; c'est que je tousse,
Auez-vous jamais veu, d’expreſſion plus douce,	Avez-vous jamais vu, d’expression plus douce,
Malgré les ſoins maudits d’vn iniuſte pouuoir,	Malgré les soins maudits d’un injuste pouvoir,
Vn plus beau naturel peut-il ſe faire voir?	Un plus beau naturel peut-il se faire voir?
Et n’eſt-ce pas ſans doute vn crime puniſſable,	Et n’est-ce pas sans doute un crime punissable,
De gaſter meſchamment ce fons d’ame admirable?	De gâter méchamment ce fonds d’âme admirable?
D’auoir dans l’ignorance & la ſtupidité,	D’avoir dans l’ignorance et la stupidité,
Voulu de cét esprit eſtoufer la clarté?	Voulu de cet esprit étouffer la clarté?
L’amour a commencé d’en déchirer le voile,	L’amour a commencé d’en déchirer le voile,
Et ſi par la faueur de quelque bonne eſtoile,	Et si par la faveur de quelque bonne étoile,
Ie puis, comme i’eſpere, à ce franc animal,	Je puis, comme j’espère, à ce franc animal,
Ce traiſtre, ce bourreau, ce faquin, ce brutal......	Ce traître, ce bourreau, ce faquin, ce brutal…
Adieu.	Adieu.
Comment ſi viſte?	Comment si vite?
Il m’eſt dans la pensée	Il m'est dans la pensée
Venu tout maintenant vne affaire preſſée.	Venu tout maintenant une affaire pressée.
Mais ne ſçauriez-vous point comme on la tient de prés,	Mais ne sauriez-vous point, comme on la tient de près,
Qui dans cette maiſon pourroit auoir accés,	Qui dans cette maison pourrait avoir accès,
I’en vſe ſans ſcrupule, & ce n’eſt pas merueille,	J’en use sans scrupule, et ce n’est pas merveille,
Qu’on ſe puiſſe entre amis ſeruir à la pareille,	Qu’on se puisse entre amis servir à la pareille.
Ie n’ay plus là dedans que gens pour m’obſeruer,	Je n’ai plus là-dedans que gens pour m’observer,
Et ſeruante & valet que ie viens de trouuer,	Et servante et valet que je viens de trouver,
N’ont iamais de quelque air que ie m’y ſois pû prendre,	N’ont jamais de quelque air que je m’y sois pu prendre
Adoucy leur rudeſſe à me vouloir entendre,	Adouci leur rudesse à me vouloir entendre,
I’auois pour de tels coups certaine vieille en main,	J’avais pour de tels coups certaine vieille en main,
D’vn genie à vray dire au deſſus de l’humain,	D’un génie à vrai dire au-dessus de l’humain,
Elle m’a dans l’abord ſerui de bonne ſorte:	Elle m’a dans l’abord servi de bonne sorte:
Mais depuis quatre iours la pauure femme eſt morte,	Mais depuis quatre jours la pauvre femme est morte,
Ne me pourriez-vous point ouurir quelque moyen?	Ne me pourriez-vous point ouvrir quelque moyen?
Non vrayment, & ſans moy vous en trouuerez bien.	Non vraiment, et sans moi vous en trouverez bien.
Adieu donc. Vous voyez ce que ie vous confie.	Adieu donc. Vous voyez ce que je vous confie.
COmme il faut deuant lui que ie me mortifie,	COmme il faut devant lui que je me mortifie,
Quelle peine à cacher mon déplaiſir cuiſant.	Quelle peine à cacher mon déplaisir cuisant.
Quoy pour vne innocente, vn eſprit ſi preſent?	Quoi pour une innocente, un esprit si pressent?
Elle a feint d’eſtre telle à mes yeux la traiſtreſſe;	Elle a feint être telle à mes yeux la traîtresse;
Ou le diable à ſon ame a ſouflé cette adreſſe:	Ou le diable à son âme a soufflé cette adresse:
Enfin me voilà mort par ce funeſte eſcrit,	Enfin me voilà mort par ce funeste écrit,
Ie voy qu’il a le traiſtre empaumé ſon eſprit,	Je vois qu’il a le traître empaumé son esprit,
Qu'à ma ſuppreſſion il s’eſt ancré chez elle,	Qu’à ma suppression il s’est ancré chez elle,
Et c’eſt mon deſeſpoir, & ma peine mortelle,	Et c’est mon désespoir, et ma peine mortelle,
Ie ſouffre doublement dans le vol de ſon cœur,	Je souffre doublement dans le vol de son cœur,
Et l’amour y pâtit auſſi bien que l’honneur.	Et l’amour y pâtit aussi bien que l’honneur.
I’enrage de trouuer cette place vſurpée,	J’enrage de trouver cette place usurpée,
Et i’enrage de voir ma prudence trompée.	Et j’enrage de voir ma prudence trompée.
Ie ſçay que pour punir ſon amour libertin	Je sais que pour punir son amour libertin
Ie n’ay qu’à laiſſer faire à ſon mauuais deſtin,	Je n’ai qu’à laisser faire à son mauvais destin,
Que ie ſeray vangé d’elle par elle-meſme:	Que je serai vengé d’elle par elle-même:
Mais il eſt bien faſcheux de perdre ce qu’on aime.	Mais il est bien fâcheux de perdre ce qu’on aime.
Ciel! puiſque pour vn choix i’ay tant Philoſophé,	Ciel! puisque pour un choix j’ai tant Philosophé,
Faut-il de ſes appas m’eſtre ſi fort coëffé?	Faut-il de ses appas m’être si fort coiffé?
Elle n’a ni parens, ni ſupport, ni richeſſe,	Elle n’a ni parents, ni support, ni richesse,
Elle trahit mes ſoins, mes bontez, ma tendreſſe,	Elle trahit mes soins, mes bontés, ma tendresse,
Et cependant ie l’aime, aprés ce laſche tour,	Et cependant je l’aime, après ce lâche tour,
Iuſqu’à ne me pouuoir paſſer de cét amour.	Jusqu’à ne me pouvoir passer de cet amour.
Sot, n’as-tu point de honte, ah ie creue, i’enrage,	Sot, n’as-tu point de honte, ah je crève, j’enrage,
Et ie ſoufleterois mille fois mon viſage,	Et je souffletterais mille fois mon visage,
Ie veux entrer vn peu; mais ſeulement pour voir	Je veux entrer un peu; mais seulement pour voir
Quelle eſt ſa contenance aprés vn trait ſi noir.	Quelle est sa contenance après un trait si noir.
Ciel! faites que mon front ſoit exempt de diſgrace,	Ciel! faites que mon front soit exempt de disgrâce,
Ou bien s’il eſt eſcrit, qu’il faille que i’y paſſe,	Ou bien s’il est écrit, qu’il faille que j’y passe,
Donnez-moy tout au moins pour de tels accidens,	Donnez-moi tout au moins pour de tels accidents
La conſtance qu’on voit à de certaines gens.	La constance qu’on voit à de certaines gens.
I’Ay peine, ie l’auouë, à demeurer en place,	J’ai peine, je l’avoue, à demeurer en place,
Et de mille ſoucis mon eſprit s’embaraſſe,	Et de mille soucis mon esprit s’embarrasse,
Pour pouuoir mettre vn ordre & dedans & dehors,	Pour pouvoir mettre un ordre et dedans et dehors,
Qui du godelureau rompe tous les efforts:	Qui du godelureau rompe tous les efforts:
De quel œil la traiſtreſſe a ſouſtenu ma veuë,	De quel œil la traîtresse a soutenu ma vue,
De tout ce qu’elle a fait elle n’eſt point émeuë.	De tout ce qu’elle a fait elle n’est point émue.
Et bien qu’elle me mette à deux doigts du treſpas,	Et bien qu’elle me mette à deux doigts du trépas,
On diroit à la voir qu’elle n’y touche pas.	On dirait à la voir qu’elle n’y touche pas.
Plus en la regardant ie la voyois tranquile,	Plus en la regardant je la voyais tranquille,
Plus ie ſentois en moy s’eſchaufer vne bile,	Plus je sentais en moi s’échauffer une bile,
Et ces boüillants tranſports dont s’enflammoit mon cœur,	Et ces bouillants transports dont s’enflammait mon cœur,
Y ſembloient redoubler mon amoureuſe ardeur.	Y semblaient redoubler mon amoureuse ardeur.
I’eſtois aigry, faſché, deſeſperé contre elle,	J’étais aigri, fâché, désespéré contre elle,
Et cependant iamais ie ne la vis ſi belle;	Et cependant jamais je ne la vis si belle;
Iamais ſes yeux au miens n’ont paru ſi perçans,	Jamais ses yeux aux miens n’ont paru si perçants,
Iamais ie n’eus pour eux des deſirs ſi preſſans,	Jamais je n’eus pour eux des désirs si pressants,
Et ie ſens là dedans qu’il faudra que ie creue,	Et je sens là-dedans qu’il faudra que je crève,
Si de mon triſte ſort la diſgrace s’acheue.	Si de mon triste sort la disgrâce s’achève.
Quoy? i’auray dirigé ſon education	Quoi? j’aurai dirigé son éducation
Auec tant de tendreſſe & de précaution?	Avec tant de tendresse et de précaution,
Ie l’auray fait paſſer chez moy dés ſon enfance,	Je l’aurai fait passer chez moi dès son enfance,
Et i’en auray chery la plus tendre eſperance.	Et j’en aurai chéri la plus tendre espérance,
Mon cœur aura baſty ſur ſes attraits naiſſans,	Mon cœur aura bâti sur ses attraits naissants,
Et creu la mitonner pour moy durant treize ans.	Et cru la mitonner pour moi durant treize ans,
Afin qu’vn ieune fou dont elle s’amourache	Afin qu’un jeune fou dont elle s’amourache
Me la vienne euleuer iuſque ſur la mouſtache,	Me la vienne enlever jusque sur la moustache,
Lors qu’elle eſt auec moy mariée à demy.	Lorsqu’elle est avec moi mariée à demi.
Non parbleu, non parbleu, petit ſor mon amy,	Non parbleu, non parbleu, petit sot mon ami,
Vous aurez beau tourner où i'y perdray mes peines,	Vous aurez beau tourner ou j’y perdrai mes peines,
Ou ie rendray ma foy, vos eſperances vaines,	Ou je rendrai ma foi, vos espérances vaines,
Et de moy tout à fait vous ne vous rirez point.	Et de moi tout à fait vous ne vous rirez point.
AH le voilà! Bon iour, me voicy tout à point	Ah le voilà! Bonjour, me voici tout à point
Pour dreſſer le contract que vous ſouhaittez faire.	Pour dresser le contrat que vous souhaitez faire.
Comment faire!	Comment faire!
Il le faut dans la forme ordinaire,	Il le faut dans la forme ordinaire,
A mes précautions ie veux ſonger de prés,	À mes précautions je veux songer de près,
Ie ne paſſeray rien contre vos intereſts.	Je ne passerai rien contre vos intérêts.
Il ſe faut garantir de toutes les ſurpriſes.	Il se faut garantir de toutes les surprises.
Suffit qu’entre mes mains vos affaires ſoient miſes,	Suffit qu’entre mes mains vos affaires soient mises,
Il ne vous faudra point de peur d’eſtre deçeu,	Il ne vous faudra point de peur d’être déçu,
Quittancer le Contract que vous n’ayez receu.	Quittancer le Contrat que vous n’ayez reçu.
I’ay peur ſi ie vais faire éclater quelque choſe	J’ai peur si je vais faire éclater quelque chose
Que de cét incident par la ville on ne cauſe.	Que de cet incident par la ville on ne cause.
Et bien il eſt aisé d’empeſcher cét éclat,	Et bien il est aisé d’empêcher cet éclat,
Et l’on peut en ſecret faire voſtre Contract.	Et l’on peut en secret faire votre Contrat.
Mais comment faudra-il qu’auec elle j’en ſorte?	Mais comment faudra-il qu’avec elle j’en sorte?
Le doüaire ſe regle au bien qu’on vous apporte.	Le douaire se règle au bien qu’on vous apporte.
Ie l’ayme, & cét amour eſt mon grand embarras.	Je l’aime, et cet amour est mon grand embarras.
On peut auantager vne femme en ce cas.	On peut avantager une femme en ce cas.
Quel traitemeur luy faire en pareille auanture?	Quel traitement lui faire en pareille aventure?
L’ordre eſt que le futur doit doüer la future	L’ordre est que le futur doit douer la future
Du tiers du dot qu’elle a, mais cét ordre n’eſt rien,	Du tiers du dot qu’elle a, mais cet ordre n’est rien,
Et l’on va plus auant lors que l’on le veut bien.	Et l’on va plus avant lorsque l’on le veut bien.
Si......	Si…
Pour le preciput il les regarde enſemble,	Pour le préciput il les regarde ensemble,
Ie dis que le futur peut comme bon luy ſemble	Je dis que le futur peut comme bon lui semble
Doüer la future.	Douer la future.
Euh!	Euh!
Il peut l’auantager	Il peut l’avantager
Lors qu’il l’ayme beaucoup & qu’il veur l’obliger,	Lors qu’il l’aime beaucoup et qu’il veut l’obliger,
Et cela par doüaire, ou préfix qu’on appelle,	Et cela par douaire, ou préfix qu’on appelle,
Qui demeure perdu par le treſpas d’icelle,	Qui demeure perdu par le trépas d’icelle,
Ou ſans retour, qui va de ladite à ſes hoirs,	Ou sans retour, qui va de ladite à ses hoirs,
Ou Couſtumier, ſelon les differens vouloirs,	Ou Coutumier, selon les différents vouloirs,
Ou par donation dans le Contract formelle,	Ou par donation dans le Contrat formelle,
Qu'on fait, ou pure & ſimple, ou qu’on fait mutuelle;	Qu’on fait, ou pure et simple, ou qu’on fait mutuelle;
Pourquoy hauſſer le dos? eſt-ce qu’on parle en fat,	Pourquoi hausser le dos? est-ce qu’on parle en fat,
Et que l’on ne ſçait pas les formes d’vn Contract?	Et que l’on ne sait pas les formes d’un Contrat?
Qui me les apprendra? perſonne; ie preſume.	Qui me les apprendra? personne; je présume.
Sçais-je pas qu’eſtant joints on eſt par la Couſtume,	Sais-je pas qu’étant joints on est par la Coutume,
Communs en meubles, biens, immeubles & conqueſts,	Communs en meubles, biens, immeubles et conquêts,
A moins que par vn Acte on y renonce exprés?	À moins que par un Acte on y renonce exprès?
Sçay-je pas que le tiers du bien de la future	Sais-je pas que le tiers du bien de la future
Entre en communauté? pour......	Entre en communauté? pour…
Oüy, c’eſt choſe ſeure,	Oui, c'est chose sûre,
Vous ſçauez tout cela, mais qui vous en dit mot?	Vous savez tout cela mais qui vous en dit mot?
Vous qui me pretendez faire paſſer pour ſot,	Vous qui me prétendez faire passer pour sot,
En me hauſſant l’eſpaule, & faiſant la grimace.	En me haussant l’épaule, et faisant la grimace.
La peſte ſoit fait l’homme, & ſa chienne de face.	La peste soit fait l’homme, et sa chienne de face.
Adieu. C’eſt le moyen de vous faire finir.	Adieu. C’est le moyen de vous faire finir.
Pour dreſſer vn Contract m’a-t’on pas fait venir?	Pour dresser un Contrat m’a-t-on pas fait venir?
Ouy, ie vous ay mandé: mais la choſe eſt remiſe,	Oui, je vous ai mandé: mais la chose est remise,
Et l’on vous mandera quand l’heure ſera priſe.	Et l’on vous mandera quand l’heure sera prise.
Voyez quel Diable d’homme auec ſon entretien?	Voyez quel Diable d’homme avec son entretien?
Ie penſe qu’il en tient, & ie croy penſer bien.	Je pense qu’il en tient, et je crois penser bien.
M’Eſtes-vous pas venu querir pour voſtre Maiſtre?	M’êtes-vous pas venu quérir pour votre Maître?
Oüy.	Oui.
I’ignore pour qui vous le pouuez connoiſtre:	J’ignore pour qui vous le pouvez connaître:
Mais allez de ma part luy dire de ce pas	Mais allez de ma part lui dire de ce pas
Que c’eſt vn fou fieffé.	Que c’est un fou fieffé.
Nous n’y manquerons pas.	Nous n’y manquerons pas.
MOnſieur......	MOnsieur…
Approchez-vous, vous eſtes mes fidelles,	Approchez-vous, vous êtes mes fidèles,
Mes bons, mes vrays amis, & i’en ſçay des nouuelles.	Mes bons, mes vrais amis, et j’en sais des nouvelles.
Le Notaire......	Le Notaire…
Laiſſons, c’eſt pour quelqu’autre iour.	Laissons, c’est pour quelque autre jour.
On veut à mon honneur joüer d’vn mauuais tour:	On veut à mon honneur jouer d’un mauvais tour:
Et quel affront pour vous mes enfans pourroit-c’eſtre,	Et quel affront pour vous mes enfants pourrait-ce être,
Si l’on auoit oſté l’honneur à voſtre Maiſtre?	Si l’on avait ôté l’honneur à votre Maître?
Vous n’oſeriez aprés paroiſtre en nul endroit,	Vous n’oseriez après paraître en nul endroit,
Et chacun vous voyant vous monſtreroit au doigt:	Et chacun vous voyant vous montrerait au doigt:
Donc puiſqu’autant que moy l’affaire vous regarde,	Donc puisque autant que moi l’affaire vous regarde,
Il faut de voſtre part faire vne telle garde	Il faut de votre part faire un telle garde
Que ce galand ne puiſſe en aucune façon......	Que ce galant ne puisse en aucune façon…
Vous nous auez tantoſt monſtré noſtre leçon.	Vous nous avez tantôt montré notre leçon.
Mais à ſes beaux diſcours gardez-bien de vous rendre.	Mais à ses beaux discours gardez bien de vous rendre.
Oh vrayment......	Oh vraiment…
Nous ſçauons comme il faut s’en deffendre.	Nous savons comme il faut s’en défendre.
S’il venoit doucement. Alain mon pauure cœur	S’il venait doucement. Alain, mon pauvre cœur
Par vn peu de ſecours ſoulage ma langueur.	Par un peu de secours soulage ma langueur.
Vous eſtes vn ſot.	Vous êtes un sot.
Bon. Georgette ma mignonne	Bon. Georgette ma mignonne
Tu me parois ſi douce, & ſi bonne perſonne.	Tu me parais si douce, et si bonne personne.
Vous eſtes vn nigaut.	Vous êtes un nigaud.
Bon. Quel mal trouues-tu	Bon. Quel mal trouves-tu
Dans vn deſſein honneſte, & tout plein de vertu?	Dans un dessein honnête, et tout plein de vertu?
Vous eſtes vn fripon.	Vous êtes un fripon.
Fort bien. Ma mort eſt ſeure	>Fort bien. Ma mort est sûre
Si tu ne prens pitié des peines que j’endure.	Si tu ne prends pitié des peines que j’endure.
Vous eſtes vn beneſt, vn impudent.	Vous êtes un benêt, un impudent.
Fort bien.	Fort bien.
Ie ne ſuis pas vn homme à vouloir rien pour rien,	Je ne suis pas un homme à vouloir rien pour rien,
Ie ſçay quand on me ſert en garder la memoire:	Je sais quand on me sert en garder la mémoire:
Cependant par auance, Alain voilà pour boire,	Cependant par avance, Alain voilà pour boire,
Et voilà pour t’auoir, Georgette, vn cottillon,	Et voilà pour t’avoir, Georgette, un cotillon,
Ce n’eſt de mes bien-faits qu’vn ſimple eſchãtillon,	Ce n’est de mes bienfaits qu’un simple échantillon,
Toute la courtoiſie enfin dont ie vous preſſe,	Toute la courtoisie enfin dont je vous presse,
C’eſt que ie puiſſe voir voſtre belle Maiſtreſſe.	C’est que je puisse voir votre belle Maîtresse.
A d’autres.	À d’autres.
Bon cela.	Bon cela.
Hors d’icy.	Hors d’ici.
Bon.	Bon.
Mais toſt.	Mais tôt.
Bon. Hola, c’eſt aſſez.	Bon. Holà, c’est assez.
Fais-je pas comme il faut?	Fais-je pas comme il faut?
Eſt-ce de la façon que vous voulez l’entendre?	Est-ce de la façon que vous voulez l’entendre?
Oüy, fort bien, hors l’argent qu’il ne falloit pas prendre.	Oui, fort bien, hors l’argent qu’il ne fallait pas prendre.
Nous ne nous ſommes pas ſouuenus de ce point.	Nous ne nous sommes pas souvenus de ce point.
Voulez-vous qu’à l’inſtant nous recommençions,	Voulez-vous qu’à l’instant nous recommencions,
Point.	Point.
Suffit, rentrez tous deux.	Suffit, rentrez tous deux.
Vous n’auez rien qu'à dire	Vous n’avez rien qu'à dire
Non, vous, dis-je, rentrez, puis que ie le deſire.	Non, non, dis-je, rentrez, puisque je le désire.
Ie vous laiſſe l’argent, allez, ie vous rejoins,	Je vous laisse l’argent, allez, je vous rejoins,
Ayez bien l’oil à tout, & ſecondez mes ſoins.	Ayez bien l’œil à tout, et secondez mes soins.
IE veux pour eſpion qui ſoit d’exacte veuë,	JE veux pour espion qui soit d’exacte vue,
Prendre le Sauetier du coin de noſtre ruë;	Prendre le Savetier du coin de notre rue;
Dans la maiſon touſiours ie pretends la tenir,	Dans la maison toujours je prétends la tenir,
Y faire bonne garde, & ſur tout en bannir	Y faire bonne garde, et sur tout en bannir
Vendeuſes de Ruban, Perruquieres, Coiffeuſes,	Vendeuses de Ruban, Perruquières, Coiffeuses,
Faiſeuſes de Mouchoirs, Gantieres, Reuendeuſes,	Faiseuses de Mouchoirs, Gantières, Revendeuses,
Tous ces gẽs qui ſous main trauaillent chaque iour,	Tous ces gens qui sous main travaillent chaque jour,
A faire reüſſir les myſteres d’amour;	À faire réussir les mystères d’amour;
Enfin i’ay veu le monde, & i’en ſçay les fineſſes,	Enfin j’ai vu le monde, et j’en sais les finesses.
Il faudra que mon homme ait de grandes addreſſes,	Il faudra que mon homme ait de grandes adresses,
Si Meſfage ou Poulet de ſa part peut entrer.	Si Message ou Poulet de sa part peut entrer.
LA place m’eſt heureuſe à vous y rencontrer,	La place m’est heureuse à vous y rencontrer.
Ie viens de l’eſchapper bien belle ie vous iure,	Je viens de l’échapper bien belle je vous jure,
Au ſortir d’auec vous ſans preuoir l’auanture,	Au sortir d’avec vous sans prévoir l’aventure,
Seule dans ſon balcon i’ay veu paroiſtre Agnés,	Seule dans son balcon j’ai vu paraître Agnès,
Qui des arbres prochains prenoit vn peu le frais,	Qui des arbres prochains prenait un peu le frais,
Aprés m’auoir fait ſigne, elle aſceu faire en ſorte	Après m’avoir fait signe, elle a su faire en sorte
Deſcendant au iardin de m’en ouurir la porte:	Descendant au jardin de m’en ouvrir la porte:
Mais à peine tous deux dans ſa chambre eſtions nous,	Mais à peine tous deux dans la chambre étions-nous,
Quelle à ſur les degrez entendu ſon ialoux,	Qu’elle a sur les degrés entendu son jaloux,
Et tout ce qu’elle a pû dans vn tel acceſſoire,	Et tout ce qu’elle a pu dans un tel accessoire,
C’eſt de me renfermer dans vne grande armoire,	C’est de me renfermer dans une grande armoire,
Il eſt entré d’abord; ie ne le voyois pas,	Il est entré d’abord; je ne le voyais pas,
Mais ie l’oyois marcher ſans rien dire à grands pas;	Mais je l’oyais marcher sans rien dire à grands pas;
Pouſſant de temps en temps des ſoupirs pitoyables,	Poussant de temps en temps des soupirs pitoyables,
Et donnant quelquefois de grands coups ſur les tables,	Et donnant quelquefois de grands coups sur les tables,
Frapant vn petit chien qui pour luy s’émouuoit,	Frappant un petit chien qui pour lui s’émouvait,
Et iettant bruſquement les hardes qu’il trouuoit,	Et jetant brusquement les hardes qu’il trouvait,
Il a meſme caſſé d’vne main mutinée,	Il a même cassé, d’une main mutinée,
Des vaſes dont la belle ornoit ſa cheminée,	Des vases dont la belle ornait sa cheminée,
Et ſans doute il faut bien qu’à ce becque cornu,	Et sans doute il faut bien qu’à ce becque cornu,
Du trait qu’elle a ioüé quelque iour ſoit venu,	Du trait qu’elle a joué quelque jour soit venu.
Enfin aprés cent tours ayant de la maniere,	Enfin après cent tours ayant de la manière,
Sur ce qui n’en peut mais déchargé ſa colere,	Sur ce qui n’en peut mais déchargé sa colère,
Mon ialoux inquiet ſans dire ſon ennuy,	Mon jaloux inquiet sans dire son ennui,
Eſt ſorty de la chambre, & moy de mon eſtuy,	Est sorti de la chambre, et moi de mon étui,
Nous n’auons point voulu de peur du perſonnage,	Nous n’avons point voulu de peur du personnage,
Riſquer à nous tenir enſemble dauantage,	Risquer à nous tenir ensemble davantage,
C’eſtoit trop hazarder; mais ie dois cette nuit,	C’était trop hasarder; mais je dois cette nuit,
Dans ſa chambre vn peu tard m’introduire ſans bruit,	Dans sa chambre un peu tard m’introduire sans bruit,
En touſſant par trois fois ie me feray connoiſtre,	En toussant par trois fois je me ferai connaître,
Et ie dois au ſignal voir ouurir la feneſtre,	Et je dois au signal voir ouvrir la fenêtre,
Dont auec vne échelle, & ſecondé d’Agnes,	Dont avec une échelle, et secondé d’Agnès,
Mon amour taſchera de me gagner l’accés,	Mon amour tâchera de me gagner l’accès.
Comme à mon ſeul amy ie veux bien vous l’apprendre,	Comme à mon seul ami je veux bien vous l’apprendre,
L’allegreſſe du cœur s’augmente à la reſpandre,	L’allégresse du cœur s’augmente à la répandre,
Et gouſtaſt-on cent fois vn bon-heur trop parfait,	Et goûtât-on cent fois un bonheur trop parfait,
On n’en eſt pas content ſi quelqu’vn ne le ſçait,	On n’en est pas content si quelqu’un ne le sait,
Vous prendrez part ie penſe à l’heur de mes affaires	Vous prendrez part, je pense, à l’heur de mes affaires
Adieu ie vais ſonger aux choſes neceſſaires.	Adieu je vais songer aux choses nécessaires.
QVoy? l’aſtre qui s’obſtine à me deſeſperer,	QUoi? l’astre qui s’obstine à me désespérer,
Ne me donnera pas le temps de reſpirer,	Ne me donnera pas le temps de respirer,
Coup ſur coup ie verray par leur intelligence,	Coup sur coup je verrai par leur intelligence,
De mes ſoins vigilans confondre la prudence,	De mes soins vigilants confondre la prudence,
Et ie ſeray la dupe en ma maturité,	Et je serai la dupe en ma maturité,
D’vne ieune innocente, & d’vn ieune euenté,	D’une jeune innocente, et d’un jeune éventé,
En ſage Philoſophe on m’a veu vingt années,	En sage Philosophe on m’a vu vingt années,
Contempler des maris les triſtes deſtinées.	Contempler des maris les tristes destinées,
Et m’inſtruire auec ſoin de tous les accidens,	Et m’instruire avec soin de tous les accidents,
Qui font dans le mal-heur tomber les plus prudens,	Qui font dans le malheur tomber les plus prudents,
Des diſgraces d’autruy profitant dans mon ame,	Des disgrâces d’autrui profitant dans mon âme,
I’ay cherché les moyens voulant prendre vne femme,	J’ai cherché les moyens voulant prendre une femme,
De pouuoir garantir mon front de tous affronts,	De pouvoir garantir mon front de tous affronts,
Et le tirer de pair d’auec les autres fronts,	Et le tirer de pair d’avec les autres fronts,
Pour ce noble deſſein i’ay creu mettre en pratique,	Pour ce noble dessein j’ai cru mettre en pratique,
Tout ce que peut trouuer l’humaine Politique,	Tout ce que peut trouver l’humaine Politique,
Et comme ſi du ſort il eſtoit arreſté,	Et comme si du sort il était arrêté,
Que nul homme icy bas n’en ſeroit exempté,	Que nul homme ici-bas n’en serait exempté,
Aprés l’experience, & toutes les lumieres,	Après l’expérience, et toutes les lumières,
Que i’ay pû m’acquerir ſur de telles matieres,	Que j’ai pu m’acquérir sur de telles matières,
Aprés vingt ans & plus, de meditation,	Après vingt ans et plus, de méditation,
Pour me conduire en tout auec precaution,	Pour me conduire en tout avec précaution,
De tant d’autres maris i’aurois quitté la trace,	De tant d’autres maris j’aurais quitté la trace,
Pour me trouuer aprés dans la meſme diſgrace.	Pour me trouver après dans la même disgrâce.
Ah bourreau de deſtin vous en aurez menty,	Ah bourreau de destin vous en aurez menti,
De l’obiet qu’on pourſuit, ie ſuis encor nanty,	De l’objet qu’on poursuit, je suis encor nanti.
Si ſon cœur m’eſt volé par ce blondin funeſte,	Si mon cœur m’est volé par ce blondin funeste,
I’empeſcheray du moins qu’on s’empare du reſte,	J’empêcherai du moins qu’on s’empare du reste,
Et cette nuit qu’on prend pour ce galand exploit,	Et cette nuit qu’on prend pour ce galant exploit,
Ne ſe paſſera pas ſi doucement qu’on croit,	Ne se passera pas si doucement qu’on croit,
Ce m’eſt quelque plaiſir parmy tant de triſteſſe,	Ce m’est quelque plaisir, parmi tant de tristesse,
Que l’on me donne auis du piege qu’on me dreſſe,	Que l’on me donne avis du piège qu’on me dresse,
Et que cét eſtourdy qui veut m’eſtre fatal,	Et que cet étourdi qui veut m’être fatal,
Faſſe ſon confident de ſon propre Riual.	Fasse son confident de son propre Rival.
ET bien, ſouperons-nous auant la promenade?	Et bien souperons-nous avant la promenade?
Non, ie ieuſne ce ſoir.	Non, je jeûne ce soir.
D’où vient cette boutade?	D’où vient cette boutade?
De grace excuſez-moy, i’ay quelqu’autre embarras.	De grâce excusez-moi, j’ai quelque autre embarras.
Voſtre hymen reſolu ne ſe fera-t’il pas?	Votre hymen résolu ne se fera-t-il pas?
C’eſt trop s’inquieter des affaires des autres.	C’est trop s’inquiéter des affaires des autres.
Oh, oh, ſi bruſquement? quels chagrins ſont les voſtres?	Oh, oh, si brusquement? quels chagrins sont les vôtres?
Seroit-il point, compere, à voſtre paſſion,	Serait-il point, compère, à votre passion,
Arriué quelque peu de tribulation?	Arrivé quelque peu de tribulation?
Ie le iurerois preſque à voir voſtre viſage.	Je le jurerais presque à voir votre visage.
Quoy qu’il m’arriue au moins auray-ie l’auantage,	Quoi qu’il m’arrive au moins aurai-je l’avantage,
De ne pas reſſembler à de certaines gens,	De ne pas ressembler à de certaines gens,
Qui ſouffrent doucement l’approche des galans.	Qui souffrent doucement l’approche des galants.
C’eſt vn eſtrange fait qu’auec tant de lumieres.	C’est un étrange fait qu’avec tant de lumières.
Vous vous effarouchiez touſiours ſur ces matieres,	Vous vous effarouchiez toujours sur ces matières,
Qu'en cela vous mettiez le ſouuerain bon-heur,	Qu’en cela vous mettiez le souverain bonheur,
Et ne conceuiez point au monde d’autre honneur,	Et ne conceviez point au monde d’autre honneur,
Eſtre auare, brutal, fourbe, meſchant, & laſche,	Être avare, brutal, fourbe, méchant, et lâche,
N’eſt rien à voſtre auis auprés de cette tache,	N’est rien à votre avis auprès de cette tache,
Et de quelque facon qu’on puiſſe auoir veſcu,	Et de quelque façon qu’on puisse avoir vécu,
On eſt homme d’honneur quand on n’eſt point cocu.	On est homme d’honneur quand on n’est point cocu.
A le bien prendre au fond, pourquoy voulez vous croire,	À le bien prendre au fond, pourquoi voulez-vous croire,
Que de ce cas fortuit dépende noſtre gloire?	Que de ce cas fortuit dépende notre gloire?
Et qu’vne ame bien née ait à ſe reprocher,	Et qu’une âme bien née ait à se reprocher,
L’iniuſtice d’vn mal qu’on ne peut empeſcher?	L’injustice d’un mal qu’on ne peut empêcher?
Pourquoy voulez-vous, dis-ie en prenant vne fẽme,	Pourquoi voulez-vous, dis-je, en prenant une femme,
Qu’on ſoit digne à ſon choix de loüange ou de blaſme,	Qu’on soit digne à son choix de louange ou de blâme,
Et qu’on s’aille former vn monſtre plein d’effroy,	Et qu’on s’aille former un monstre plein d’effroi,
De l’affront que nous fait ſon manquement de foy?	De l’affront que nous fait son manquement de foi?
Mettez-vous dans l’eſprit qu’on peut du cocuage,	Mettez-vous dans l’esprit qu’on peut du cocuage,
Se faire en galand homme vne plus douce image,	Se faire en galant homme une plus douce image,
Que des coups du hazard aucun n’eſtant garant,	Que des coups du hasard aucun n’étant garant,
Cet accident de ſoy doit eſtre indifferend,	Cet accident de soi doit être indifférent,
Et qu’enfin tout le mal quoy que le monde gloſe,	Et qu’enfin tout le mal quoi que le monde glose,
N’eſt que dans la facon de receuoir la choſe	N’est que dans la façon de recevoir la chose
Car pour ſe bien conduire en ces difficultez,	Car pour se bien conduire en ces difficultés,
Il y faut comme en tout fuïr les extremitez,	Il y faut comme en tout fuir les extrémités,
N’imiter pas ces gens vn peu trop débonnaires,	N’imiter pas ces gens un peu trop débonnaires,
Qui tirent vanité de ces ſortes d’affaires;	Qui tirent vanité de ces sortes d’affaires;
De leurs femmes toûjours vont citant les galans,	De leurs femmes toujours vont citant les galants,
En font par tout l’éloge, & proſnent leurs talens,	En font par tout l’éloge, et prônent leurs talents,
Teſmoignent auec eux d’eſtroites ſimpathies,	Témoignent avec eux d’étroites sympathies,
Sont de tous leurs cadeaux, de toutes leurs parties:	Sont de tous leurs cadeaux, de toutes leurs parties:
Et font qu’auec raiſon les gens ſont eſtonnez,	Et font qu’avec raison les gens sont étonnés,
De voir leur hardieſſe à montrer là leur nez.	De voir leur hardiesse à montrer là leur nez.
Ce procedé ſans doute eſt tout à fait blâmable:	Ce procédé sans doute est tout à fait blâmable:
Mais l’autre extrémité n’eſt pas moins condamnable,	Mais l’autre extrémité n’est pas moins condamnable,
Si ie n’approuue pas ces amis des galans,	Si je n’approuve pas ces amis des galants,
Ie ne ſuis pas auſſi pour ces gens turbulens,	Je ne suis pas aussi pour ces gens turbulents,
Dont l’imprudent chagrin qui tempeſte & qui gronde,	Dont l’imprudent chagrin qui tempête et qui gronde,
Attire au bruit qu’il fait les yeux de tout le monde;	Attire au bruit qu’il fait les yeux de tout le monde;
Et qui par cét éclat ſemblent ne pas vouloir	Et qui par cet éclat semblent ne pas vouloir
Qu’aucun puiſſe ignorer ce qu’ils peuuent auoir.	Qu’aucun puisse ignorer ce qu’ils peuvent avoir.
Entre ces deux partis il en eſt vn honneſte,	Entre ces deux partis il en est un honnête,
Où dans l’occaſion l’homme prudent s’arreſte,	Où dans l’occasion l’homme prudent s’arrête,
Et quand on le ſçait prendre on n’a point à rougir,	Et quand on le sait prendre on n’a point à rougir,
Du pis dont vne femme auec nous puiſſe agir.	Du pis dont une femme avec nous puisse agir.
Quoy qu’on en puiſſe dire, enfin le cocuage	Quoi qu’on en puisse dire, enfin le cocuage
Sous des traits moins affreux aisément s’enuiſage:	Sous des traits moins affreux aisément s’envisage:
Et comme ie vous dis, toute l’habilité,	Et comme je vous dis toute l’habileté,
Ne va qu’à le ſçauoir tourner du bon coſté.	Ne va qu’à le savoir tourner du bon côté.
Aprés ce beau diſcours toute la confrerie,	Après ce beau discours, toute la confrérie,
Doit vn remerciment à voſtre Seigneurie:	Doit un remerciement à votre Seigneurie:
Et quiconque voudra vous entendre parler,	Et quiconque voudra vous entendre parler,
Montrera de la ioye à s’y voir enroller.	Montrera de la joie à s’y voir enrôler.
Ie ne dis pas cela, car c'eſt ce que ie blaſme:	Je ne dis pas cela, car c’est ce que je blâme:
Mais comme c’eſt le ſort qui nous donne vne femme,	Mais comme c’est le sort qui nous donne une femme,
Ie dis que l’on doit faire ainſi qu’au jeu de dez,	Je dis que l’on doit faire ainsi qu’au jeu de dés,
Où s’il ne vous vient pas ce que vous demandez.	Où, s’il ne vous vient pas ce que vous demandez.
Il faut joüer d’adreſſe, & d’vne ame reduite,	Il faut jouer d’adresse, et d’une âme réduite,
Corriger le hazard par la bonne conduite.	Corriger le hasard par la bonne conduite.
C’eſt à dire dormir, & manger toûjours bien,	C’est-à-dire dormir, et manger toujours bien,
Et ſe perſuader que tout cela n’eſt rien.	Et se persuader que tout cela n’est rien.
Vous penſez-vous mocquer, mais à ne vous rien feindre,	Vous pensez-vous moquer: mais à ne vous rien feindre,
Dans le monde ie voy cent choſes plus à craindre,	Dans le monde je vois cent choses plus à craindre,
Et dont ie me ferois vn bien plus grand mal-heur,	Et dont je me ferais un bien plus grand malheur,
Que de cét accident qui vous fait tant de peur.	Que de cet accident qui vous fait tant de peur.
Penſez-vous qu’à choiſir de deux choſes preſcrites,	Pensez-vous qu’à choisir de deux choses prescrites,
Ie n’aimaſſe pas mieux eſtre ce que vous dites,	Je n’aimasse pas mieux être ce que vous dites,
Que de me voir mari de ces femmes de bien,	Que de me voir mari de ces femmes de bien,
Dont la mauuaiſe humeur fait vn procés ſur rien.	Dont la mauvaise humeur fait un procès sur rien.
Ces dragons de vertu ces honneſtes Diableſſes,	Ces dragons de vertu, ces honnêtes Diablesses,
Se retranchant touſiours ſur leurs ſages proüeſſes,	Se retranchant toujours sur leurs sages prouesses,
Qui pour vn petit tort qu’elles ne nous font pas,	Qui pour un petit tort qu’elles ne nous font pas,
Prennent droit de traiter les gens de haut en bas,	Prennent droit de traiter les gens de haut en bas,
Et veulent ſur le pied de nous eſtre fidelles,	Et veulent sur le pied de nous être fidèles,
Que nous ſoyons tenus à tout endurer d’elles:	Que nous soyons tenus à tout endurer d’elles:
Encor vn coup Compere, apprenez qu’en effet,	Encor un coup Compère, apprenez qu’en effet,
Le cocuage n’eſt que ce que l’on le fait,	Le Cocuage n’est que ce que l’on le fait,
Qu'on peut le ſounaiter pour de certaines cauſes,	Qu’on peut le souhaiter pour de certaines causes,
Et qu’il a ſes plaiſirs comme les autres choſes.	Et qu’il a ses plaisirs comme les autres choses.
Si vous eſtes d’humeur à vous en contenter?	Si vous êtes d’humeur à vous en contenter?
Quant à moy ce n’eſt pas la mienne d’en tâter;	Quant à moi ce n’est pas la mienne d’en tâter;
Et pluſtoſt que ſubir vne telle auanture.....	Et plutôt que subir une telle aventure…
Mon Dieu ne jurez point de peur d’eſtre parjure;	Mon Dieu ne jurez point de peur d’être parjure;
Si le ſort l’a reglé, vos ſoins ſont ſuperflus,	Si le sort l’a réglé, vos soins sont superflus,
Et l’on ne prendra pas voſtre auis là deſſus.	Et l’on ne prendra pas votre avis là-dessus.
Moy! ie ſerois cocu?	Moi! je serais cocu?
Vous voilà bien malade,	Vous voilà bien malade,
Mille gens le ſont bien ſans vous faire brauade;	Mille gens le sont bien sans vous faire bravade;
Qui de mine, de cœur, de biens & de maiſon,	Qui de mine, de cœur, de biens et de maison,
Ne feroient auec vous nulle comparaiſon.	Ne feraient avec vous nulle comparaison.
Et moy ie n’en voudrois auec eux faire aucune;	Et moi je n’en voudrais avec eux faire aucune:
Mais cette raillerie en vn mot m’importune.	Mais cette raillerie en un mot m’importune.
Briſons-là, s’il vous plaiſt.	Brisons-là, s’il vous plaît.
Vous eſtes en courroux,	Vous êtes en courroux,
Nous en ſçaurons la cauſe; Adieu ſouuenez-vous;	Nous en saurons la cause: Adieu souvenez-vous;
Quoy que ſur ce ſuiet voſtre honneur vous inſpire,	Quoique sur ce sujet votre honneur vous inspire,
Que c’eſt eſtre à demy ce que l’on vient de dire:	Que c’est être à demi ce que l’on vient de dire:
Que de vouloir jurer qu’on ne le ſera pas.	Que de vouloir jurer qu’on ne le sera pas.
Moy! ie le jure encore, & ie vais de ce pas,	Moi! je le jure encore, et je vais de ce pas,
Contre cét accident trouuer vn bon remede.	Contre cet accident trouver un bon remède.
MEs amis, c’eſt icy que j’implore voſtre aide,	Mes amis, c’est ici que j’implore votre aide,
Ie ſuis édifié de voſtre affection;	Je suis édifié de votre affection;
Mais il faut qu’elle éclate en cette occaſion:	Mais il faut qu’elle éclate en cette occasion:
Et ſi vous m’y ſeruez ſelon ma confiance,	Et si vous m’y servez selon ma confiance,
Vous eſtes aſſeurez de voſtre recompenſe.	Vous êtes assurés de votre récompense.
l’homme que vous ſçauez, n’en faites point de bruit,	L’homme que vous savez, n’en faites point de bruit,
Veut comme ie l’ay ſceu m’attraper cette nuit,	Veut comme je l’ai su m’attraper cette nuit,
Dans la chambre d’Agnés entrer par eſcalade,	Dans la chambre Agnès entrer par escalade,
Mais il luy faut nous trois dreſſer vne embuſcade:	Mais il lui faut nous trois dresser une embuscade:
Ie veux que vous preniez chacun vn bon baſton,	Je veux que vous preniez chacun un bon bâton,
Et quand il ſera prés du dernier eſchelon;	Et quand il sera près du dernier échelon;
Car dans le temps qu’il faut i’ouuriray la feneſtre,	Car dans le temps qu’il faut j’ouvrirai la fenêtre,
Que tous deux à l’enuy vous me chargiez ce traître:	Que tous deux à l’envi vous me chargiez ce traître:
Mais d’vn air dont ſon dos garde le ſouuenir,	Mais d’un air dont son dos garde le souvenir,
Et qui lui puiſſe apprendre à n’y plus reuenir,	Et qui lui puisse apprendre à n’y plus revenir,
Sans me nommer pourtant en aucune maniere,	Sans me montrer pourtant en aucune manière,
Ni faire aucun ſemblant que ie ſeray derriere.	Ni faire aucun semblant que je serai derrière.
Aurez-vous bien l’eſprit de ſeruir mon couroux?	Auriez-vous bien l’esprit de servir mon courroux?
S’il ne tient qu’à frapper, Monſieur, tout eſt à nous.	S’il ne tient qu’à frapper, Monsieur, tout est à nous.
Vous verrez, quand ie bas, ſi i’y vais de main-morte.	Vous verrez, quand je bats, si j’y vais de main morte.
La mienne, quoy qu’aux yeux, elle n’eſt pas ſi forte,	La mienne, quoique aux yeux, elle semble moins forte,
N’en quitte pas ſa part à le bien eſtriller.	N’en quitte pas sa part à le bien étriller.
Rentrez-donc, & ſur tout gardez de babiller;	Rentrez donc, et surtout gardez de babiller;
Voilà pour le prochain vne leçon vtile,	Voilà pour le prochain une leçon utile,
Et ſi tous les Maris qui ſont en cette Ville,	Et si tous les Maris qui sont en cette Ville,
De leurs Femmes ainſi receuoient le Galand,	De leurs Femmes ainsi recevaient le Galant,
Le nombre des Cocus ne ſeroit pas ſi grand.	Le nombre des Cocus ne serait pas si grand.
TRaiſtres, qu’auez-vous fait par cette violence?	TRaîtres, qu’avez-vous fait par cette violence?
Nous vous auons rendu, Monſieur, obeïſſance.	Nous vous avons rendu, Monsieur, obéissance.
De cette excuſe en vain vous voulez vous armer.	De cette excuse en vain vous voulez vous armer.
L’ordre eſtoit de le battre, & non de l'aſſommer;	L’ordre était de le battre, et non de l’assommer;
Et c’eſtoit ſur le dos, & non pas ſur la teſte,	Et c’était sur le dos, et non pas sur la tête,
Que i'auois conmandé qu’on fiſt choir la tempeſte.	Que j’avais commandé qu’on fît choir la tempête.
Ciel! dans quel accident me iette icy le ſort?	Ciel! dans quel accident me jette ici le sort?
Et que puis-ie reſoudre à voir cét homme mort?	Et que puis-je résoudre à voir cet homme mort?
Rentrez dans la maiſon; & gardez de rien dire	Rentrez dans la maison; et gardez de rien dire
De cet ordre innocent que i’ay pû vous preſcrire.	De cet ordre innocent que j’ai pu vous prescrire.
Le iour s’en va paroiſtre, & ie vais conſulter	Le jour s’en va paraître, et je vais consulter
Comment dans ce malheur ie me dois comporter.	Comment dans ce malheur je me dois comporter.
Helas! que deuiendray-ie? & que dira le pere,	Hélas! que deviendrai-je? et que dira le père,
Lors qu’inopinément il ſçaura cette affaire?	Lors qu’inopinément il saura cette affaire?
IL faut que i’aille vn peu reconnoiftre qui c’eſt.	Il faut que j’aille un peu reconnaître qui c’est.
Euſt-on iamais preueu... Qui va là s’il vous plaiſt.	Eût-on jamais prévu… Qui va là? s’il vous plaît.
C’eſt vous, Seigneur Arnolphe.	C’est vous, Seigneur Arnolphe.
Oüy; mais vous....	Oui; mais vous…
C’eſt Horace.	C’est Horace.
Ie m’en allois chez vous, vous prier d’vne grace,	Je m’en allais chez vous, vous prier d’une grâce.
Vous ſortez bien matin.	Vous sortez bien matin.
Quelle confuſion!	Quelle confusion!
Eſt-ce vn enchantement? eſt-ce vne illuſion?	Est-ce un enchantement? est-ce une illusion?
I’eſtois, à dire vray, dans vne grande peine;	J’étais, à dire vrai, dans une grande peine;
Et ie benis du Ciel la bonté ſouueraine,	Et je bénis du Ciel la bonté souveraine,
Qui fait qu’à poinct nommé ie vous rencontre ainſi.	Qui fait qu’à point nommé je vous rencontre ainsi.
Ie viens vous auertir que tout a reüſſi,	Je viens vous avertir que tout a réussi,
Et meſme beaucoup plus que ie n’euſſe osé dire;	Et même beaucoup plus que je n’eusse osé dire;
Et par vn incident qui deuoit tout deſtruire.	Et par un incident qui devait tout détruire.
Ie ne ſçay point par où l’on a pû ſoupçonner	Je ne sais point par où l’on a pu soupçonner
Cette aſſignation qu’on m’auoit ſceu donner:	Cette assignation qu’on m’avait su donner:
Mais eſtant ſur le poinct d’atteindre à la feneſtre	Mais étant sur le point d’atteindre à la fenêtre
I’ay, contre mon eſpoir, veu quelques gens paroiſtre,	J’ai, contre mon espoir, vu quelques gens paraître,
Qui ſur moy bruſquement leuant chacun le bras	Qui sur moi brusquement levant chacun le bras
M’ont fait manquer le pied & tomber iuſqu'en bas;	M’ont fait manquer le pied et tomber jusqu’en bas;
Et ma cheute aux deſpens de quelque meurtriſſeure,	Et ma chute aux dépens de quelque meurtrissure,
De vingt coups de baſton m’a ſauué l’auanture.	De vingt coups de bâtons m’a sauvé l’aventure.
Ces gens-là, dont eſtoit ie penſe mon jaloux,	Ces gens-là, dont était je pense mon jaloux,
Ont imputé ma cheute à l’effort de leurs coups,	Ont imputé ma chute à l’effort de leurs coups,
Et comme la douleur vn aſſez long eſpace	Et comme la douleur un assez long espace
M’a fait ſans remuer demeurer ſur la place,	M’a fait sans remuer demeurer sur la place,
Ils ont creu tout de bon qu’ils m’auoient aſſommé,	Ils ont cru tout de bon qu’ils m’avaient assommé,
Et chacun d’eux s’en eſt auſſi-toſt allarmé.	Et chacun d’eux s’en est aussitôt alarmé.
I'entendois tout leur bruit dans le profond ſilence,	J’entendais tout leur bruit dans le profond silence,
L’vn l’autre ils s’accuſoient de cette violence,	L’un l’autre ils s’accusaient de cette violence,
Et ſans lumiere aucune en querellant le ſort,	Et sans lumière aucune, en querellant le sort,
Sont venus doucement taſter ſi i’eſtois mort.	Sont venus doucement tâter si j’étais mort.
Ie vous laiſſe à penſer ſi dans la nuit obſcure,	Je vous laisse à penser si dans la nuit obscure,
I'ay d’vn vray trépaſſé ſceu tenir la figure.	J’ai d’un vrai trépassé su tenir la figure.
Ils ſe ſont retirez auec beaucoup d’effroy;	Ils se sont retirés avec beaucoup d’effroi;
Et comme ie ſongeois à me retirer moy,	Et comme je songeais à me retirer moi,
De cette feinte mort la ieune Agnes eſmeuë	De cette feinte mort la jeune Agnès émue
Auec empreſſement eſt deuers moy venuë:	Avec empressement est devers moi venue:
Car les diſcours qu’entr’eux ces gens auoient tenus,	Car les discours qu’entre eux ces gens avaient tenus,
luſques à ſon oreille eſtoient d’abord venus,	Jusques à son oreille étaient d’abord venus,
Et pendant tout ce trouble eſtant moins obſeruée,	Et pendant tout ce trouble étant moins observée,
Du logis ayſément elle s’eſtoit ſauuée.	Du logis aisément elle s’était sauvée.
Mais me trouuant ſans mal elle a fait éclatter	Mais me trouvant sans mal elle a fait éclater
Vn tranſport difficile à bien repreſenter.	Un transport difficile à bien représenter.
Que vous diray-ie? enfin cette aymable perſonne	Que vous dirai-je? enfin cette aimable personne
A ſuiuy les conſeils que ſon amour luy donne.	A suivi les conseils que son amour lui donne.
N’a plus voulu ſonger à retourner chez ſoy,	N’a plus voulu songer à retourner chez soi,
Et de tout ſon deſtin s’eſt commiſe à ma foy.	Et de tout son destin s’est commise à ma foi.
Conſiderez vn peu par ce trait d’innocence	Considérez un peu par ce trait d’innocence
Où l'expoſe d’vn fou la haute impertinence;	Où l’expose d’un fou la haute impertinence;
Et quels faſcheux perils elle pourroit courir,	Et quels fâcheux périls elle pourrait courir,
Si i’eſtois maintenant homme à la moins cherir?	Si j’étais maintenant homme à la moins chérir?
Mais d’vn trop pur amour mon ame eſt embrazée,	Mais d’un trop pur amour mon âme est embrasée,
I’aimerois mieux mourir que l’auoir abuſée.	J’aimerais mieux mourir que l’avoir abusée.
Ie luy vois des appas dignes d’vn autre ſort,	Je lui vois des appas dignes d’un autre sort,
Et rien ne m’en ſçauroit ſeparer que la mort.	Et rien ne m’en saurait séparer que la mort.
Ie preuoy là-deſſus l’emportement d’vn pere:	Je prévois là-dessus l’emportement d’un père:
Mais nous prendrons le temps d’apaiſer ſa colere.	Mais nous prendrons le temps d’apaiser sa colère.
A des charmes ſi doux ie me laiſſe emporter,	À des charmes si doux je me laisse emporter,
Et dans la vie, enfin, il ſe faut contenter.	Et dans la vie, enfin, il se faut contenter.
Ce que ie veux de vous ſous vn ſecret fidelle,	Ce que je veux de vous sous un secret fidèle,
C’eſt que ie puiſſe mettre en vos mains cette Belle,	C’est que je puisse mettre en vos mains cette Belle,
Que dans voſtre maiſon, en faueur de mes feux,	Que dans votre maison, en faveur de mes feux,
Vous luy donniez retraite au moins vn iour ou deux.	Vous lui donniez retraite au moins un jour ou deux.
Outre qu’aux yeux du monde il faut cacher ſa fuite,	Outre qu’aux yeux du monde il faut cacher sa fuite,
Et qu’on en pourra faire vne exacte pourſuite;	Et qu’on en pourra faire une exacte poursuite;
Vous ſçauez qu’vne fille auſſi de ſa façon	Vous savez qu’une fille aussi de sa façon
Donne auec vn ieune homme vn eſtrange ſoupçon.	Donne avec un jeune homme un étrange soupçon.
Et comme c’eſt à vous, ſeur de voſtre prudence	Et comme c’est à vous, sûr de votre prudence
Que i’ay fait de mes feux entiere confidence;	Que j’ai fait de mes feux entière confidence;
C’eſt à vous ſeul auſſi comme ami genereux	C’est à vous seul aussi, comme ami généreux
Que ie puis confier ce depoſt amoureux.	Que je puis confier ce dépôt amoureux.
Ie ſuis, n’en doutez point, tout à voſtre ſeruice.	Je suis, n’en doutez point, tout à votre service.
Vous voulez bien me rendre vn ſi charmant office.	Vous voulez bien me rendre un si charmant office.
Tres-volontiers, vous dis-je, & ie me ſens rauir	Très volontiers, vous dis-je, et je me sens ravir
De cette occaſion que i'ay de vous ſeruir.	De cette occasion que j’ai de vous servir.
Ie rends graces au Ciel de ce qu’il me l’enuoye,	Je rends grâces au Ciel de ce qu’il me l’envoie,
Et n’ay iamais rien fait auec ſi grande ioye.	Et n’ai jamais rien fait avec si grande joie.
Que ie ſuis redeuable à toutes vos bontez!	Que je suis redevable à toutes vos bontés!
I’auois de voſtre part craint des difficultez:	J’avais de votre part craint des difficultés:
Mais vous eſtes du monde, & dans voſtre ſageſſe	Mais vous êtes du monde, et dans votre sagesse
Vous ſçauez excuſer le feu de la ieuneſſe,	Vous savez excuser le feu de la jeunesse,
Vn de mes gens la garde au coin de ce détour.	Un de mes gens la garde au coin de ce détour.
Mais comment ferons-nous? car il fait vn peu iour;	Mais comment ferons-nous? car il fait un peu jour;
Si ie la prens icy, l’on me verra, peut-eſtre,	Si je la prends ici, l’on me verra, peut-être,
Et s’il faut que chez moy vous veniez à paroiſtre,	Et s’il faut que chez moi vous veniez à paraître,
Des valets cauſeront. Pour ioüer au plus ſeur,	Des valets causeront. Pour jouer au plus sûr,
Il faut me l’amener dans vn lieu plus obſcur,	Il faut me l’amener dans un lieu plus obscur,
Mon allée eſt commode, & ie l’y vais attendre.	Mon allée est commode, et je l’y vais attendre.
Ce ſont precautions qu’il eſt fort bon de prendre.	Ce sont précautions qu’il est fort bon de prendre.
Pour moy ie ne feray que vous la mettre en main,	Pour moi je ne ferai que vous la mettre en main,
Et chez moy ſans éclat ie retourne ſoudain.	Et chez moi sans éclat je retourne soudain.
Ah fortune! ce trait d’auanture propice,	Ah fortune! ce trait d’aventure propice,
Repare tous les maux que m'a faits ton caprice.	Répare tous les maux que m’a faits ton caprice.
NE ſoyez point en peine, où ie vais vous mener,	NE soyez point en peine, où je vais vous mener,
C’eſt vn logement ſeur que ie vous fais dõner.	C’est un logement sûr que je vous fais donner.
Vous loger auec moy ce ſeroit tout deſtruire,	Vous loger avec moi ce serait tout détruire,
Entrez dans cette porte, & laiſſez-vous conduire.	Entrez dans cette porte, et laissez-vous conduire.
Pourquoy me quittez-vous?	Pourquoi me quittez-vous?
Chere Agnes, il le faut.	Chère Agnès, il le faut.
Songez donc, ie vous prie, à reuenir bien-toſt.	Songez donc, je vous prie, à revenir bientôt.
I’en ſuis aſſez preſſé par ma flame amoureuſe.	J’en suis assez pressé par ma flamme amoureuse.
Quand ie ne vous vois point, ie ne ſuis point ioyeuſe.	Quand je ne vous vois point, je ne suis point joyeuse.
Hors de voſtre preſence on me voit triſte auſſi.	Hors de votre présence on me voit triste aussi.
Helas! s’il eſtoit vray, vous reſteriez icy.	Hélas! s’il était vrai, vous resteriez ici.
Quoy! vous pourriez douter de mon amour extréme?	Quoi! vous pourriez douter de mon amour extrême?
Non, vous ne m’aymez pas autant que ie vous aime.	Non, vous ne m’aimez pas autant que je vous aime.
Ah l’on me tire trop!	Ah! l’on me tire trop!
C’eſt qu’il eſt dangereux,	C’est qu’il est dangereux,
Chere Agnés, qu’en ce lieu nous ſoyons veus tous deux,	Chère Agnès, qu’en ce lieu nous soyons vus tous deux.
Et le parfait amy, de qui la main vous preſſe,	Et le parfait ami, de qui la main vous presse,
Suit le zele prudent qui pour nous l’intereſſe.	Suit le zèle prudent qui pour nous l’intéresse.
Mais ſuiure vn inconnu que...	Mais suivre un inconnu que…
N’aprehendez rien,	N’appréhendez rien,
Entre de telles mains vous ne ſerez que bien.	Entre de telles mains vous ne serez que bien.
Ie me trouuerois mieux entre celles d’Horace.	Je me trouverais mieux entre celles d’Horace.
Et i’aurois...	Et j’aurais…
Attendez.	Attendez.
Adieu, le iour me chaſſe.	Adieu, le jour me chasse.
Quand vous verray-ie donc?	Quand vous verrai-je donc?
Bien-toſt aſſeurément.	Bientôt assurément.
Que ie vais m'ennuyer iuſques à ce moment!	Que je vais m’ennuyer jusques à ce moment!
Grace au Ciel, mon bonheur n’eſt plus en concurrence,	Grâce au Ciel, mon bonheur n’est plus en concurrence,
Et ie puis maintenant dormir en aſſeurance.	Et je puis maintenant dormir en assurance.
VEnez, ce n’eſt pas là que ie vous logeray,	VEnez, ce n’est pas là que je vous logerai,
Et voftre gifte ailleurs eſt par moy preparé,	Et votre gîte ailleurs est pour moi préparé.
Ie pretends en lieu ſeur mettre voſtre perſonne.	Je prétends en lieu sûr mettre votre personne.
Me connoiſſez-vous?	Me connaissez-vous?
Hay.	Hay.
Mon viſage, Friponne,	Mon visage, Friponne,
Dans cette occaſion rend vos ſens effrayez,	Dans cette occasion rend vos sens effrayés,
Et c’eſt à contre-cœur qu’icy vous me voyez;	Et c’est à contrecœur qu’ici vous me voyez;
Ie trouble en ſes projets l’amour qui vous poſſede,	Je trouble en ses projets l’amour qui vous possède,
N’appellez point des yeux le Galand à voſtre ayde,	N’appelez point des yeux le Galant à votre aide,
Il eſt trop eſloigné pour vous donner ſecours,	Il est trop éloigné pour vous donner secours,
Ah, ah, ſi ieune encor, vous ioüez de ces tours,	Ah, ah, si jeune encor, vous jouez de ces tours,
Voſtre ſimplicité, qui ſemble ſans pareille,	Votre simplicité qui semble sans pareille,
Demande ſi l’on fait les Enfans par l’oreille,	Demande si l’on fait les Enfants par l’oreille,
Et vous ſçauez donner des rendez-vous la nuit,	Et vous savez donner des rendez-vous la nuit,
Et pour ſuiure vn Galand vous euader ſans bruit.	Et pour suivre un Galant vous évader sans bruit.
Tu-dieu? comme auec luy voſtre langue cajole;	Tudieu! comme avec lui votre langue cajole:
Il faut qu’on vous ait miſe à quelque bonne école.	Il faut qu’on vous ait mise à quelque bonne école.
Qui diantre tout d’vn coup vous en a tant appris?	Qui diantre tout d’un coup vous en a tant appris?
Vous ne craignez donc plus de trouuer des Eſprits?	Vous ne craignez donc plus de trouver des Esprits?
Et ce Galand la nuit vous a donc enhardie.	Et ce Galant la nuit vous a donc enhardie.
Ah, Coquine, en venir à çette perfidie;	Ah, Coquine, en venir à cette perfidie;
Malgré tous mes bienfaits former vn tel deſſein,	Malgré tous mes bienfaits former un tel dessein,
Petit ſerpent que i’ay reſchauffé dans mon ſein,	Petit serpent que j’ai réchauffé dans mon sein,
Et qui dés qu’il ſe ſent par vne humeur ingrate,	Et qui dès qu’il se sent par une humeur ingrate,
Cherche à faire du mal à celuy qui le flatte.	Cherche à faire du mal à celui qui le flatte.
Pourquoy me criez-vous?	Pourquoi me criez-vous?
I’ay grand tort en effet.	J’ai grand tort en effet.
Ie n’entends point de mal dans tout ce que i’ay fait.	Je n’entend point de mal dans tout ce que j’ai fait.
Suiure vn Galand n’eſt pas vne action infame?	Suivre un galant n’est pas une action infâme?
C’eſt vn hõme qui dit qu’il me veut pour ſa femme;	C’est un homme qui dit qu’il me veut pour sa femme;
I'ay ſuiuy vos leçons, & vous m’auez preſché	J’ai suivi vos leçons, et vous m’avez prêché
Qu'il ſe faut marier pour oſter le peché.	Qu’il se faut marier pour ôter le péché.
Oüy, mais pour femme moy ie pretendois vous prendre,	Oui, mais pour femme moi je prétendais vous prendre.
Et ie vous l’auois fait, me ſemble, aſſez entendre.	Et je vous l’avais fait, me semble, assez entendre.
Oüy, mais à vous parler franchement entre nous,	Oui, mais à vous parler franchement entre nous,
Il eſt plus pour cela, ſelon mon gouſt, que vous;	Il est plus pour cela selon mon goût, que vous;
Chez vous le mariage eſt faſcheux & penible,	Chez vous le mariage est fâcheux et pénible,
Et vos diſcours en font vne image terrible:	Et vos discours en font une image terrible:
Mais las! il le fait luy ſi remply de plaiſirs,	Mais las! il le fait lui si rempli de plaisirs,
Que de ſe marier il donne des deſirs.	Que de se marier il donne des désirs.
Ah, c’eſt que vous l’aymez, traiſtreſſe.	Ah, c’est que vous l’aimez, traîtresse.
Oüy ie l’ayme.	Oui je l’aime.
Et vous auez le front de le dire à moy-meſme?	Et vous avez le front de le dire à moi-même?
Et pourquoy s’il eſt vray, ne le dirois-ie pas?	Et pourquoi s’il est vrai, ne le dirais-je pas?
Le deuiez-vous aimer? Impertinente.	Le deviez-vous aimer? Impertinente.
Helas!	Hélas!
Eſt-ce que i’en puis mais? luy ſeul en eſt la cauſe,	Est-ce que j’en puis mais? lui seul en est la cause,
Et ie n’y ſongeois pas lors que ſe fit la choſe.	Et je n’y songeais pas lorsque se fit la chose.
Mais il falloit chaſſer cet amoureux deſir.	Mais il fallait chasser cet amoureux désir.
Le moyen de chaſſer ce qui fait du plaiſir.	Le moyen de chasser ce qui fait du plaisir.
Et ne ſçauiez-vous pas que c’eſtoit me déplaire?	Et ne savez-vous pas que c’était me déplaire?
Moy, point du tout, quel mal cela vous peut-il faire?	Moi, point du tout, quel mal cela vous peut-il faire?
Il eſt vray, i’ay ſuiet d’en eſtre réjoüy,	Il est vrai, j’ai sujet d’en être réjoui,
Vous ne m’aymez donc pas à ce conte.	Vous ne m’aimez donc pas à ce compte.
Vous.	Vous.
Oüy.	Oui.
Helas, non.	Hélas, non.
Comment, non?	Comment, non?
Voulez-vous que ie mente?	Voulez-vous que je mente?
Pourquoy ne m’aymer pas, Madame l'impudente?	Pourquoi ne m’aimer pas, Madame l’impudente?
Mondieu, ce n’eſt pas moy que vous deuez blaſmer;	Mon dieu, ce n’est pas moi que vous devez blâmer;
Que ne vous eſtes-vous comme luy fait aymer?	Que ne vous êtes-vous comme lui fait aimer?
Ie ne vous en ay pas empeſché, que ie penſe.	Je ne vous en ai pas empêché, que je pense.
Ie m’y ſuis efforcé de toute ma puiſſance;	Je m’y suis efforcé de toute ma puissance;
Mais les ſoins que i’ay pris, ie les ay perdus tous.	Mais les soins que j’ai pris, je les ai perdus tous.
Vrayment il en ſçait donc là-deſſus plus que vous;	Vraiment il en sait donc là-dessus plus que vous;
Car à ſe faire aimer il n’a point eu de peine.	Car à se faire aimer il n’a point eu de peine.
Voyez comme raiſonne & répond la vilaine.	Voyez comme raisonne et répond la vilaine.
Peſte, vne Precieuſe en diroit-elle plus?	Peste, une Précieuse en dirait-elle plus?
Ah! ie l’ay mal connuë, ou ma foy là-deſſus	Ah! je l’ai mal connue, ou ma foi là-dessus
Vne ſotte en ſçait plus que le plus habile homme;	Une sotte en sait plus que le plus habile homme;
Puis qu’en raiſonnement voſtre eſprit ſe conſomme,	Puisqu’en raisonnement votre esprit se consomme,
La belle raiſonneuſe, eſt-ce qu’vn ſi long-temps	La belle raisonneuse, est-ce qu’un si long-temps
Ie vous auray pour luy nourrie à mes deſpens?	Je vous aurai pour lui nourrie à mes dépens?
Non, il vous rendra tout iuſques au dernier double.	Non, il vous rendra tout jusques au dernier double.
Elle a de certains mots où mon dépit redouble,	Elle a de certains mots où mon dépit redouble,
Me rendra-t-il, coquine, auec tout ſon pouuoir	Me rendra-t-il, coquine, avec tout son pouvoir
Les obligations que vous pouuez m’auoir?	Les obligations que vous pouvez m’avoir?
Ie ne vous en ay pas de ſi grandes qu’on penſe.	Je ne vous en ai pas de si grandes qu’on pense.
N’eſt-ce rien que les ſoins d’éleuer voſtre enfance?	N’est-ce rien que les soins d’élever votre enfance?
Vous auez là dedans bien operé vrayment,	Vous avez là-dedans bien opéré vraiment,
Et m’auez fait en tout inſtruire joliment,	Et m’avez fait en tout instruire joliment,
Croit-on que ie me flatte, & qu’enfin dans ma teſte	Croit-on que je me flatte, et qu’enfin dans ma tête
Ie ne iuge pas bien que ie ſuis vne beſte?	Je ne juge pas bien que je suis une bête?
Moy-meſme i'en ay honte, & dans l’âge où ie ſuis	Moi-même j’en ai honte, et dans l’âge où je suis
Ie ne veux plus paſſer pour ſotte, ſi ie puis.	Je ne veux plus passer pour sotte, si je puis.
Vous fuyez l’ignorance, & voulez, quoy qu’il coute,	Vous fuyez l’ignorance, et voulez, quoi qu’il coûte,
Apprendre du blondin quelque choſe.	Apprendre du blondin quelque chose.
Sans doute,	Sans doute,
C’eſt de luy que ie ſçay ce que ie puis ſçauoir,	C’est de lui que je sais ce que je puis savoir,
Et beaucoup plus qu’à vous ie penſe luy deuoir.	Et beaucoup plus qu’à vous je pense lui devoir.
Ie ne ſçay qui me tient qu’auec vne gourmade	Je ne sais qui me tient qu’avec une gourmade
Ma main de ce diſcours ne vange la brauade.	Ma main de ce discours ne venge la bravade.
I’enrage quand ie voy ſa piquante froideur,	J’enrage quand je vois sa piquante froideur,
Et quelques coups de poing ſatisferoient mon cœur;	Et quelques coups de poing satisferaient mon cœur;
Helas, vous le pouuez, ſi cela peut vous plaire.	Hélas, vous le pouvez, si cela peut vous plaire.
Ce mot, & ce regard deſarment ma colere,	Ce mot, et ce regard désarme ma colère,
Et produit vn retour de tendreſſe de cœur,	Et produit un retour de tendresse de cœur,
Qui de ſon action m’efface la noirceur.	Qui de son action m’efface la noirceur.
Choſe eſtrange! d’aimer, & que pour ces traiſtreſſes	Chose étrange! d’aimer, et que pour ces traîtresses
Les hommes ſoient ſujets à de telles foibleſſes,	Les hommes sont sujets à de telles faiblesses,
Tout le monde connoiſt leur imperfection.	Tout le monde connaît leur imperfection.
Ce n'eſt qu'extrauagance, & qu’indiſcretion;	Ce n’est qu’extravagance, et qu’indiscrétion;
Leur eſprit eſt meſchant, & leur ame fragile,	Leur esprit est méchant, et leur âme fragile,
Il n’eſt rien de plus foible & de plus imbecile;	Il n’est rien de plus faible, et de plus imbécile;
Rien de plus infidelle, & malgré tout cela	Rien de plus infidèle, et malgré tout cela
Dans le monde on fait tout pour ces animaux-là.	Dans le monde on fait tout pour ces animaux-là.
Hé bien, faiſons la paix, va petite traiſtreſſe,	Hé bien, faisons la paix, va petite traîtresse,
Ie te pardonne tout, & te rens ma tendreſſe;	Je te pardonne tout, et te rends ma tendresse;
Conſidere par là l’amour que i’ay pour toy,	Considère par là l’amour que j’ai pour toi,
Et me voyant ſi bon, en reuanche ayme-moy.	Et me voyant si bon, en revanche aime-moi.
Du meilleur de mon cœur, ie voudrois vous complaire,	Du meilleur de mon cœur, je voudrais vous complaire.
Que me couſteroit-il, ſi ie le pounois faire?	Que me coûterait-il, si je le pouvais faire?
Mon pauure petit bec, tu le peux, ſi tu veux,	Mon pauvre petit bec, tu le peux, si tu veux,
Eſcoute ſeulement ce ſoupir amoureux,	Écoute seulement ce soupir amoureux,
Voy ce regard mourant, contemple ma perſonne,	Vois ce regard mourant, contemple ma personne,
Et quitte ce morueux, & l’amour qu’il te donne;	Et quitte ce morveux, et l’amour qu’il te donne;
C’eſt quelque ſort qu’il faut qu’il ait ietté ſur toy,	C’est quelque sort qu’il faut qu’il ait jeté sur toi,
Et tu ſeras cent fois plus heureuſe auec moy.	Et tu seras cent fois plus heureuse avec moi.
Ta forte paſſion eſt d’eſtre braue & leſte,	Ta forte passion est d’être brave et leste,
Tu le ſeras toûjours, va, ie te le proteſte;	Tu le seras toujours, va, je te le proteste;
Sans ceſſe nuict & iour ie te careſſeray,	Sans cesse nuit et jour je te caresserai,
Ie te bouchonneray, baiſeray; mangeray	Je te bouchonnerai, baiserai, mangerai;
Tout comme tu voudras, tu pourras te conduire,	Tout comme tu voudras, tu pourras te conduire,
Ie ne m’explique point, & cela c’eſt tout dire.	Je ne m’explique point, et cela c’est tout dire.
Iuſqu’où la paſſion peut-elle faire aller?	Jusqu’où la passion peut-elle faire aller?
Enfin à mon amour rien ne peut s’égaler;	Enfin à mon amour rien ne peut s’égaler;
Quelle preuue veux-tu que ie t’en donne, ingratte?	Quelle preuve veux-tu que je t’en donne, ingrate?
Me veux-tu voir pleurer? veux-tu que ie me batte?	Me veux-tu voir pleurer? veux-tu que je me batte?
Veux-tu que ie m’arrache vn coſté de cheueux?	Veux-tu que je m’arrache un côté de cheveux?
Veux-tu que ie me tuë? oüy, dy ſi tu le veux,	Veux-tu que je me tue? oui, dis si tu le veux,
Ie ſuis tout preſt, cruelle, à te prouuer ma flame.	Je suis tout prêt, cruelle, à te prouver ma flamme.
Tenez, tous vos diſcours ne me touchent point l'ame.	Tenez, tous vos discours ne me touchent point l’âme.
Horace auec deux mots en feroit plus que vous.	Horace avec deux mots en ferait plus que vous.
Ah! c’eſt trop me brauer, trop pouſſer mon courroux;	Ah! c’est trop me braver, trop pousser mon courroux;
Ie ſuiuray mon deſſein, beſte trop indocile,	Je suivrai mon dessein, bête trop indocile,
Et vous denicherez à l'inſtant de la Ville;	Et vous dénicherez à l’instant de la Ville;
Vous rebutez mes vœux, & me mettez à bout;	Vous rebutez mes vœux, et me mettez à bout;
Mais vn cul de Couuent me vangera de tout.	Mais un cul de Couvent me vengera de tout.
IE ne ſçay ce que c’eſt, Monſieur, mais il me ſemble	JE ne sais ce que c’est, Monsieur, mais il me semble
Qu'Agnes & le corps mort s’en ſont allez enſemble.	Qu’Agnès et le corps mort s’en sont allés ensemble.
La voicy; dans ma chambre allez me la nicher,	La voici; dans ma chambre allez me la nicher.
Ce ne ſera pas là qu’il la viendra chercher,	Ce ne sera pas là qu’il la viendra chercher,
Et puis c’eſt ſeulement pour vne demie-heure,	Et puis c’est seulement pour une demie-heure,
Ie vais pour luy donner vne ſeure demeure	Je vais pour lui donner une sûre demeure
Trouuer vne voiture; enfermez-vous des mieux,	Trouver une voiture; enfermez-vous des mieux,
Et ſur tout gardez-vous de la quitter des yeux:	Et surtout gardez-vous de la quitter des yeux:
Peut-eſtre que ſon ame eſtant dépayſée	Peut-être que son âme étant dépaysée
Pourra de cét amour eſtre deſabuſée.	Pourra de cet amour être désabusée.
AH! ie viens vous trouuer accablé de douleur,	Ah! je viens vous trouver accablé de douleur,
Le Ciel, Seigneur Arnolphe, a conclu mon malheur,	Le Ciel, Seigneur Arnolphe, a conclu mon malheur,
Et par vn trait fatal d’vne iniuſtice extréme	Et par un trait fatal d’une injustice extrême
On me veut arracher de la beauté que i’ayme.	On me veut arracher de la beauté que j’aime.
Pour arriuer icy mon pere a pris le frais,	Pour arriver ici mon père a pris le frais,
I’ay trouué qu’il mettoit pied à terre icy prés,	J’ai trouvé qu’il mettait pied-à-terre ici près,
Et la cauſe en vn mot d’vne telle venuë,	Et la cause en un mot d’une telle venue,
Qui, comme ie diſois, ne m’eſtoit pas connuë,	Qui, comme je disais, ne m’était pas connue,
C’eſt qu’il m’a marié ſans m’en reſcrire rien,	C’est qu’il m’a marié sans m’en écrire rien,
Et qu’il vient en ces lieux celebrer ce lien.	Et qu’il vient en ces lieux célébrer ce lien.
Iugez, en prenant part à mon inquietude,	Jugez, en prenant part à mon inquiétude,
S’il pouuoit m’arriuer vn contre-temps plus rude;	S’il pouvait m’arriver un contre-temps plus rude;
Cet Enrique, dont hier ie m’informois à vous,	Cet Enrique, dont hier je m’informais à vous,
Cauſe tout le malheur dont ie reſſens les coups;	Cause tout le malheur dont je ressens les coups;
Il vient auec mon pere acheuer ma ruïne,	Il vient avec mon père achever ma ruine,
Et c’eſt ſa fille vnique à qui l’on me deſtine.	Et c’est sa fille unique à qui l’on me destine.
I'ay dés leurs premiers mots penſé m’éuanoüir,	J’ai dès leurs premiers mots pensé m’évanouir,
Et d’abord ſans vouloir plus long-temps les ouïr;	Et d’abord sans vouloir plus longtemps les ouïr;
Mon pere ayant parlé de vous rendre viſite	Mon père ayant parlé de vous rendre visite
L’eſprit plein de frayeur ie l’ay deuancé viſte:	L’esprit plein de frayeur je l’ai devancé vite:
De grace, gardez-vous de luy rien découurir	De grâce, gardez-vous de lui rien découvrir
De mon engagement, qui le pourroit aigrir,	De mon engagement, qui le pourrait aigrir,
Et taſchez, comme en vous il prend grande creance,	Et tâchez, comme en vous il prend grande créance,
De le diſſuader de cette autre alliance.	De le dissuader de cette autre alliance.
Oüy dà.	Ouida.
Conſeillez-luy de differer vn peu,	Conseillez-lui de différer un peu,
Et rendez en ami ce ſeruice à mon feu.	Et rendez en ami ce service à mon feu.
Ie n’y manqueray pas.	Je n’y manquerai pas.
C’eſt en vous que i’eſpere.	C’est en vous que j’espère.
Fort bien.	Fort bien.
Et ie vous tiens mon veritable pere;	Et je vous tiens mon véritable père;
Dites-luy que mon âge... ah! ie le voy venir,	Dites-lui que mon âge… ah! je le vois venir,
Eſcoutez les raiſons que ie vous puis fournir.	Écoutez les raisons que je vous puis fournir.
AVſſi-toſt qu’à mes yeux ie vous ay veu paroiſtre,	AUssitôt qu’à mes yeux je vous ai vu paraître,
Quand on ne m’euſt rien dit i’aurois ſceu vous connoiſtre;	Quand on ne m’eût rien dit j’aurais su vous connaître;
Ie vous voy tous les traits de cette aimable ſœur,	Je vous vois tous les traits de cette aimable sœur,
Dont l’hymen autrefois m’auoit fait poſſeſſeur;	Dont l’hymen autrefois m’avait fait possesseur;
Et ie ſerois heureux, ſi la Parque cruelle	Et je serais heureux, si la Parque cruelle
M’euſt laiſſé ramener cette épouſe fidelle,	M’eût laissé ramener cette épouse fidèle,
Pour ioüir auec moy des ſenſibles douceurs	Pour jouir avec moi des sensibles douceurs
De reuoir tous les ſiens aprés nos longs malheurs:	De revoir tous les siens après nos longs malheurs:
Mais puiſque du deſtin la fatale puiſſance	Mais puisque du destin la fatale puissance
Nous priue pour iamais de ſa chere preſence,	Nous prive pour jamais de sa chère présence,
Taſchons dé nous reſoudre, & de nous contenter	Tâchons de nous résoudre, et de nous contenter
Du ſeul fruict amoureux qui m’en eſt pû reſter,	Du seul fruit amoureux qui m’en est pu rester,
Il vous touche de prés. Et ſans voſtre ſuffrage	Il vous touche de près. Et sans votre suffrage
I’aurois tort de vouloir diſpoſer de ce gage;	J’aurais tort de vouloir disposer de ce gage;
Le choix du ſils d’Oronte eſt glorieux de ſoy,	Le choix du fils d’Oronte est glorieux de soi,
Mais il faut que ce choix vous plaiſe comme à moy.	Mais il faut que ce choix vous plaise comme à moi.
C’eſt de mon iugement auoir mauuaiſe eſtime,	C’est de mon jugement avoir mauvaise estime,
Que douter ſi i’approuue vn choix ſi legitime:	Que douter si j’approuve un choix si légitime:
Oüy, ie vais vous ſeruir de la bonne façon.	Oui, je vais vous servir de la bonne façon.
Gardez encor vn coup...,	Gardez encor un coup…
N’ayez aucun ſoupçon.	N’ayez aucun soupçon.
Ah! que cette embraſſade eſt pleine de tendreſſe.	Ah! que cette embrassade est pleine de tendresse.
Que ie ſens à vous voir vne grande allegreſſe.	Que je sens à vous voir une grande allégresse.
Ie ſuis icy venu...	Je suis ici venu…
Sans m’en faire recit,	Sans m’en faire récit,
Ie ſçay ce qui vous meine.	Je sais ce qui vous mène.
On vous l’a deſia dit.	On vous l’a déjà dit.
Oüy.	Oui.
Tant mieux.	Tant mieux.
Voſtre fils à cet hymen reſiſte,	Votre fils à cet hymen résiste,
Et ſon cœur preuenu n’y voit rien que de triſte,	Et son cœur prévenu n’y voit rien que de triste,
Il m'a meſme prié de vous en détourner;	Il m’a même prié de vous en détourner;
Et moy tout le conſeil que ie vous puis donner,	Et moi tout le conseil que je vous puis donner,
C’eſt de ne pas ſouffrir que ce nœud ſe differe,	C’est de ne pas souffrir que ce nœud se diffère,
Et de faire valoir l’authorité de pere;	Et de faire valoir l’autorité de père;
Il faut auec vigueur ranger les ieunes gens,	Il faut avec vigueur ranger les jeunes gens,
Et nous faiſons contr’eux à leur eſtre indulgens.	Et nous faisons contre eux à leur être indulgents.
Ah traiſtre!	Ah traître!
Si ſon cœur a quelque repugnance,	Si son cœur a quelque répugnance,
Ie tiens qu’on ne doit pas luy faire violence;	Je tiens qu’on ne doit pas lui faire violence;
Mon frere, que ie croy, ſera de mon auis.	Mon frère, que je crois, sera de mon avis.
Quoy? ſe laiſſera-t’il gouuerner par ſon fils?	Quoi? se laissera-t-il gouverner par son fils?
Eſt-ce que vous voulez qu’vn pere ait la moleſſe	Est-ce que vous voulez qu’un père ait la mollesse
De ne ſçauoir pas faire obeïr la ieuneſſe?	De ne savoir pas faire obéir la jeunesse?
Il ſeroit beau, vrayment, qu’on le viſt auiourd’huy	Il serait beau, vraiment, qu’on le vît aujourd’hui
Prendre loy de qui doit la receuoir de luy.	Prendre loi de qui doit la recevoir de lui.
Non, non, c’eſt mon intime, & ſa gloire eſt la miẽne,	Non, non, c’est mon intime, et sa gloire est la mienne,
Sa parole eſt donnée, il faut qu’il la maintienne,	Sa parole est donnée, il faut qu’il la maintienne,
Qu'il faſſe voir icy de fermes ſentimens,	Qu’il fasse voir ici de fermes sentiments,
Et force de ſon fils tous les attachemens.	Et force de son fils tous les attachements.
C’eſt parler comme il faut, & dans cette alliance,	C’est parler comme il faut, et dans cette alliance,
C’eſt moy qui vous reſpons de ſon obeïſſance.	C’est moi qui vous réponds de son obéissance.
Ie ſuis ſurpris, pour moy, du grand empreſſement	Je suis surpris, pour moi, du grand empressement
Que vous nous faites voir pour cet engagement,	Que vous me faites voir pour cet engagement,
Et ne puis deumner quel motif vous inſpire...	Et ne puis deviner quel motif vous inspire…
Ie ſçay ce que ie fais, & dis ce qu’il faut dire.	Je sais ce que je fais, et dis ce qu’il faut dire.
Oüy, oüy, Seigneur Arnolphe, il eſt...	Oui, oui, Seigneur Arnolphe, il est…
Ce nom l’aigrit,	Ce nom l’aigrit,
C’eſt Monſieur de la Souche, on vous l’a deſia dit.	C’est Monsieur de la Souche, on vous l’a déjà dit.
Il n’importe.	Il n’importe.
Qu’entens-je?	Qu’entends-je?
Oüy c’eſt là le myſtere,	Oui c’est là le mystère,
Et vous pouuez iuger ce que ie deuois faire.	Et vous pouvez juger ce que je devais faire.
En quel trouble....	En quel trouble…
Monſieur, ſi vous n’eſtes auprés,	Monsieur, si vous n’êtes auprès,
Nous aurons de la peine à retenir Agnés,	Nous aurons de la peine à retenir Agnès,
Elle veut à tous coups s’eſchaper, & peut-eſtre	Elle veut à tous coups s’échapper, et peut-être
Quelle ſe pourroit bien ietter par la feneſtre.	Qu’elle se pourrait bien jeter par la fenêtre.
Faites-là-moy venir, auſſi bien de ce pas	Faites-la-moi venir, aussi bien de ce pas
Pretens-ie l’emmener, ne vous en faſchez pas,	Prétends-je l’emmener, ne vous en fâchez pas,
Vn bonheur continu rendroit l’homme ſuperbe,	Un bonheur continu rendrait l’homme superbe,
Et chacun a ſon tour, comme dit le Prouerbe.	Et chacun à son tour, comme dit le Proverbe.
Quels maux peuuent, ô Ciel, égaler mes ennuis?	Quels maux peuvent, ô Ciel, égaler mes ennuis?
Et s’eſt-on iamais veu dans l'abyſme où ie ſuis?	Et s’est-on jamais vu dans l’abîme où je suis?
Preſſez viſte le iour de la Ceremonie,	Pressez vite le jour de la Cérémonie,
I’y prens part, & deſia moy-meſme ie m’en prie.	J’y prends part, et déjà moi-même je m’en prie.
C’eſt bien noſtre deſſein.	C’est bien notre dessein.
VEnez, Belle, venez,	VEnez, Belle, venez,
Qu’on ne ſçauroit tenir, & qui vous mutinez,	Qu’on ne saurait tenir, et qui vous mutinez,
Voicy voſtre Galand, a qui pour recompence	Voici votre Galant, à qui pour récompense
Vous pouuez faire vne humble & douce reuerence,	Vous pouvez faire une humble et douce révérence,
Adieu; l’éuenement trompe vn peu vos ſouhaits;	Adieu; l’événement trompe un peu vos souhaits;
Mais tous les amoureux ne ſont pas ſatisfaits.	Mais tous les amoureux ne sont pas satisfaits.
Me laiſſez-vous, Horace, emmener de la ſorte?	Me laissez-vous, Horace, emmener de la sorte?
Ie ne ſçay où i’en ſuis, tant ma douleur eſt forte.	Je ne sais où j’en suis, tant ma douleur est forte.
Allons, cauſeuſe, allons.	Allons, causeuse, allons.
Ie veux reſter icy.	Je veux rester ici.
Dites-nous ce que c’eſt que ce myſtere-cy,	Dites-nous ce que c’est que ce mystère-ci,
Nous nous regardons tous ſans le pouuoir comprendre.	Nous nous regardons tous sans le pouvoir comprendre.
Auec plus de loiſir ie pourray vous l’aprendre,	Avec plus de loisir je pourrai vous l’apprendre,
Iuſqu’au reuoir.	Jusqu’au revoir.
Où donc pretendez-vous aller?	Où donc prétendez-vous aller?
Vous ne nous parlez point, comme il nous faut parler.	Vous ne nous parlez point, comme il nous faut parler.
Ie vous ay conſeillé malgré tout ſon murmure,	Je vous ai conseillé malgré tout son murmure,
D’acheuer l’hymenée.	D’achever l’hyménée.
Oüy, mais pour le conclure	Oui, mais pour le conclure
Si l’on vous a dit tout, ne vous a-t’on pas dit	Si l’on vous a dit tout, ne vous a-t-on pas dit
Que vous auez chez vous celle dont il s’agit?	Que vous avez chez vous celle dont il s’agit?
La fille qu’autrefois de l’aimable Angelique	La fille qu’autrefois de l’aimable Angélique
Sous des liens ſecrets eut le Seigneur Enrique.	Sous des liens secrets eut le Seigneur Enrique.
Sur quoy voſtre diſcours eſtoit-il donc fondé?	Sur quoi votre discours était-il donc fondé?
Ie m’eſtonnois auſſi de voir ſon procedé.	Je m’étonnais aussi de voir son procédé.
Quoy...	Quoi…
D’vn hymen ſecret ma ſœur eut vne fille,	D’un hymen secret ma sœur eut une fille,
Dont on cacha le ſort à toute la famille.	Dont on cacha le sort à toute la famille.
Et qui ſous de feints noms pour ne rien découurir,	Et qui sous de feints noms pour ne rien découvrir,
Par ſon eſpoux aux champs fut donnée à nourrir.	Par son époux aux champs fut donnée à nourrir.
Et dans ce temps le ſort luy déclarant la guerre,	Et dans ce temps le sort lui déclarant la guerre,
L’obligea de ſortir de ſa natale terre.	L’obligea de sortir de sa natale terre.
Et d’aller eſſuyer mille perils diuers	Et d’aller essuyer mille périls divers
Dans ces lieux ſeparez de nous par tant de mers.	Dans ces lieux séparés de nous par tant de mers.
Où ſes ſoins ont gagné ce que dans ſa patrie	Où ses soins ont gagné ce que dans sa patrie
Auoient pû luy rauir l’impoſture & l'enuie.	Avaient pu lui ravir l’imposture et l’envie.
Et de retour en France, il a cherché d’abord	Et de retour en France, il a cherché d’abord
Celle à qui de ſa fille il confia le ſort.	Celle à qui de sa fille il confia le sort.
Et cette Païſanne a dit auec franchiſe,	Et cette Paysanne a dit avec franchise,
Qu'en vos mains à quatre ans elle l’auoit remiſe.	Qu’en vos mains à quatre ans elle l’avait remise.
Et qu’elle l’auoit fait ſur voſtre charité	Et qu’elle l’avait fait sur votre charité
Par vn accablement d’extréme pauureté.	Par un accablement d’extrême pauvreté.
Et luy plein de tranſport, & l’allegreſſe en l’ame	Et lui plein de transports, et l’allégresse en l’âme
A fait iuſqu’en ces lieux conduire cette femme.	A fait jusqu’en ces lieux conduire cette femme.
Et vous allez, enfin, la voir venir ici	Et vous allez, enfin, la voir venir ici
Pour rendre aux yeux de tous ce myſtere éclairci.	Pour rendre aux yeux de tous ce mystère éclairci.
Ie deuine à peu prés quel eſt voſtre ſupplice,	Je devine à peu prés quel est votre supplice,
Mais le ſort en cela ne vous eſt que propice;	Mais le sort en cela ne vous est que propice;
Si n’eſtre point cocu vous ſemble vn ſi grand bien,	Si n’être point cocu vous semble un si grand bien,
Ne vous point marier en eſt le vray moyen.	Ne vous point marier en est le vrai moyen.
Oh!	Oh!
D’où vient qu’il s’enfuit ſans rien dire?	D’où vient qu’il s’enfuit sans rien dire?
Ah mon pere	Ah mon père
Vous ſçaurez pleinement ce ſurprenant myſtere.	Vous saurez pleinement ce surprenant mystère.
Le hazard en ces lieux auoit executé	Le hasard en ces lieux avait exécuté
Ce que voſtre ſageſſe auoit premedité.	Ce que votre sagesse avait prémédité.
I’eſtois par les doux nœuds d’vne ardeur mutuelle	J’étais par les doux nœuds d’une ardeur mutuelle
Engagé de parole auecque cette Belle;	Engagé de parole avec cette Belle;
Et c’eſt elle en vn mot que vous venez chercher,	Et c’est elle en un mot que vous venez chercher,
Et pour qui mon refus a penſé vous faſcher.	Et pour qui mon refus a pensé vous fâcher.
Ie n’en ay point douté d’abord que ie l’ay veuë,	Je n’en ai point douté d’abord que je l’ai vue,
Et mon ame depuis n’a ceſſé d’eſtre eſmeuë.	Et mon âme depuis n’a cessé d’être émue.
Ah! ma fille, ie cede à des tranſports ſi doux.	Ah! ma fille, je cède à des transports si doux.
I’en ferois de bon cœur, mon frere, autant que vous.	J’en ferais de bon cœur, mon frère, autant que vous.
Mais ces lieux & cela ne s’accommodent gueres;	Mais ces lieux et cela ne s’accommodent guère;
Allons dans la maiſon débroüiller ces myſteres,	Allons dans la maison débrouiller ces mystères,
Payer à noſtre amy ces ſoins officieux,	Payer à notre ami ses soins officieux,
Et rendre grace au Ciel qui fait tout pour le mieux.	Et rendre grâce au Ciel qui fait tout pour le mieux.
