EXPERIENCES NOVVELLES TOVCHANT LE VVIDE, Faites dans des Tuyaux, Syringues, Soufflets, & Siphons de pluſieurs longueurs & figures:	EXPÉRIENCES NOUVELLES TOUCHANT LE VIDE, Faites dans des Tuyaux, Seringues, Soufflets, et Siphons de plusieurs longueurs et figures:
Auec diuerſes liqueurs, comme vif- argent, eau, vin, huyle, air, &c.	Avec diverses liqueurs, comme vif-argent, eau, vin, huile, air, etc.
Auec vn diſcours ſur le meſme ſujet.	Avec un discours sur le même sujet.
Où eſt monſtré qu’vn vaiſſeau ſi grand qu’on le pourra faire, peut eſtre rendu vuide de toutes les matieres connuës en la nature, & qui tombent ſous les ſens.	Où est montré qu’un vaisseau si grand qu’on le pourra faire, peut être rendu vide de toutes les matières connues en la nature, et qui tombent sous les sens.
Et quelle force eſt neceſſaire pour faire admettre ce vuide.	Et quelle force est nécessaire pour faire admettre ce vide.
Dedié à Monſieur PASCAL Conſeiller du Roy en ſes Conſeils d’Eſtat & Priué.	Dédié à Monsieur PASCAL Conseiller du Roi en ses Conseils d’État et Privé.
Par le ſieur B. P. ſon fils. Le tout reduit en Abbregé, & donné par aduance d’vn plus grand traicté ſur le meſme ſujet.	Par le sieur B. P. son fils. Le tout réduit en Abrégé, et donné par avance d’un plus grand traité sur le même sujet.
A PARIS, Chez Pierre MARGAT, au Quay de Geſvres, à l’Oyſeau de Paradis.	À PARIS, Chez Pierre MARGAT, au Quai de Gesvres, à l’Oiseau de Paradis.
M. DC. XLVII. Auec Permißion.	M. DC. XLVII. Avec Permission.
AV LECTEVR.	AU LECTEUR.
MON cher Lecteur, Quelques conſiderations m’empeſchans de donner à preſent vn Traictéentier, où i’ay rapporté quantité d’expetiences nouuelles que i'ay faites touchant le vuide, & les conſequences que i'enay tirées, i’ay voulu faire vn recit des principales dans cet abbregé;	MON cher Lecteur, Quelques considérations m’empêchant de donner à présent un Traité entier, où j’ai rapporté quantité d’expériences nouvelles que j’ai faites touchant le vide, et les conséquences que j’en ai tirées, j’ai voulu faire un récit des principales dans cet abrégé;
où vous verrez par auance le deſſein de tout l’ouurage.	où vous verrez par avance le dessein de tout l’ouvrage.
L’occaſion de ces experiẽces eſt telle.	L’occasion de ces expériences est telle.
Il y a enuiron quatre ans qu'en Italie on eſprouua qu'vn tuyau de verre de quatre pieds, dont vn bout eſt ouuert, & l'autre ſeellé hermetiquement, eſtant remply de vif- argent, puis l'ouuerture bouchée auec le doigt ou autrement, & le tuyau diſposé perpendiculairement à l'horizon, l'ouuerture bouchée eſtant vers le bas, & plongée deux ou trois doigts dans d’autre vif-argẽt contenu en vn vaiſſeau moitié plein de vif-argent, & l’autre moitié d’eau;	Il y a environ quatre ans qu’en Italie on éprouva qu’un tuyau de verre de quatre pieds, dont un bout est ouvert, et l’autre scellé hermétiquement, étant rempli de vif-argent, puis l’ouverture bouchée avec le doigt ou autrement, et le tuyau disposé perpendiculairement à l’horizon, l’ouverture bouchée étant vers le bas, et plongée deux ou trois doigts dans d’autre vif-argent contenu en un vaisseau moitié plein de vif-argent, et l’autre moitié d’eau;
ſi on des bouche l'ouuerture demeurant touſiours enfoncée dans le vif-argent du vaiſſeau, le vif-argent du tuyau deſcend en partie, laiſſant au haut du tuyau vn eſpace vuide en apparence, le bas du meſme tuyau demeurant plein du meſme vif-argent iuſques à vne certaine hauteur.	si on des bouche l’ouverture demeurant toujours enfoncée dans le vif-argent du vaisseau, le vif-argent du tuyau descend en partie, laissant au haut du tuyau un espace vide en apparence, le bas du même tuyau demeurant plein du même vif-argent jusqu’à une certaine hauteur.
Et ſi on hauſſe vn peu le tuyau iuſques à ce que ſon ouuerture qui trempoit auparauant dans le vif- argent du vaiſſeau, ſortant de ce vif argent;	Et si on hausse un peu le tuyau jusqu’à ce que son ouverture qui trempait auparavant dans le vif-argent du vaisseau, sortant de ce vif-argent;
arriue à la region de l'eau, le vif argent du tuyau monte iuſques en haut, auec l'eau;	arrive à la région de l’eau, le vif-argent du tuyau monte jusqu’en haut, avec l’eau;
& ces deux liqueurs ſe broüillent dans le tuyau:	et ces deux liqueurs se brouillent dans le tuyau:
mais enfin tout le vif-argent tombe, & le tuyau ſe trouue tout plein d’eau.	mais enfin tout le vif-argent tombe, et le tuyau se trouve tout plein d’eau.
Cette experience ayant eſté mandee de Rome au RP Merſenne Minime à Paris, il la diuulga en France en l’année 1644. non ſans l'admiration de tous les ſçauans & curieux;	Cette expérience ayant été mandée de Rome au R. P. Mersenne Minime à Paris, il la divulgua en France en l’année 1644 non sans l’admiration de tous les savants et curieux;
par la communication deſquels eſtant deuenuë fameuſe de toutes parts, ie l’appris de Mr Petit Intendant des Fortifications, & tres-verſé en toutes les belles letttes, qui l’auoit appriſe du RP. Merſenne meſme.	par la communication desquels étant devenue fameuse de toutes parts, je l’appris de Mr Petit Intendant des Fortifications, et très versé en toutes les belles lettres, qui l’avait apprise du R. P. Mersenne même.
Nous la fiſmes donc enſemble à Roüen ledit ſieur Petit & moy, de la meſme ſorte qu’elle auoit eſté faite en Italie, & trouuaſmes de poinct en poinct ce qui auoit eſté mandé de ce pays-lâ, ſans y auoir pour lors rien remarqué de nouueau.	Nous la fîmes donc ensemble à Rouen ledit sieur Petit et moi, de la même sorte qu’elle avait été faite en Italie, et trouvâmes de point en point ce qui avait été mandé de ce pays-là, sans y avoir pour lors rien remarqué de nouveau.
Depuis, faiſant reflexion en moi-meſme ſur les conſequences de ces experiences, elle me confirma dans la penſée où i’auois touſiours eſté, que le vuide n’eſtoit pas vne choſe impoſſible dans la Nature, & qu’elle ne le fuyoit pas auec tant d’horreur que pluſieurs ſe l’imaginent.	Depuis, faisant réflexion en moi-même sur les conséquences de ces expériences, elle me confirma dans la pensée où j’avais toujours été, que le vide n’était pas une chose impossible dans la Nature, et qu’elle ne le fuyait pas avec tant d’horreur que plusieurs se l’imaginent.
Ce qui m’obligeoit à cette penſee, eſtoit le peu  de fondement que ie voyois à la maxime ſi receuë, que la Nature ne ſouffre point le vuide;	Ce qui m’obligeait à cette pensée, était le peu de fondement que je voyais à la maxime si reçue, que la Nature ne souffre point le vide;
qui n’eſt appuyee que ſur des experiences dont la plus part ſont tres-fauſſes, quoy que tenuës pour tres-conſtantes:	qui n’est appuyée que sur des expériences dont la plupart sont très fausses, quoique tenues pour très constantes:
& des autres, les vnes ſont entierement eſloignees de contribuer à cette preuue, & montrent que la Nature abhorre la trop grande plenitude, & non pas qu’elle fuit le vuide:	et des autres, les unes sont entièrement éloignées de contribuer à cette preuve, et montrent que la Nature abhorre la trop grande plénitude, et non pas qu’elle fuit le vide:
& les plus fauorables ne font voir autre choſe, ſinon que la Nature a horreur pour le vuide, ne montrans pas qu’elle ne le peut ſouffrir.	et les plus favorables ne font voir autre chose, sinon que la Nature a horreur pour le vide, ne montrant pas qu’elle ne le peut souffrir.
A la foibleſſe de ce principe, i’adiouſtois les obſeruations que nous faiſons iournellemens de la rarefaction & condenſation de l’air;	À la faiblesse de ce principe, j’ajoutais les observations que nous faisons journellement de la raréfaction et condensation de l’air;
qui comme quelques vns ont eſprouué, ſe peut condenſer iuſques à la millieſme partie de la place qu’il ſembloit occuper auparauant, & qui ſe rarefie ſi fort, que ie trouuois comme neceſſaire, ou qu’il y eut vn grand vuide entre ſes parties, ou qu’il y eut penetration de dimenſions.	qui comme quelques-uns ont éprouvé, se peut condenser jusqu’à la millième partie de la place qu’il semblait occuper auparavant, et qui se raréfie si fort, que je trouvais comme nécessaire, ou qu’il y eût un grand vide entre ses parties, ou qu’il y eût pénétration de dimensions.
Mais comme tout le monde ne receuoit pas cela pour preuue, ie creus que cette experience d’Italie eſtoit capable de conuaincre ceux-la meſmes qui ſont les plus preoccupez de l’impoſſibilité du vuide.	Mais comme tout le monde ne recevait pas cela pour preuve, je crus que cette expérience d’Italie était capable de convaincre ceux-là mêmes qui sont les plus préoccupés de l’impossibilité du vide.
Neantmoins, la force de la preuention fit encore trouuer des objections qui luy oſterent la croyance qu’elle meritoit.	Néanmoins, la force de la prévention fit encore trouver des objections qui lui ôtèrent la croyance qu’elle méritait.
Les vns dirent que le haut de la ſarbatane eſtoit plein des eſprits du Mercure:	Les uns dirent que le haut de la sarbatane était plein des esprits du Mercure:
d’autres, d’vn grain d’air imperceptible rarefié:	d’autres, d’un grain d’air imperceptible raréfié:
d’autres, d’vne matiere qui ne ſubſiſtoit que dans leur imagination:	d’autres, d’une matière qui ne subsistait que dans leur imagination:
& tous conſpirans à bannir le vuide, exercerent à l’enui cette puiſſance de l’eſprit qu’on nomme Subtilité dans les Eſcoles:	et tous conspirant à bannir le vide, exercèrent à l’envi cette puissance de l’esprit qu’on nomme Subtilité dans les Écoles:
& qui pour ſolution des difficultez veritables, ne donne que des vaines paroles ſans fondement.	et qui pour solution des difficultés véritables, ne donne que des vaines paroles sans fondement.
Ie me reſolus donc de faire des experiences ſi conuainquantes, qu’elles fuſſent à l'eſpreuue de toutes les objections qu’on y pourroit faire:	Je me résolus donc de faire des expériences si convaincantes, qu’elles fussent à l’épreuve de toutes les objections qu’on y pourrait faire:
& i’en fis au commencement de cette année vn grand nombre, dont il y en a qui ont quelque rapport auec celle d’Italie:	et j’en fis au commencement de cette année un grand nombre, dont il y en a qui ont quelque rapport avec celle d’Italie:
& d’autres qui en ſont entierement eſloignées, & n’ont rien, de commun auec elle:	et d’autres qui en sont entièrement éloignées, et n’ont rien, de commun avec elle:
& elles ont eſté ſi exactes & ſi heureuſes, que i’ay montré par leur moyen, qu'vn vaiſſeau ſi grãd qu’on le pourra faire, peut eſtre rendu vuide de toutes les matieres qui tombent ſous les ſens, & qui ſont connuës dans la Nature:	et elles ont été si exactes et si heureuses, que j’ai montré par leur moyen, qu’un vaisseau si grand qu’on le pourra faire, peut être rendu vide de toutes les matières qui tombent sous les sens, et qui sont connues dans la Nature:
& quelle force eſt neceſſaire pour faire admettre ce vuide.	et quelle force est nécessaire pour faire admettre ce vide.
C’eſt auſſi par là que i'ay eſprouué la hauteur neceſſaire à vn ſiphon, pour faire l'effet qu’on en attend;	C’est aussi par là que j’ai éprouvé la hauteur nécessaire à un siphon, pour faire l’effet qu’on en attend;
apres laquelle hauteur limitée, il n’agit plus:	après laquelle hauteur limitée, il n’agit plus:
contre l’opinion ſi vniuerſellement receuë dans le monde durant tant de ſiecles:	contre l’opinion si universellement reçue dans le monde durant tant de siècles:
comme auſſi le peu de force neceſſaire pour attirer le piſton d’vne ſyringue, ſans qu’il y ſuccede aucune matiere:	comme aussi le peu de force nécessaire pour attirer le piston d’une seringue, sans qu’il y succède aucune matière:
& beaucoup d’autres choſes que vous verrez dans l’ouurage entier:	et beaucoup d’autres choses que vous verrez dans l’ouvrage entier:
dans lequel i’ay deſſein de montret quelle force la Nature employe pour eſuiter le vuide: & qu'elle l’admet & le ſouffre effectiuement dans vn grand eſpace, que l’on rend facilement vuide de toutes les matieres qui tombent ſous les ſens.	dans lequel j’ai dessein de montrer quelle force la Nature emploie pour éviter le vide: et qu’elle l’admet et le souffre effectivement dans un grand espace, que l’on rend facilement vide de toutes les matières qui tombent sous les sens.
C’eſt pourquoy i’ay diuiſé le Traicté entier en deux Parties, dont la premiere comprend le recit au long de toutes mes experiences auec les figures, & vne recapitulation de ce qui s’y voit, diuiſee en pluſieurs maximes.	C’est pourquoi j’ai divisé le Traité entier en deux Parties, dont la première comprend le récit au long de toutes mes expériences avec les figures, et une récapitulation de ce qui s’y voit, divisée en plusieurs maximes.
Et la ſeconde, les conſequences que i'en ay tirees, diuiſees en pluſieurs propoſitions:	Et la seconde, les conséquences que j’en ai tirées, divisées en plusieurs propositions:
où i’ay montré que l'eſpace vuide en apparence, qui a paru dans les experiences, eſt vuide en effet de toutes les matieres qui tombent ſous les ſens, & qui ſont connuës dans la Nature:	où j’ai montré que l’espace vide en apparence, qui a paru dans les expériences, est vide en effet de toutes les matières qui tombent sous les sens, et qui sont connues dans la Nature:
Et dans la cõcluſion, ie donne mon ſentiment ſur le ſuiet du vuide, & reſpons aux objections qu’on y peut faire.	Et dans la conclusion, je donne mon sentiment sur le sujet du vide, et répond aux objections qu’on y peut faire.
Ainſi, ie me contente de montrer vn grand eſpace vuide, & laiſſe à des perſonnes ſçauantes & curieuſes à eſprouuer ce qui ſe fait dans vn tel eſpace:	Ainsi, je me contente de montrer un grand espace vide, et laisse à des personnes savantes et curieuses à éprouver ce qui se fait dans un tel espace:
comme ſi les animaux y viuent:	comme si les animaux y vivent:
ſi le verre en diminuë ſa refraction:	si le verre en diminue sa réfraction:
& tout ce qu’on y peut faire, n’en faiſant nulle mention dans ce Traicté, dont i’ay iugé à propos de vous donner cet Abbregé par auance:	et tout ce qu’on y peut faire, n’en faisant nulle mention dans ce Traité, dont j’ai jugé à propos de vous donner cet Abrégé par avance:
Parce qu’ayant fait ces experiences auec beaucoup de frais, de peine & de temps;	Parce qu’ayant fait ces expériences avec beaucoup de frais, de peine et de temps;
i’ay craint qu'vn autre qui n’y auroit employé le temps, l’argent, ny la peine, me preuenant, donnat au public des choſes qu’il n’auroit pas veuës, & leſquelles par conſequent, il ne pourroit pas rapporter auec l’exacteté & l’ordre neceſſaire pour les déduire comme il faut;	j’ai craint qu’un autre qui n’y aurait employé le temps, l’argent, ni la peine, me prévenant, donnât au public des choses qu’il n’aurait pas vues, et lesquelles par conséquent, il ne pourrait pas rapporter avec l’exacteté et l’ordre nécessaire pour les déduire comme il faut;
n’y ayant perſonne qui ait eu des tuyaux & des ſiphons de la longueur des miens;	n’y ayant personne qui ait eu des tuyaux et des siphons de la longueur des miens;
& peu qui vouluſſent ſe donner la peine neceſſaire pour en auoir.	et peu qui voulussent se donner la peine nécessaire pour en avoir.
Et comme les honneſtes gens ioignent à l'inclination generale qu’ont tous les hommes de ſe maintenir dans leurs iuſtes poſſeſſions, celle de refuſer l’honneur qui ne leur eſt pas deu;	Et comme les honnêtes gens joignent à l’inclination générale qu’ont tous les hommes de se maintenir dans leurs justes possessions, celle de refuser l’honneur qui ne leur est pas dû;
vous approuuerez ſans doute, que ie me defende également, & de ceux qui voudroient m’oſter quelques-vnes des experiences que ie vous donne icy, & que ie vous promets dans le Traicté entier, puis qu’elles ſont de mon inuention:	vous approuverez sans doute, que je me défende également, et de ceux qui voudraient m’ôter quelques-unes des expériences que je vous donne ici, et que je vous promets dans le Traité entier, puisqu’elles sont de mon invention:
Et de ceux qui m’attribuëroient celle d’Italie donc ie vous ay parlé, puis qu’elle n’en eſt pas.	Et de ceux qui m’attribueraient celle d’Italie donc je vous ai parlé, puisqu’elle n’en est pas.
Car encore que ie l’aye faite en plus de façons qu’aucun autre, & auec des tuyaux de douze & meſme de quinze pieds de long:	Car encore que je l’aie faite en plus de façons qu’aucun autre, et avec des tuyaux de douze et même de quinze pieds de long:
neantmoins ie n’en parleray pas ſeulement dans ces eſcrits:	néanmoins je n’en parlerai pas seulement dans ces écrits:
parce que ie n’en ſuis pas l’Inventeur:	parce que je n’en suis pas l’Inventeur:
n’ayant deſſein de donner que celles qui me ſont particulieres, & de mon propre genie.	n’ayant dessein de donner que celles qui me sont particulières, et de mon propre génie.
ABBREGE' DE LA  premiere partie, dans laquelle ſont rapportées les  Experiences.	ABRÉGÉ DE LA première partie, dans laquelle sont rapportées les Expériences.
EXPERIENCES.	EXPÉRIENCES.
VNE ſyringue de  verre auec vn piſton bien iuſte,  plongée entierement dans l’eau, & dont on  bouche l’ouuerture auec le  doigt en ſorte qu’il touche au  bas du piſton, mettant pour  cet effect, la main & le bras    dans l’eau:	UNE seringue de verre avec un piston bien juste, plongée entièrement dans l’eau, et dont on bouche l’ouverture avec le doigt en sorte qu’il touche au bas du piston, mettant pour cet effet, la main et le bras dans l’eau:
on n’a beſoin que  d’vne force mediocre pour le  retirer & faire qu’il ſe deſ-vniſſe du doigt, ſans que l’eau y entre en aucune façon:	on n’a besoin que d’une force médiocre pour le retirer et faire qu’il se désunisse du doigt, sans que l’eau y entre en aucune façon:
(ce  que les Philoſophes ont creu  ne ſe pouuoir faire auec aucune force finie) & ainſi le doigt  ſe ſent fortement attiré &  auec douleur;	(ce que les Philosophes ont cru ne se pouvoir faire avec aucune force finie) et ainsi le doigt se sent fortement attiré et avec douleur;
& le piſton laiſſe vn eſpace vuide en apparence, & où il ne paroiſt qu’aucun corps ait peu ſucceder;	et le piston laisse un espace vide en apparence, et où il ne paraît qu’aucun corps ait pu succéder;
puis qu’il eſt tout entouré d’eau qui n’a peu y auoir  d’accez, l’ouuerture en eſtant  bouchée, & ſi on tire le piſton  dauantage, l’eſpace vuide en  apparence deuient plus grand;	puisqu’il est tout entouré d’eau qui n’a pu y avoir d’accès, l’ouverture en étant bouchée, et si on tire le piston davantage, l’espace vide en apparence devient plus grand;
mais le doigt ne ſent pas plus  d’attraction.	mais le doigt ne sent pas plus d’attraction.
Et ſi on le tire  preſque tout entier hors de  l’eau, en ſorte qu’il n’y reſte  que ſon ouuerture & le doigt  qui la bouche:	Et si on le tire presque tout entier hors de l’eau, en sorte qu’il n’y reste que son ouverture et le doigt qui la bouche:
lors, oſtant le  doigt, l’eau, contre ſa nature,  monte auecque violence, &  remplit entierement tout l’eſpace que le piſton auoit laiſſé.	lors, ôtant le doigt, l’eau, contre sa nature, monte avec violence, et remplit entièrement tout l’espace que le piston avait laissé.
2. Vn ſouflet bien fermé de  tous coſtés fait le meſme effet,  auec vne pareille preparation:	2. Un soufflet bien fermé de tous côtés fait le même effet, avec une pareille préparation:
contre le ſentiment des meſmes Philoſophes.	contre le sentiment des mêmes Philosophes.
3. Vn tuyau de verre de quarante-ſix pieds, dont vn  bout eſt ouuert, & l'autre ſeellé hermetiquement, eſtant  remply d’eau, ou pluſtoſt de  vin bien rouge, pour eſtre  plus viſible, puis bouché, &  eſleué en cet eſtat, & porté  perpendiculairement à l’horiſon, l’ouuerture bouchée en  bas, dans vn vaiſſeau plein  d’eau, & enfoncé dedans enuiron d’vn pied:	3. Un tuyau de verre de quarante-six pieds, dont un bout est ouvert, et l’autre scellé hermétiquement, étant rempli d’eau, ou plutôt de vin bien rouge, pour être plus visible, puis bouché, et élevé en cet état, et porté perpendiculairement à l’horizon, l’ouverture bouchée en bas, dans un vaisseau plein d’eau, et enfoncé dedans environ d’un pied:
ſi l’on deſbouche l’ouuerture, le vin du  tuyau deſcend iuſques à vne  certaine hauteur, qui eſt enuiron de trente-deux pieds  depuis la ſurface de l'eau du  vaiſſeau, & ſe vuide & ſe meſle parmy l’eau du vaiſſeau qu’il  teint inſenſiblement, & ſe  des-vniſſant d’auec le haut du    verre, laiſſe vn eſpace d’enuiron treize pieds vuide en apparence;	si l’on débouche l’ouverture, le vin du tuyau descend jusqu’à une certaine hauteur, qui est environ de trente-deux pieds depuis la surface de l’eau du vaisseau, et se vide et se mêle parmi l’eau du vaisseau qu’il teint insensiblement, et se désunissant d’avec le haut du verre, laisse un espace d’environ treize pieds vide en apparence;
où de meſme, il ne  paroiſt qu’aucun corps ait peu  ſucceder:	où de même, il ne paraît qu’aucun corps ait pu succéder:
Et ſi on incline le  tuyau;	Et si on incline le tuyau;
comme alors la hauteur du vin du tuyau deuient  moindre par cette inclination, le vin remonte, iuſques  à ce qu’il vienne à la hauteur  de trente-deux pieds:	comme alors la hauteur du vin du tuyau devient moindre par cette inclination, le vin remonte, jusqu’à ce qu’il vienne à la hauteur de trente-deux pieds:
& enfin, ſi on l’incline iuſques à la  hauteur de trente-deux pieds,  il ſe remplit entierement, en  reſucçant ainſi autant d’eau  qu’il auoit rejetté de vin:	et enfin, si on l’incline jusqu’à la hauteur de trente-deux pieds, il se remplit entièrement, en resuçant ainsi autant d’eau qu’il avait rejeté de vin:
ſi  bien qu’on le void plein de vin  depuis le haut iuſques à treize  pieds prez du bas, & remply    d’eau teinte inſenſiblement  dans les treize pieds inferieurs  qui reſtent.	si bien qu’on le voit plein de vin depuis le haut jusqu’à treize pieds près du bas, et rempli d’eau teinte insensiblement dans les treize pieds inférieurs qui restent.
4. Vn ſiphon ſcaléne, dont  la plus longue iambe eſt de  cinquante pieds, & la plus  courte de quarante-cinq, eſtant remply d’eau, & les deux  ouuertures bouchées eſtans  miſes dans deux vaiſſeaux  pleins d’eau, & enfoncées enuiron d’vn pied, en ſorte que  le ſiphon ſoit perpendiculaire  à l’horiſon, & que la ſurface  de l’eau d’vn vaiſſeau ſoit plus  haute que la ſurface de l’autre,  de cinq pieds:	4. Un siphon scalène, dont la plus longue jambe est de cinquante pieds, et la plus courte de quarante-cinq, étant rempli d’eau, et les deux ouvertures bouchées étant mises dans deux vaisseaux pleins d’eau, et enfoncées environ d’un pied, en sorte que le siphon soit perpendiculaire à l’horizon, et que la surface de l’eau d’un vaisseau soit plus haute que la surface de l’autre, de cinq pieds:
ſi l’on desbouche les deux ouuertures le ſiphon eſtant en cet eſtat, la    plus longue iambe n’attire  point l’eau de la plus courte, ny par conſequent celle du  vaiſſeau où elle eſt:	si l’on débouche les deux ouvertures le siphon étant en cet état, la plus longue jambe n’attire point l’eau de la plus courte, ni par conséquent celle du vaisseau où elle est:
contre le  ſentiment de tous les Philoſophes & artiſans:	contre le sentiment de tous les Philosophes et artisans:
mais l’eau deſcend de toutes les deux iambes dans les deux vaiſſeaux,  iuſques à la meſme hauteur  que dans le tuyau precedent,  en comptant la hauteur depuis la ſurface de l’eau de chacun des vaiſſeaux;	mais l’eau descend de toutes les deux jambes dans les deux vaisseaux, jusqu’à la même hauteur que dans le tuyau précédent, en comptant la hauteur depuis la surface de l’eau de chacun des vaisseaux;
Mais ayant  incliné le ſiphon au deſſous  de la hauteur d’enuiron trente-& vn pieds, la plus longue  iambe attire l’eau qui eſt dans  le vaiſſeau de la plus courte;	Mais ayant incliné le siphon au-dessous de la hauteur d’environ trente-et un pieds, la plus longue jambe attire l’eau qui est dans le vaisseau de la plus courte;
& quand on le rehauſſe au    deſſus de cette hauteur, cela ceſſe, & tous les deux  coſtés deſgorgẽt, chacun dans  ſon vaiſſeau;	et quand on le rehausse au-dessus de cette hauteur, cela cesse, et tous les deux côtés dégorgent, chacun dans son vaisseau;
Et quand on le  rabaiſſe, l’eau de la plus longue iambe atire l’eau de la plus  courte comme auparauant.	Et quand on le rabaisse, l’eau de la plus longue jambe attire l’eau de la plus courte comme auparavant.
5. Si l’on met vne corde de  prez de quinze pieds, auec vn  fil attaché au bout, (laquelle  on laiſſe long-temps dans  l’eau afin que s’imbibant peu  à peu, l’air qui pourroit y eſtre  enclos en ſorte) dans vn tuyau  de quinze pieds ſeellé par vn  bout comme deſſus, & remply d’eau;	5. Si l’on met une corde de près de quinze pieds, avec un fil attaché au bout, (laquelle on laisse longtemps dans l’eau afin que s’imbibant peu à peu, l’air qui pourrait y être enclos en sorte) dans un tuyau de quinze pieds scellé par un bout comme dessus, et rempli d’eau;
De façon qu’il n’y  ait hors du tuyau que le fil attaché à la corde, afin de l’en    tirer;	De façon qu’il n’y ait hors du tuyau que le fil attaché à la corde, afin de l’en tirer;
Et l’ouuerture ayant eſté  miſe dans du vif argent:	Et l’ouverture ayant été mise dans du vif-argent:
quand  on tire la corde peu à peu, le  vif argẽt monte à proportion,  iuſques à ce que la hauteur  du vif argent, iointe à la  quatorzieſme partie de la hauteur qui reſte d’eau, ſoit de  deux pieds trois pouces:	quand on tire la corde peu à peu, le vif-argent monte à proportion, jusqu’à ce que la hauteur du vif-argent, jointe à la quatorzième partie de la hauteur qui reste d’eau, soit de deux pieds trois pouces:
car  apres, quand on tire la corde,  l’eau quitte le haut du verre,  & laiſſe vn eſpace vuide en  apparence, qui deuient d’autant plus grand, que l’on tire  la corde dauantage:	car après, quand on tire la corde, l’eau quitte le haut du verre, et laisse un espace vide en apparence, qui devient d’autant plus grand, que l’on tire la corde davantage:
Que ſi on  incline le tuyau, le vif argent  du vaiſſeau y r’entre en ſorte  que ſi on l’incline aſſez, il ſe  trouue tout plein de vif argent    & d’eau qui frappe le haut  du tuyau auecque violence,  faiſant le meſme bruit & le  meſme eſclat que s’il caſſoit  le verre, qui court riſque de  ſe caſſer en effect:	Que si on incline le tuyau, le vif-argent du vaisseau y rentre en sorte que si on l’incline assez, il se trouve tout plein de vif-argent et d’eau qui frappe le haut du tuyau avec violence, faisant le même bruit et le même éclat que s’il cassait le verre, qui court risque de se casser en effet:
Et pour  oſter le ſoubçon de l'air que  l’on pourroit dire eſtre demeuré dans la corde, on faict  la meſme experience, auec  quantité de petits Cylindres  de bois, attachez les vns aux  autres auec du fil de laton.	Et pour ôter le soupçon de l’air que l’on pourrait dire être demeuré dans la corde, on fait la même expérience, avec quantité de petits Cylindres de bois, attachés les uns aux autres avec du fil de laiton.
6. Vne ſyringue auec vn piſton parfaitement iuſte, eſtant miſe dans le vif argent,  en ſorte que ſon ouuerture y  ſoit enfoncée pour le moins  d’vn pouce, & que le reſte de    la ſyringue ſoit eſleué perpendiculairement au dehors:	6. Une seringue avec un piston parfaitement juste, étant mise dans le vif-argent, en sorte que son ouverture y soit enfoncée pour le moins d’un pouce, et que le reste de la seringue soit élevé perpendiculairement au dehors:
ſi  l’on retire le piſton, la ſyringue demeurant en cét eſtat;	si l’on retire le piston, la seringue demeurant en cet état;
le  vif argẽt entrãt par l’ouuerture de la ſyringue, monte & demeure vny au piſton iuſques à  ce qu’il ſoit eſleué dãs la ſyringue deux pieds trois pouces;	le vif-argent entrant par l’ouverture de la seringue, monte et demeure uni au piston jusqu’à ce qu’il soit élevé dans la seringue deux pieds trois pouces;
Mais apres cette hauteur, ſi  l’on retire dauãtage le piſton, il  n’attire pas le vif argent plus  haut, qui demeurant touſiours  à cette hauteur de deux pieds  trois pouces, quitte le piſton:	Mais après cette hauteur, si l’on retire davantage le piston, il n’attire pas le vif-argent plus haut, qui demeurant toujours à cette hauteur de deux pieds trois pouces, quitte le piston:
de ſorte qu’il ſe faict vn eſpace vuide en apparence, qui  deuient d’autant plus grand  que l’on tire le piſton dauan tage:	de sorte qu’il se fait un espace vide en apparence, qui devient d’autant plus grand que l’on tire le piston davantage:
Il eſt vray-ſemblable que  la meſme choſe arriue dans vne  pompe par aſpiration;	Il est vraisemblable que la même chose arrive dans une pompe par aspiration;
& que  l'eau n'y monte que iuſques à la  hauteur de trente & vn pieds,  qui reſpond à celle de deux pieds  trois pouces de vif argent.	et que l’eau n’y monte que jusqu’à la hauteur de trente et un pieds, qui répond à celle de deux pieds trois pouces de vif-argent.
Et  ce qui eſt plus remarquable,  c’eſt que la ſyringue pezée en  cet eſtat ſans la retirer du vif  argent ny la bouger en aucune façon, peze autant (quoy  que l’eſpace vuide en apparence, ſoit ſi petit que l’on voudra) que quand, en retirant le  piſton dauantage, on le fait ſi  grand qu’on voudra:	Et ce qui est plus remarquable, c’est que la seringue pesée en cet état sans la retirer du vif-argent ni la bouger en aucune façon, pèse autant (quoique l’espace vide en apparence, soit si petit que l’on voudra) que quand, en retirant le piston davantage, on le fait si grand qu’on voudra:
& qu’elle peze touſiours autant que  le corps de la ſyringue auec le    vif argent qu’elle contient de  la hauteur de deux pieds trois  poulces, ſans qu’il y ait encore aucun eſpace vuide en apparence:	et qu’elle pèse toujours autant que le corps de la seringue avec le vif-argent qu’elle contient de la hauteur de deux pieds trois pouces, sans qu’il y ait encore aucun espace vide en apparence:
c’eſt à dire, lors que  le piſton n’a pas encore quitté  le vif argent de la ſyringue,  mais qu’il eſt preſt à s’en desvnir;	c’est-à-dire, lorsque le piston n’a pas encore quitté le vif-argent de la seringue, mais qu’il est prêt à s’en désunir;
ſi l’on le tire tant ſoit peu.	si l’on le tire tant soit peu.
De ſorte que l'eſpace vuide en  apparence, quoy que tous les  corps qui l’enuironnent tendent à le remplir, n’apporte  aucun changement à ſon  poids:	De sorte que l’espace vide en apparence, quoique tous les corps qui l’environnent tendent à le remplir, n’apporte aucun changement à son poids:
& que quelque difference de grandeur qu’il y ait  entre ces eſpaces, il n’y en a  aucune entre les poids.	et que quelque différence de grandeur qu’il y ait entre ces espaces, il n’y en a aucune entre les poids.
7. Ayant remply vn ſiphon    de vif argent, dont la plus longue iambe a dix pieds, & l’autre neuf & demy, & mis les  deux ouuertures dans deux  vaiſſeaux de vif argent, enfoncées enuiron d’vn poulce  chacune, en ſorte que la ſurface du vif argent de l’vn ſoit  plus haute de demy pied que  la ſurface du vif argent de l’autre;	7. Ayant rempli un siphon de vif-argent, dont la plus longue jambe a dix pieds, et l’autre neuf et demi, et mis les deux ouvertures dans deux vaisseaux de vif-argent, enfoncées environ d’un pouce chacune, en sorte que la surface du vif-argent de l’un soit plus haute de demi-pied que la surface du vif-argent de l’autre;
quand le ſyphon eſt perpẽdiculaire, la plus lõgue iambe  n’attire pas le vif-argent de la  plus courte:	quand le siphon est perpendiculaire, la plus longue jambe n’attire pas le vif-argent de la plus courte:
mais le vif-argent  ſe rompãt par le haut, deſcend  dans chacune des iambes, &  regorge dans les vaiſſeaux, &  tombe iuſques à la hauteur  ordinaire de deux pieds trois    poulces, depuis la ſurface du  vif argent de chaque vaiſſeau;	mais le vif-argent se rompant par le haut, descend dans chacune des jambes, et regorge dans les vaisseaux, et tombe jusqu’à la hauteur ordinaire de deux pieds trois pouces, depuis la surface du vif-argent de chaque vaisseau;
que ſi on incline le ſiphon, le  vif argent des vaiſſeaux remonte dans les iambes, les  remplit, & commence de  couler de la iambe la plus  courte dans la plus longue, &  ainſi vuide ſon vaiſseau:	que si on incline le siphon, le vif-argent des vaisseaux remonte dans les jambes, les remplit, et commence de couler de la jambe la plus courte dans la plus longue, et ainsi vide son vaisseau:
car  cette inclination dans les  tuyaux où eſt ce vuide apparent, lorsqu’ils ſont dans quelque liqueur, attire toûjours les  liqueurs des vaiſſeaux, ſi les  ouuertures des tuyaux ne ſont  point bouchées, ou attire le  doigt, s’il bouche ces ouuertures.	car cette inclination dans les tuyaux où est ce vide apparent, lorsqu’ils sont dans quelque liqueur, attire toujours les liqueurs des vaisseaux, si les ouvertures des tuyaux ne sont point bouchées, ou attire le doigt, s’il bouche ces ouvertures.
8. Le meſme ſiphon eſtant    remply d’eau entierement, &  en ſuite d’vne corde, comme  cy-deſſus, les deux ouuertures  eſtans auſſi miſes dans les deux  meſmes vaiſſeaux de vif argẽt,  quand on tire la corde par vne  de ces ouuertures, le vif argent  monte des vaiſſeaux dans toutes les deux iambes:	8. Le même siphon étant rempli d’eau entièrement, et ensuite d’une corde, comme ci-dessus, les deux ouvertures étant aussi mises dans les deux mêmes vaisseaux de vif-argent, quand on tire la corde par une de ces ouvertures, le vif-argent monte des vaisseaux dans toutes les deux jambes:
en ſorte  que la quatorzieſme partie de  la hauteur de l’eau d’vne iambe, auec la hauteur du vif argẽt  qui y eſt monté, eſt egale à la  quatorzieſme partie de la hauteur de l’eau de l’autre, iointe  à la hauteur du vif argent qui  y eſt monté;	en sorte que la quatorzième partie de la hauteur de l’eau d’une jambe, avec la hauteur du vif-argent qui y est monté, est égale à la quatorzième partie de la hauteur de l’eau de l’autre, jointe à la hauteur du vif-argent qui y est monté;
ce qui arriuera  tant que cette quatorzieſme  partie de la hauteur de l’eau,   iointe à la hauteur du vif argent dans chaque iambe, ſoit  de la hauteur de deux pieds  trois poulces:	ce qui arrivera tant que cette quatorzième partie de la hauteur de l’eau, jointe à la hauteur du vif-argent dans chaque jambe, soit de la hauteur de deux pieds trois pouces:
car apres, l'eau  ſe diuiſera par le haut, &  il s’y trouuera vn vuide apparent.	car après, l’eau se divisera par le haut, et il s’y trouvera un vide apparent.
Deſquelles experiences, & de  pluſieurs, autres rapportées  dans le Liure entier, où ſe voyent  des tuyaux de toutes longueurs  groſſeurs, & figurés, chargez de differentes liqueurs, enfoncées diuerſement dans des  liqueurs differentes, transportées des vnes dans les autres,  pezées en pluſieurs façons, &  ou ſont remarquées les attractions differentes que reſſent le  doigt qui bouſche les tuyaux où  eſt le vuide apparent;	Desquelles expériences, et de plusieurs, autres rapportées dans le Livre entier, où se voient des tuyaux de toutes longueurs grosseurs, et figurés, chargés de différentes liqueurs, enfoncées diversement dans des liqueurs différentes, transportées des unes dans les autres, pesées en plusieurs façons, et où sont remarquées les attractions différentes que ressent le doigt qui bouche les tuyaux où est le vide apparent;
on déduit  manifeſtement ces maximes.	on déduit manifestement ces maximes.
MAXIMES.	MAXIMES.
1. QVe tous les corps ont  repugnance à ſe ſeparer l’vn de l’autre, & admettre ce vuide apparent dans  leur interualle:	1. QUe tous les corps ont répugnance à se séparer l’un de l’autre, et admettre ce vide apparent dans leur intervalle:
c’eſt à dire, que  la Nature abhorre ce vuide  apparent.	c’est-à-dire, que la Nature abhorre ce vide apparent.
2. Que cette horreur où  cette repugnance qu’ont tous  les corps n’eſt pas plus grande pour admettre vn grand  vuide apparent qu’vn petit:	2. Que cette horreur où cette répugnance qu’ont tous les corps n’est pas plus grande pour admettre un grand vide apparent qu’un petit:
c’eſt à dire, à s’eſloigner d’vn  grand interualle que d’vn petit.	c’est-à-dire, à s’éloigner d’un grand intervalle que d’un petit.
3. Que la force de cette horreur eſt limitée, & pareille à  celle auec laquelle de l’eau  d’vne certaine hauteur qui eſt  enuiron de trente & vn pieds,  tend à couler en bas.	3. Que la force de cette horreur est limitée, et pareille à celle avec laquelle de l’eau d’une certaine hauteur qui est environ de trente et un pieds, tend à couler en bas.
4. Que les corps qui bornent  ce vuide apparent, ont inclination à le remplir.	4. Que les corps qui bornent ce vide apparent, ont inclination à le remplir.
5. Que cette inclination n'eſt  pas plus forte pour remplir vn  grand vuide apparent, qu’vn  petit.	5. Que cette inclination n’est pas plus forte pour remplir un grand vide apparent, qu’un petit.
6. Que la force de cette inclination eſt limitée, & touſjours pareille à celle auec laquelle de l’eau d’vne certaine  hauteur, qui eſt enuiron de  trente & vn pied, tend à couler en bas.	6. Que la force de cette inclination est limitée, et toujours pareille à celle avec laquelle de l’eau d’une certaine hauteur, qui est environ de trente et un pied, tend à couler en bas.
7. Qu'vne force plus grande  de ſi peu que l’on voudra, que  celle auec laquelle l'eau de la  hauteur de trente & vn pieds,  tend à couler en bas, ſuffit  pour faire admettre ce vuide  apparent, & meſme ſi grãd que  l'on voudra, c’eſt à dire, pour  faire des-vnir les corps d’vn  ſi grand interualle que l’on  voudra, pourueu qu’il n’y ait  point d’autre obſtacle à leur  ſeparation ny à leur eſloignement, que l’horreur que la Nature a pour ce vuide apparent.	7. Qu’une force plus grande de si peu que l’on voudra, que celle avec laquelle l’eau de la hauteur de trente et un pieds, tend à couler en bas, suffit pour faire admettre ce vide apparent, et même si grand que l’on voudra, c’est-à-dire, pour faire désunir les corps d’un si grand intervalle que l’on voudra, pourvu qu’il n’y ait point d’autre obstacle à leur séparation ni à leur éloignement, que l’horreur que la Nature a pour ce vide apparent.
ABBREGE’ DE LA  deuxieſme Partie, dans laquelle ſont rapportées les conſequences de ces Experiences  touchant la matiere qui peut  remplir cet eſpace vuide en apparence, diuiſée en pluſieurs  propoſitions, auec leurs demonſtrations.	ABRÉGÉ DE LA deuxième Partie, dans laquelle sont rapportées les conséquences de ces Expériences touchant la matière qui peut remplir cet espace vide en apparence, divisée en plusieurs propositions, avec leurs démonstrations.
PROPOSITIONS.	PROPOSITIONS.
QVE l’eſpace vuide en apparence  n'eſt pas remply  de l’air exterieur  qui enuironne le tuyau, &    qu’il n’y eſt point entré par les  pores du verre.	QUE l’espace vide en apparence n’est pas rempli de l’air extérieur qui environne le tuyau, et qu’il n’y est point entré par les pores du verre.
2. Qu'il n'eſt pas plein de  l’air que quelques Philoſophes diſent eſtre enfermé dans  les pores de tous les corps, qui  ſe trouueroit par ce moyen, au  dedans de la liqueur qui remplit les tuyaux.	2. Qu’il n’est pas plein de l’air que quelques Philosophes disent être enfermé dans les pores de tous les corps, qui se trouverait par ce moyen, au dedans de la liqueur qui remplit les tuyaux.
3. Qu’il n’eſt pas plein de l’air  que quelques-vns eſtiment  eſtre entre le tuyau, & la liqueur qui le remplit, & enferme dans les interſtices ou atomes des corpuſcules qui compoſent ces liqueurs.	3. Qu’il n’est pas plein de l’air que quelques-uns estiment être entre le tuyau, et la liqueur qui le remplit, et enferme dans les interstices ou atomes des corpuscules qui composent ces liqueurs.
4. Qu'il n'eſt pas plein d’vn  grain d’air imperceptible, reſté  par hazard entre la liqueur &    le verre, ou porté par le doigt  qui le bouche, ou entré par  quelqu’autre façon, qui ſe rarefieroit extraordinairement;	4. Qu’il n’est pas plein d’un grain d’air imperceptible, resté par hasard entre la liqueur et le verre, ou porté par le doigt qui le bouche, ou entré par quelqu’autre façon, qui se raréfierait extraordinairement;
& que quelques vns ſouſtiendroient ſe pouuoir rarefier aſſez pour remplir tout le monde, pluſtoſt que d'admettre  du vuide.	et que quelques uns soutiendraient se pouvoir raréfier assez pour remplir tout le monde, plutôt que d’admettre du vide.
5. Qu'il n'eſt pas plein d’vne  petite portion du vif argent  ou de l’eau, qui eſtant tirée  d’vn coſté par les parois du verre, & de l'autre par la force de  la liqueur, ſe rarefie & ſe conuertit en vapeurs;	5. Qu’il n’est pas plein d’une petite portion du vif-argent ou de l’eau, qui étant tirée d’un côté par les parois du verre, et de l’autre par la force de la liqueur, se raréfie et se convertit en vapeurs;
en ſorte que  cette attraction reciproque  faſſe le meſme effet que la chaleur qui conuertit ces liqueurs    en vapeur, & les rend volatilles.	en sorte que cette attraction réciproque fasse le même effet que la chaleur qui convertit ces liqueurs en vapeur, et les rend volatiles.
6. Qu'il n'eſt pas plein des  eſprits de la liqueur qui remplit le tuyau.	6. Qu’il n’est pas plein des esprits de la liqueur qui remplit le tuyau.
7. Qu'il n'eſt pas plein d’vn  air plus ſubtil meſlé parmy  l’air exterieur, qui en eſtant  deſtaché & entré par les pores  du verre, tendroit touſiours à  y retourner, ou y ſeroit ſans  ceſſe attiré.	7. Qu’il n’est pas plein d’un air plus subtil mêlé parmi l’air extérieur, qui en étant détaché et entré par les pores du verre, tendrait toujours à y retourner, ou y serait sans cesse attiré.
8. Que l'eſpace vuide en apparence, n’eſt remply d’aucune des matieres qui ſont connuës dans la Nature, & qui  tombent ſous ancun des  ſens.	8. Que l’espace vide en apparence, n’est rempli d’aucune des matières qui sont connues dans la Nature, et qui tombent sous aucun des sens.	8. Que l'eſpace vuide en apparence, n’eſt remply d’aucune des matieres qui ſont connuës dans la Nature, & qui  tombent ſous aucun des  ſens.
ABBREGE' DE LA  Concluſion, dans laquelle  ie donne mon ſentiment.	ABRÉGÉ DE LA Conclusion, dans laquelle je donne mon sentiment.
APres auoir demonſtré  qu'aucunes des matieres  qui tombent ſous nos ſens,  & dont nous auons connoiſſance,  ne rempliſſent cet eſpace vuide  en apparence.	APrès avoir démontré qu’aucunes des matières qui tombent sous nos sens, et dont nous avons connaissance, ne remplissent cet espace vide en apparence.
Mon ſentiment  ſera, iuſques à ce qu'on m'aye  montré l'exiſtance de quelque  matiere qui le rempliſſe, qu'il eſt  veritablement vuide, & deſtitué de toute matiere.	Mon sentiment sera, jusqu’à ce qu’on m’ait montré l’existence de quelque matière qui le remplisse, qu’il est véritablement vide, et destitué de toute matière.
C'eſt pourquoy ie diray du    vuide veritable, ce que i'ay  montré du vuide apparent, &  ie tiendray pour vrayes les Maximes poſées cy-deſſus, & enoncées du vuide abſolu comme elles  l’ont eſté de l’apparent, ſçauoir  en cette ſorte	C’est pourquoi je dirai du vide véritable, ce que j’ai montré du vide apparent, et je tiendrai pour vraies les Maximes posées ci-dessus, et énoncées du vide absolu comme elles l’ont été de l’apparent, savoir en cette sorte
MAXIMES.	MAXIMES.
1. QVe tous les corps ont  repugnance à ſe ſeparer l’vn de l'autre, & admettre  du vuide dans leur interualle;	1. QUe tous les corps ont répugnance à se séparer l’un de l’autre, et admettre du vide dans leur intervalle;
c’eſt à dire, que la Nature abhorre le vuide.	c’est-à-dire, que la Nature abhorre le vide.
2. Que cette horreur ou repugnance qu’ont tous les  corps, n'eſt pas plus grande  pour admettre vn grand vuide, qu’vn petit:	2. Que cette horreur ou répugnance qu’ont tous les corps, n’est pas plus grande pour admettre un grand vide, qu’un petit:
c’eſt à dire,  pour s’eſloigner d’vn grand  interualle que d’vn petit.	c’est-à-dire, pour s’éloigner d’un grand intervalle que d’un petit.
3. Que la force de cette horreur eſt limitée, & pareille à  celle auec laquelle de l’eau  d’vne certaine hauteur, qui eſt  à peu prés de trente & vn pied,  tend à couler en bas.	3. Que la force de cette horreur est limitée, et pareille à celle avec laquelle de l’eau d’une certaine hauteur, qui est à peu près de trente et un pied, tend à couler en bas.
4. Que les corps qui bornent  ce vuide, ont inclination à le  remplir.	4. Que les corps qui bornent ce vide, ont inclination à le remplir.
5. Que cette inclination n'eſt  pas plus forte pour remplir vn  grand vuide, qu'vn petit.	5. Que cette inclination n’est pas plus forte pour remplir un grand vide, qu’un petit.
6. Que la force de cette inclination eſt limitée & touſiours  égale à celle auec laquelle l’eau  d’vne certaine hauteur, qui    eſt enuiron de trente & vn  pied, tend à couler en bas.	6. Que la force de cette inclination est limitée et toujours égale à celle avec laquelle l’eau d’une certaine hauteur, qui est environ de trente et un pied, tend à couler en bas.
7. Qu'vne force plus grande  de ſi peu que l’on voudra, que  celle auec laquelle l’eau de la  hauteur de trente & vn pied  tend à couler en bas, ſuffit  pour faire admette du vuide,  & meſme ſi grand que l’on  voudra;	7. Qu’une force plus grande de si peu que l’on voudra, que celle avec laquelle l’eau de la hauteur de trente et un pied tend à couler en bas, suffit pour faire admette du vide, et même si grand que l’on voudra;
c’eſt à dire, à faire desvnir les corps d’vn ſi grand interualle que l’on voudra:	c’est-à-dire, à faire désunir les corps d’un si grand intervalle que l’on voudra:
pourueu qu’il n’y ait point d’autre  obſtacle à leur ſeparation ny  à leur eſloignement que l’horreur que la Nature a pour le  vuide.	pourvu qu’il n’y ait point d’autre obstacle à leur séparation ni à leur éloignement que l’horreur que la Nature a pour le vide.
ENSVITE IE RESpons aux objections qu’on y  peut faire, dont voicy les  principales.	ENSUITE JE RÉponds aux objections qu’on y peut faire, dont voici les principales.
OBIECTIONS.	OBJECTIONS.
1. QVe cette propoſtion,  qu’vn eſpace eſt vuidé, repugne au ſens commun.	1. QUe cette proposition, qu’un espace est vidé, répugne au sens commun.
2. Que cette propoſition, que  la Nature abhorre le vuide, &  neantmoins l’admet, l'accuſe  d’impuiſſance, ou implique  contradiction.	2. Que cette proposition, que la Nature abhorre le vide, et néanmoins l’admet, l’accuse d’impuissance, ou implique contradiction.
3. Que pluſieurs experiences, & meſmes iournalieres,    montrent que là Nature ne  peut ſouffrir de vuide.	3. Que plusieurs expériences, et mêmes journalières, montrent que là Nature ne peut souffrir de vide.
4. Qu’vne matiere imperceptible, inoüye & incognuë à  tous les ſens, remplit cet eſpace.	4. Qu’une matière imperceptible, inouïe et inconnue à tous les sens, remplit cet espace.
5. Que la lumiere eſtant vn  accident, ou vne ſubſtance;	5. Que la lumière étant un accident, ou une substance;
il  n'eſt pas poſſible qu'elle ſe  ſouſtienne dans le vuide,  ſi elle eſt vn accident;	il n’est pas possible qu’elle se soutienne dans le vide, si elle est un accident;
&  qu'elle remplit l'eſpace vuide  en apparence, ſi elle eſt vne  ſubſtance.	et qu’elle remplit l’espace vide en apparence, si elle est une substance.
Permißion.	Permission.
IL eſt permis au ſieur PASCAL de faire imprimer vn Liuret intitulé, Experiences nouuelles touchant le vuide, &c.	IL est permis au sieur PASCAL de faire imprimer un Livret intitulé, Expériences nouvelles touchant le vide, etc.
Faict à Paris ce 8. Octobre 1647.	Fait à Paris ce 8. Octobre 1647.
DAVBRAY.	DAUBRAY.
