TRAITEZ DE L’EQVILIBRE DES LIQVEVRS, ET DE LA PESANTEVR DE LA MASSE DE L'AIR.	TRAITÉS DE L’ÉQUILIBRE DES LIQUEURS, ET DE LA PESANTEUR DE LA MASSE DE L’AIR.
Contenant l’explication des cauſes de divers effets de la nature qui n’avoient point eſté bien connus juſques ici, & particulieremẽt de ceux que l’on avoit attribuez à l’horreur du Vuide.	Contenant l’explication des causes de divers effets de la nature qui n’avaient point été bien connus jusqu'ici, et particulièrement de ceux que l’on avait attribués à l’horreur du Vide.
Par Monſieur PASCAL. A PARIS, Chez GVILLAUME DESPREZ, ruë S. Iacques, à l’Image S. Proſper. M. DC. LXIII. AVEC PRIVILEGE DV ROY.	Par Monsieur PASCAL. À PARIS, Chez GUILLAUME DESPREZ, rue S. Jacques, à l’Image S. Prosper. M. DC. LXIII. AVEC PRIVILÈGE DU ROI.
SI l’on attache contre vn mur pluſieurs Vaiſſeaux, l’vn tel que celuy de la premiere Figure;	SI l’on attache contre un mur plusieurs Vaisseaux, l’un tel que celui de la première Figure;
l’autre panché, comme en la ſeconde;	l’autre penché, comme en la seconde;
l'autre fort large, comme en la troiſiéme;	l’autre fort large, comme en la troisième;
l’autre eſtroit, comme en la quatriéme;	l’autre étroit, comme en la quatrième;
l’autre qui ne ſoit qu’vn petit tuyau qui aboutiſſe à vn Vaiſſeau large par en bas, mais qui n’ait preſque point de hauteur, comme en la cinquiéme Figure;	l’autre qui ne soit qu’un petit tuyau qui aboutisse à un Vaisseau large par en bas, mais qui n’ait presque point de hauteur, comme en la cinquième Figure;
& qu’on les rempliſſe tous d’eau juſques à vne meſme hauteur, & qu’on faſſe à tous des ouuertures pareilles par en bas, leſquelles on bouche pour retenir l’eau: l’experience fait voir, qu’il faut vne pareille force pour empeſcher tous ces tampons de ſortir, quoy que l'eau ſoit en vne quantité toute differente en tous ces differents Vaiſſeaux;	et qu’on les remplisse tous d’eau jusqu’à une même hauteur, et qu’on fasse à tous des ouvertures pareilles par en bas, lesquelles on bouche pour retenir l’eau: l’expérience fait voir, qu’il faut une pareille force pour empêcher tous ces tampons de sortir, quoique l’eau soit en une quantité toute différente en tous ces différents Vaisseaux;
parce qu’elle eſt à vne pareille hauteur en tous: & la meſure de cette force eſt le poids de l’eau contenuë dans le premier Vaiſſeau, qui eſt vniforme en tout ſon corps. Car ſi cette eau peſe cent liures, il faudra vne force de cent liures, pour ſoûtenir chacun des tampons, & meſme celuy du Vaiſſeau cinquiéme, quand l’eau qui y eſt ne peſeroit pas vne once.	parce qu’elle est à une pareille hauteur en tous: et la mesure de cette force est le poids de l’eau contenue dans le premier Vaisseau, qui est uniforme en tout son corps. Car si cette eau pèse cent livres, il faudra une force de cent livres, pour soutenir chacun des tampons, et même celui du Vaisseau cinquième, quand l’eau qui y est ne pèserait pas une once.
Pour l’éprouuer exactement, il faut boucher l’ouuerture du cinquiéme Vaiſſeau auec vne piece de bois ronde, enueloppée d’étoupe comme le piſton d’vne Pompe, qui entre & couſe dans cette ouuerture auec tant de juſteſſe, qu’il n’y tienne pas, & qu’il empeſche neanmoins l’eau d’en ſortir, & attacher vn fil au milieu de ce Piſton, que l’on paſſe dans ce petit tuyau, pour l’attacher à vn bras de balance, & pendre à l’autre bras vn poids de cent liures: on verra vn parfait Equilibre de ce poids de cent liures auec l'eau du petit tuyau qui peſe vne once;	Pour l’éprouver exactement, il faut boucher l’ouverture du cinquième Vaisseau avec une pièce de bois ronde, enveloppée d’étoupe comme le piston d’une Pompe, qui entre et couse dans cette ouverture avec tant de justesse, qu’il n’y tienne pas, et qu’il empêche néanmoins l’eau d’en sortir, et attacher un fil au milieu de ce Piston, que l’on passe dans ce petit tuyau, pour l’attacher à un bras de balance, et pendre à l’autre bras un poids de cent livres: on verra un parfait Equilibre de ce poids de cent livres avec l’eau du petit tuyau qui pèse une once;
& ſi peu qu’on diminuë de ces cent liures, le poids de l'eau fera baiſſer le Piſton, & par conſequent baiſſer le bras de la balance où il eſt attaché, & hauſſer celuy où pend le poids d’vn peu moins de cent liures.	et si peu qu’on diminue de ces cent livres, le poids de l’eau fera baisser le Piston, et par conséquent baisser le bras de la balance où il est attaché, et hausser celui où pend le poids d’un peu moins de cent livres.
Si cette eau vient à ſe glacer, & que la glace ne prenne pas au Vaiſſeau, comme en effet elle ne s’y attache pas d’ordinaire, il ne faudra à l’autre bras de la balance qu’vne once pour tenir le poids de la glace en Equilibre;	Si cette eau vient à se glacer, et que la glace ne prenne pas au Vaisseau, comme en effet elle ne s’y attache pas d’ordinaire, il ne faudra à l’autre bras de la balance qu’une once pour tenir le poids de la glace en Équilibre;
mais ſi on approche du feu contre le Vaiſſeau, qui faſſe fondre la glace, il faudra vn poids de cent liures pour contrebalancer la peſanteur de cette glace fonduë en eau, quoy que nous ne la ſuppoſions que d’vne once.	mais si on approche du feu contre le Vaisseau, qui fasse fondre la glace, il faudra un poids de cent livres pour contrebalancer la pesanteur de cette glace fondue en eau, quoique nous ne la supposions que d’une once.
La meſme choſe arriueroit, quand ces ouuertures que l’on bouche ſeroient à coſté, ou meſme en haut: & il ſeroit meſme plus aiſé de l’éprouuer en cette ſorte.	La même chose arriverait, quand ces ouvertures que l’on bouche seraient à côté, ou même en haut: et il serait même plus aisé de l’éprouver en cette sorte.
Figure VI. Il faut auoir vn Vaiſſeau clos de tous coſtez, & y faire deux ouuertures en haut, vne fort-étroitte, l'autre plus large;	Figure VI. Il faut avoir un Vaisseau clos de tous côtés, et y faire deux ouvertures en haut, une fort étroite, l’autre plus large;
Figure VI.	Figure VI.
& ſouder ſur l’vne & ſur l’autre, des tuyaux de la groſſeur chacun de ſon ouuerture;	et souder sur l’une et sur l’autre, des tuyaux de la grosseur chacun de son ouverture;
& on verra que ſi on met vn Piſton au tuyau large, & qu’on verſe de l’eau dans le tuyau menu, il faudra mettre ſur le Piſton vn grand poids, pour empeſcher que le poids de l’eau du petit tuyau ne le pouſſe en haut;	et on verra que si on met un Piston au tuyau large, et qu’on verse de l’eau dans le tuyau menu, il faudra mettre sur le Piston un grand poids, pour empêcher que le poids de l’eau du petit tuyau ne le pousse en haut;
de la meſme ſorte que dans les premiers exemples il falloit vne force de cent liures pour empeſcher que le poids de l’eau ne les pouſsât en bas, parce que l’ouuerture eſtoit en bas;	de la même sorte que dans les premiers exemples il fallait une force de cent livres pour empêcher que le poids de l’eau ne les poussât en bas, parce que l’ouverture était en bas;
& ſi elle eſtoit à côté, il faudroit vne pareille force pour empeſcher que le poids de l’eau ne repouſsât le Piſton vers ce coſté.	et si elle était à côté, il faudrait une pareille force pour empêcher que le poids de l’eau ne repoussât le Piston vers ce côté.
Et quand le tuyau plein d’eau ſeroit cent fois plus large ou cent fois plus eſtroit, pourueu que l'eau y fût toûjours à la meſme hauteur, il faudroit toûjours vn meſme poids pour contrepeſer l’eau, & ſi peu qu’on diminuë le poids, l’eau baiſſera, & fera monter le poids diminué.	Et quand le tuyau plein d’eau serait cent fois plus large ou cent fois plus étroit, pourvu que l’eau y fût toujours à la même hauteur, il faudrait toujours un même poids pour contre-peser l’eau, et si peu qu’on diminue le poids, l’eau baissera, et fera monter le poids diminué.
Reigle de la force neceſſaire pour arreſter l'eau. Mais ſi on verſoit de l’eau dans le tuyau à vne hauteur double, il faudroit vn poids double ſur le Piſton, pour contrepeſer l’eau;	Règle de la force nécessaire pour arrêter l’eau. Mais si on versait de l’eau dans le tuyau à une hauteur double, il faudrait un poids double sur le Piston, pour contre-peser l’eau;
Reigle de la force neceſſaire pour arreſter l'eau.	Règle de la force nécessaire pour arrêter l’eau.
& de meſme ſi on faiſoit l’ouuerture où eſt le Piſton, double de ce qu’elle eſt, il faudroit doubler la force neceſſaire pour ſoûtenir le Piſton double: d’où l’on voit que la force neceſſaire pour empeſcher l’eau de couler par vne ouuerture, eſt proportionnée à la hauteur de l’eau, & non pas à ſa largeur;	et de même si on faisait l’ouverture où est le Piston, double de ce qu’elle est, il faudrait doubler la force nécessaire pour soutenir le Piston double: d’où l’on voit que la force nécessaire pour empêcher l’eau de couler par une ouverture, est proportionnée à la hauteur de l’eau, et non pas à sa largeur;
& que la meſure de cette force eſt toûjours le poids de toute l’eau qui ſeroit contenuë dans vne colomne de la hauteur de l’eau, & de la groſſeur de l’ouuerture.	et que la mesure de cette force est toujours le poids de toute l’eau qui serait contenue dans une colonne de la hauteur de l’eau, et de la grosseur de l’ouverture.
Ce que j'ay dit de l’eau ſe doit entendre de toute autre ſorte de Liqueurs.	Ce que j’ai dit de l’eau se doit entendre de toute autre sorte de Liqueurs.
ON voit par tous ces exemples, qu’vn petit filet d’eau tient vn grand poids en Equilibre: il reſte à montrer quelle eſt la cauſe de cette multiplication de force;	ON voit par tous ces exemples, qu’un petit filet d’eau tient un grand poids en Équilibre: il reste à montrer quelle est la cause de cette multiplication de force;
nous l’allons faire par l’experience qui ſuit.	nous l’allons faire par l’expérience qui suit.
Figure VII. Nouuelle ſorte de Machine pour multiplier les forces. Si vn Vaiſſeau plein d’eau, clos de toutes parts a deux ouuertures, l’vne centuple de l’autre;	Figure VII. Nouvelle sorte de Machine pour multiplier les forces. Si un Vaisseau plein d’eau, clos de toutes parts a deux ouvertures, l’une centuple de l’autre;
Figure VII. Nouuelle ſorte de Machine pour multiplier les forces.	Figure VII. Nouvelle sorte de Machine pour multiplier les forces.
en mettant à chacune vn Piſton qui luy ſoit juſte, vn homme pouſſant le petit Piſton égalera la force de cent hommes qui pouſſeront celuy qui eſt cent fois plus large & en ſurmontera quatre vingt dix neuf.	en mettant à chacune un Piston qui lui soit juste, un homme poussant le petit Piston égalera la force de cent hommes qui pousseront celui qui est cent fois plus large et en surmontera quatre-vingt-dix-neuf.
Et quelque proportion qu’ayent ces ouuertures, ſi les forces qu’on mettra ſur les Piſtons ſont comme les ouuertures, elles ſeront en Equilibre. D’où il paroiſt, qu’vn Vaiſſeau plein d’eau eſt vn nouueau principe de Mechanique, & vne machine nouuelle pour multiplier les forces à tel dégré qu’on voudra, puis qu’vn homme par ce moyen pourra enleuer tel fardeau qu’on luy propoſera.	Et quelque proportion qu’aient ces ouvertures, si les forces qu’on mettra sur les Pistons sont comme les ouvertures, elles seront en Équilibre. D’où il paraît, qu’un Vaisseau plein d’eau est un nouveau principe de Mécanique, et une machine nouvelle pour multiplier les forces à tel degré qu’on voudra, puisqu’un homme par ce moyen pourra enlever tel fardeau qu’on lui proposera.
Et l’on doit admirer, qu’il ſe rencontre en cette Machine nouuelle cét ordre conſtant qui ſe trouue en toutes les anciennes, ſçauoir le leuier, le tour, la vis ſans fin, &c. qui eſt, que le chemin eſt augmenté en meſme proportion que la force. Car il eſt viſible, que comme vne de ces ouuerture eſt centuple de l’autre, ſi l’homme qui pouſſe le petit Piſton l’enfonçoit d’vn poulce, il ne repouſſeroit l’autre que de la centiéme partie ſeulement: car comme cette impulſion ſe fait à cauſe de la continuité de l’eau, qui communique de l’vn des Piſtons à l’autre, & qui fait que l’vn ne peut ſe mouuoir ſans pouſſer l’autre;	Et l’on doit admirer, qu’il se rencontre en cette Machine nouvelle cet ordre constant qui se trouve en toutes les anciennes, savoir le levier, le tour, la vis sans fin, etc. qui est, que le chemin est augmenté en même proportion que la force. Car il est visible, que comme une de ces ouverture est centuple de l’autre, si l’homme qui pousse le petit Piston l’enfonçait d’un pouce, il ne repousserait l’autre que de la centième partie seulement: car comme cette impulsion se fait à cause de la continuité de l’eau, qui communique de l’un des Pistons à l’autre, et qui fait que l’un ne peut se mouvoir sans pousser l’autre;
il eſt viſible que quand le petit Piſton s’eſt meu d’vn poulce, l’eau qu’il a pouſſée, pouſſant l’autre Piſton, comme elle trouue ſon ouuerture cent fois plus large, elle n’y occupe que la centiéme partie de la hauteur: de ſorte que le chemin eſt au chemin, comme la force à la force. Ce que l'on peut prendre meſme pour la vraye cauſe de cét effet, eſtant clair, que c’eſt la meſme choſe de faire faire vn poulce de chemin à cent liures d’eau, que de faire faire cent poulces de chemin à vne liure d’eau;	il est visible que quand le petit Piston s’est mû d’un pouce, l’eau qu’il a poussée, poussant l’autre Piston, comme elle trouve son ouverture cent fois plus large, elle n’y occupe que la centième partie de la hauteur: de sorte que le chemin est au chemin, comme la force à la force. Ce que l’on peut prendre même pour la vraie cause de cet effet, étant clair, que c’est la même chose de faire faire un pouce de chemin à cent livres d’eau, que de faire faire cent pouces de chemin à une livre d’eau;
& qu’ainſi, lors qu’vne liure d’eau eſt tellement ajuſtée auec cent liures d’eau, que les cent liures ne puiſſent ſe remuer vn poulce, qu’elles ne faſſent remuer la liure de cent poulces, il faut qu’elles demeurent en Equilibre, vne liure ayant autant de force pour faire faire vn poulce de chemin à cent liures, que cent liures pour faire faire cent poulces à vne liure.	et qu’ainsi, lorsqu’une livre d’eau est tellement ajustée avec cent livres d’eau, que les cent livres ne puissent se remuer un pouce, qu’elles ne fassent remuer la livre de cent pouces, il faut qu’elles demeurent en Équilibre, une livre ayant autant de force pour faire faire un pouce de chemin à cent livres, que cent livres pour faire faire cent pouces à une livre.
On peut encore ajoûter pour plus grand éclairciſſement, que l’eau eſt également preſſée ſous ces deux Piſtons;	On peut encore ajouter pour plus grand éclaircissement, que l’eau est également pressée sous ces deux Pistons;
car ſi l’vn a cent fois plus de poids que l’autre, auſſi en reuanche il touche cent fois plus de parties;	car si l’un a cent fois plus de poids que l’autre, aussi en revanche il touche cent fois plus de parties;
& ainſi chacune l’eſt également;	et ainsi chacune l’est également;
donc toutes doiuent eſtre en repos, parce qu’il n’y a pas plus de raiſon pourquoy l’vne cede que l'autre: de ſorte que ſi vn Vaiſſeau plein d’eau n’a qu’vne ſeule ouuerture, large d’vn poulce, par exemple, où l’on mette vn Piſton chargé d’vn poids d’vne liure;	donc toutes doivent être en repos, parce qu’il n’y a pas plus de raison pourquoi l’une cède que l’autre: de sorte que si un Vaisseau plein d’eau n’a qu’une seule ouverture, large d’un pouce, par exemple, où l’on mette un Piston chargé d’un poids d’une livre;
ce poids fait effort contre toutes les parties du Vaiſſeau generalement, à cauſe de la cõtinuité & de la fluidité de l’eau: mais pour determiner combien chaque partie ſouffre;	ce poids fait effort contre toutes les parties du Vaisseau généralement, à cause de la continuité et de la fluidité de l’eau: mais pour déterminer combien chaque partie souffre;
en voicy la regle. Chaque partie large d’vn poulce, comme l’ouuerture, ſouffre autant que ſi elle eſtoit pouſſée par le poids d’vne liure (ſans compter le poids de l’eau dont je ne parle pas icy, car je ne parle que du poids du Piſton) parce que le poids d’vne liure preſſe le Piſton qui eſt à l’ouuerture, & chaque portion du Vaiſſeau plus ou moins grande, ſouffre preciſément plus ou moins à proportion de ſa grandeur, ſoit que cette portion ſoit vis à vis de l’ouuerture, ou à coſté, loin ou preſt;	en voici la règle. Chaque partie large d’un pouce, comme l’ouverture, souffre autant que si elle était poussée par le poids d’une livre (sans compter le poids de l’eau dont je ne parle pas ici, car je ne parle que du poids du Piston) parce que le poids d’une livre presse le Piston qui est à l’ouverture, et chaque portion du Vaisseau plus ou moins grande, souffre précisément plus ou moins à proportion de sa grandeur, soit que cette portion soit vis-à-vis de l’ouverture, ou à côté, loin ou près;
car la continuité & la fluidité de l’eau rend toutes ces choſes là égales & indifferentes: De ſorte qu’il faut que la matiere dont le Vaiſſeau eſt fait, ait aſſez de reſiſtances en toutes ſes parties pour ſoûtenir tous ces efforts: Si ſa reſiſtance eſt moindre en quelqu’vne, elle creve;	car la continuité et la fluidité de l’eau rend toutes ces choses là égales et indifférentes: De sorte qu’il faut que la matière dont le Vaisseau est fait, ait assez de résistances en toutes ses parties pour soutenir tous ces efforts: Si sa résistance est moindre en quelqu’une, elle crève;
ſi elle eſt plus grãde, il en fournit ce qui eſt neceſſaire, & le reſte demeure inutile en cette occaſion: tellement que ſi on fait vne ouuerture nouuelle à ce Vaiſſeau, il faudra pour arreſter l'eau qui en jalliroit vne force égale à la reſiſtance que cette partie deuoit auoir, c’eſt à dire, vne force qui ſoit à celle d’vne liure, comme cette derniere ouuerture eſt à la premiere.	si elle est plus grande, il en fournit ce qui est nécessaire, et le reste demeure inutile en cette occasion: tellement que si on fait une ouverture nouvelle à ce Vaisseau, il faudra pour arrêter l’eau qui en jaillirait une force égale à la résistance que cette partie devait avoir, c’est-à-dire, une force qui soit à celle d’une livre, comme cette dernière ouverture est à la première.
Voicy encore une preuve qui ne pourra eſtre entenduë que par les ſeuls Geometres, & peut eſtre paſſée par les autres.	Voici encore une preuve qui ne pourra être entendue que par les seuls Géomètres, et peut être passée par les autres.
Ie prends pour principe, que jamais vn corps ne ſe meut par ſon poids, ſans que ſon centre de grauité deſcende. D’où je prouue que les deux Piſtõs figurez en la Figure VII. ſont en Equilibre, en cette ſorte: car leur centre de grauité cõmun, eſt au point qui diuiſe la ligne, qui joint leurs centres de grauité particuliers, en la proportion de leurs poids;	Je prends pour principe, que jamais un corps ne se meut par son poids, sans que son centre de gravité descende. D’où je prouve que les deux Pistons figurés en la Figure VII. sont en Équilibre, en cette sorte: car leur centre de gravité commun, est au point qui divise la ligne, qui joint leurs centres de gravité particuliers, en la proportion de leurs poids;
qu’ils ſe meuuent maintenant s’il eſt poſſible: donc leurs chemins ſeront entre eux comme leurs poids reciproquement, comme nous auons fait voir: or ſi on prend leur centre de grauité commun en cette ſeconde ſituation, on le trouuera preciſément au meſme endroit que la premiere fois;	qu’ils se meuvent maintenant s’il est possible: donc leurs chemins seront entre eux comme leurs poids réciproquement, comme nous avons fait voir: or si on prend leur centre de gravité commun en cette seconde situation, on le trouvera précisément au même endroit que la première fois;
car il ſe trouuera toûjours au point qui diuiſe la ligne, qui joint leurs centres de grauité particuliers, en la proportion de leurs poids;	car il se trouvera toujours au point qui divise la ligne, qui joint leurs centres de gravité particuliers, en la proportion de leurs poids;
donc à cauſe du paralleliſme des lignes de leurs chemins, il ſe trouuera en l’interſection des deux lignes qui joignẽt les centres de grauité dans les deux ſituations: donc le centre de grauité commun ſera au meſme point qu’auparauant: donc les deux Piſtons conſiderez comme vn ſeul corps, ſe ſont meus, ſans que le centre de grauité commun ſoit deſcendu: ce qui eſt contre le principe: donc ils ne peuuent ſe mouuoir: donc ils ſeront en repos, c’eſt à dire en Equilibre;	donc à cause du parallélisme des lignes de leurs chemins, il se trouvera en l’intersection des deux lignes qui joignent les centres de gravité dans les deux situations: donc le centre de gravité commun sera au même point qu’auparavant: donc les deux Pistons considérés comme un seul corps, se sont mus, sans que le centre de gravité commun soit descendu: ce qui est contre le principe: donc ils ne peuvent se mouvoir: donc ils seront en repos, c’est à dire en Équilibre;
ce qu’il falloit démontrer.	ce qu’il fallait démontrer.
I'ay démõtré par cette Methode dans vn petit Traitté de Mechanique, la raiſon de toutes les multiplications de forces qui ſe trouuent en tous les autres inſtrumens de Mechanique qu’on a juſques à preſent inuentez. Car je fais voir en tous, que les poids inégaux, qui ſe trouuent en Equilibre, par l’auantage des Machines, ſont tellement diſpoſez par la conſtruction des Machines, que leur centre de grauité commun ne ſçauroit jamais deſcendre, quelque ſituation qu’ils priſſent: D’où il s’enſuit qu’ils doiuent demeurer en repos, c’eſt à dire en Equilibre.	J’ai démontré par cette Méthode dans un petit Traité de Mécanique, la raison de toutes les multiplications de forces qui se trouvent en tous les autres instruments de Mécanique qu’on a jusqu’à présent inventés. Car je fais voir en tous, que les poids inégaux, qui se trouvent en Équilibre, par l’avantage des Machines, sont tellement disposés par la construction des Machines, que leur centre de gravité commun ne saurait jamais descendre, quelque situation qu’ils prissent: D’où il s’ensuit qu’ils doivent demeurer en repos, c’est à dire en Équilibre.
Prenons donc pour tres veritable, qu’vn Vaiſſeau plein d’eau, ayant des ouuertures, & des forces à ces ouuertures qui leur ſoient proportionnées, elles ſont en Equilibre;	Prenons donc pour très véritable, qu’un Vaisseau plein d’eau, ayant des ouvertures, et des forces à ces ouvertures qui leur soient proportionnées, elles sont en Équilibre;
& c’eſt le fondement & la raiſon de l’Equilibre des Liqueurs, dont nous allons donner pluſieurs exemples.	et c’est le fondement et la raison de l’Équilibre des Liqueurs, dont nous allons donner plusieurs exemples.
cette Machine nouuelle de Mechanique fait entendre pourquoy les Liqueurs peſent ſuiuant leur hauteur. Cette, Machine de Mechanique pour multiplier les forces, eſtant bien entenduë, fait voir la raiſon pour laquelle les Liqueurs peſent ſuiuant leur hauteur, & non pas ſuiuant leur largeur dans tous les effets que nous en auons rapportez.	cette Machine nouvelle de Mécanique fait entendre pourquoi les Liqueurs pèsent suivant leur hauteur. Cette, Machine de Mécanique pour multiplier les forces, étant bien entendue, fait voir la raison pour laquelle les Liqueurs pèsent suivant leur hauteur, et non pas suivant leur largeur dans tous les effets que nous en avons rapportés.
cette Machine nouuelle de Mechanique fait entendre pourquoy les Liqueurs peſent ſuiuant leur hauteur.	cette Machine nouvelle de Mécanique fait entendre pourquoi les Liqueurs pèsent suivant leur hauteur.
Car il eſt viſible qu’en la Figure VI. l’eau d’vn petit tuyau contrepeſe vn Piſton chargé de cent liures, parce que le Vaiſſeau du fond eſt luy meſme vn Vaiſſeau plein d’eau, ayant deux ouuertures, à l’vne deſquelles eſt le Piſton large, & à l’autre l’eau du tuyau qui eſt proprement vn Piſton peſant de luy meſme, qui doit contrepeſer l’autre, ſi leurs poids ſont entr’eux comme leurs ouuertures.	Car il est visible qu’en la Figure VI l’eau d’un petit tuyau contre-pèse un Piston chargé de cent livres, parce que le Vaisseau du fond est lui-même un Vaisseau plein d’eau, ayant deux ouvertures, à l’une desquelles est le Piston large, et à l’autre l’eau du tuyau qui est proprement un Piston pesant de lui-même, qui doit contre-peser l’autre, si leurs poids sont entre eux comme leurs ouvertures.
Auſſi en la Figure V. l’eau du tuyau menu eſt en Equilibre auec vn poids de cent liures;	Aussi en la Figure V l’eau du tuyau menu est en Équilibre avec un poids de cent livres;
parce que le Vaiſſeau du fond qui eſt large & peu haut, eſt vn Vaiſſeau clos de toutes parts, plein d’eau, ayant deux ouuertures, l’vne en bas, large, où eſt le Piſton, l’autre en haut menuë, où eſt le petit tuyau, dont l’eau eſt proprement vn Piſton peſant de luy meſme, & contrepeſant l’autre, à cauſe de la proportion des poids aux ouuertures;	parce que le Vaisseau du fond qui est large et peu haut, est un Vaisseau clos de toutes parts, plein d’eau, ayant deux ouvertures, l’une en bas, large, où est le Piston, l’autre en haut menue, où est le petit tuyau, dont l’eau est proprement un Piston pesant de lui même, et contre-pesant l’autre, à cause de la proportion des poids aux ouvertures;
car il n’importe pas ſi ces ouuertures ſont vis à vis ou non, comme il a eſté dit.	car il n’importe pas si ces ouvertures sont vis-à-vis ou non, comme il a été dit.
Où l’on voit que l’eau de ces tuyaux ne fait autre choſe, que ce que feroiẽt des Piſtons de cuiure égalemẽt peſans, puis qu'vn Piſton de cuiure peſant vne once, ſeroit auſſi bien en Equilibre auec le poids de cent liures, comme le petit filet d’eau peſant vne once: de ſorte que la cauſe de l’Equilibre d’vn petit poids auec vn plus grand, qui paroiſt en tous ces exemples, n’eſt pas en ce que ces corps qui peſent ſi peu, & qui en contrepeſent de bien plus peſans, ſont d’vne matiere liquide, car cela n'eſt pas commun à tous les exemples, puiſque ceux où de petits Piſtons de cuiure en contrepeſent de ſi peſans, montrent la meſme choſe;	Où l’on voit que l’eau de ces tuyaux ne fait autre chose, que ce que feraient des Pistons de cuivre également pesants, puisqu’un Piston de cuivre pesant une once, serait aussi bien en Équilibre avec le poids de cent livres, comme le petit filet d’eau pesant une once: de sorte que la cause de l’Équilibre d’un petit poids avec un plus grand, qui paraît en tous ces exemples, n’est pas en ce que ces corps qui pèsent si peu, et qui en contre-pèsent de bien plus pesants, sont d’une matière liquide, car cela n’est pas commun à tous les exemples, puisque ceux où de petits Pistons de cuivre en contre-pèsent de si pesants, montrent la même chose;
mais en ce que la matiere qui s’étend dans le fond des Vaiſſeaux, depuis vne ouuerture juſqu'à l'autre eſt liquide, car cela eſt commun à tous;	mais en ce que la matière qui s’étend dans le fond des Vaisseaux, depuis une ouverture jusqu’à l’autre est liquide, car cela est commun à tous;
& c’eſt la veritable cauſe de cette multiplication.	et c’est la véritable cause de cette multiplication.
Auſſi dans l’exemple de la Figure V. ſi l’eau qui eſt dans le petit tuyau ſe glaçoit, & que celle qui eſt dans le Vaiſſeau large du fond demeuraſt liquide, il faudroit cent liures pour ſoûtenir le poids de cette glace;	Aussi dans l’exemple de la Figure V si l’eau qui est dans le petit tuyau se glaçait, et que celle qui est dans le Vaisseau large du fond demeurât liquide, il faudrait cent livres pour soutenir le poids de cette glace;
mais ſi l’eau qui eſt dans le fond ſe glace, ſoit que l'autre ſe gele ou demeure liquide, il ne faut qu’vne once pour la contrepeſer.	mais si l’eau qui est dans le fond se glace, soit que l’autre se gèle ou demeure liquide, il ne faut qu’une once pour la contre-peser.
D’où il paroiſt bien clairement, que c’eſt la liquidité du corps, qui communique d’vne des ouuertures à l’autre, qui cauſe cette multiplication de forces;	D’où il paraît bien clairement, que c’est la liquidité du corps, qui communique d’une des ouvertures à l’autre, qui cause cette multiplication de forces;
parce que le fondement en eſt, comme nous auons déja dit, qu’vn Vaiſſeau plein d’eau eſt vne Machine de Mechanique pour multiplier les forces.	parce que le fondement en est, comme nous avons déjà dit, qu’un Vaisseau plein d’eau est une Machine de Mécanique pour multiplier les forces.
Paſſons aux autres effets, dont cette Machine nous découure la raiſon.	Passons aux autres effets, dont cette Machine nous découvre la raison.
Figure VIII. SI vn Vaiſſeau plein d’eau a deux ouuertures, à chacune deſquelles ſoit ſoudé vn tuyau;	Figure VIII. SI un Vaisseau plein d’eau a deux ouvertures, à chacune desquelles soit soudé un tuyau;
Figure VIII.	Figure VIII.
ſi on verſe de l’eau dans l’vn & dans l’autre à pareille hauteur, les deux ſeront en Equilibre.	si on verse de l’eau dans l’un et dans l’autre à pareille hauteur, les deux seront en Équilibre.
Car leurs hauteurs eſtant pareilles, elles ſeront en la proportion de leurs groſſeurs, c’eſt à dire de leurs ouuertures;	Car leurs hauteurs étant pareilles, elles seront en la proportion de leurs grosseurs, c’est-à-dire de leurs ouvertures;
donc ces deux eaux de ces tuyaux ſont proprement deux Piſtons peſans à proportion des ouuertures;	donc ces deux eaux de ces tuyaux sont proprement deux Pistons pesants à proportion des ouvertures;
donc ils ſeront en Equilibre par les demonſtrations precedentes. De là vient, que ſi on verſe de l’eau dãs l’vn de ces tuyaux ſeulement, elle fera remonter l’eau dans l’autre, juſques à ce qu’elle ſoit arriuée à la meſme hauteur, & lors elles demeureront en Equilibre;	donc ils seront en Équilibre par les démonstrations précédentes. De là vient, que si on verse de l’eau dans l’un de ces tuyaux seulement, elle fera remonter l’eau dans l’autre, jusqu’à ce qu’elle soit arrivée à la même hauteur, et lors elles demeureront en Équilibre;
car alors ce ſeront deux Piſtons peſans en la proportion de leurs ouuertures.	car alors ce seront deux Pistons pesants en la proportion de leurs ouvertures.
Pourquoy l'eau monte außi haut que ſa ſource. C’eſt la raiſon pour laquelle l’eau monte auſſi haut que ſa ſource.	Pourquoi l’eau monte aussi haut que sa source. C’est la raison pour laquelle l’eau monte aussi haut que sa source.
Pourquoy l'eau monte außi haut que ſa ſource.	Pourquoi l’eau monte aussi haut que sa source.
Ces ſortes d'experiences ne ſe peuuent faire qu'ẽ rempliſſant le Vaiſſeau juſques à l'embouchure des tuyaux, de la Liqueur la plus peſante. Que ſi l’on met des Liqueurs differentes dans les tuyaux, comme de l’eau dans vn, & du vif argent dans l’autre, ces deux Liqueurs ſeront en Equilibre, quand leurs hauteurs ſerõt proportionnées à leurs peſanteurs;	Ces sortes d’expériences ne se peuvent faire qu’en remplissant le Vaisseau jusqu’à l’embouchure des tuyaux, de la Liqueur la plus pesante. Que si l’on met des Liqueurs différentes dans les tuyaux, comme de l’eau dans un, et du vif-argent dans l’autre, ces deux Liqueurs seront en Équilibre, quand leurs hauteurs seront proportionnées à leurs pesanteurs;
Ces ſortes d'experiences ne ſe peuuent faire qu'ẽ rempliſſant le Vaiſſeau juſques à l'embouchure des tuyaux, de la Liqueur la plus peſante.	Ces sortes d’expériences ne se peuvent faire qu’en remplissant le Vaisseau jusqu’à l’embouchure des tuyaux, de la Liqueur la plus pesante.
c’eſt à dire quand la hauteur de l'eau ſera quatorze fois plus grande que la hauteur du vif argent, parce que le vif argent peſe de luy meſme quatorze fois plus que l’eau;	c’est-à-dire quand la hauteur de l’eau sera quatorze fois plus grande que la hauteur du vif-argent, parce que le vif-argent pèse de lui même quatorze fois plus que l’eau;
car ce ſera deux Piſtons, l’vn d’eau, l’autre de vif argent, dont les poids ſeront proportionnez aux ouuertures.	car ce sera deux Pistons, l’un d’eau, l’autre de vif-argent, dont les poids seront proportionnés aux ouvertures.
Et meſme quand le tuyau plein d’eau ſeroit cent fois plus menu que celuy ou ſeroit le vif argent, ce petit filet d’eau tiendroit en Equilibre toute cette large maſſe de vif argent, pourueu qu’il eût quatorze fois plus de hauteur.	Et même quand le tuyau plein d’eau serait cent fois plus menu que celui ou serait le vif-argent, ce petit filet d’eau tiendrait en Équilibre toute cette large masse de vif-argent, pourvu qu’il eût quatorze fois plus de hauteur.
Tout ce que nous auons dit juſques à cette heure des tuyaux, ſe doit entendre de quelque Vaiſſeau que ce ſoit, regulier ou non;	Tout ce que nous avons dit jusqu’à cette heure des tuyaux, se doit entendre de quelque Vaisseau que ce soit, régulier ou non;
car le meſme Equilibre s’y rencontre: de ſorte que ſi au lieu de ces deux tuyaux que nous auons figurez à ces deux ouuertures, on y mettoit deux Vaiſſeaux qui aboutiſſent auſſi à ces deux ouuertures;	car le même Équilibre s’y rencontre: de sorte que si au lieu de ces deux tuyaux que nous avons figurés à ces deux ouvertures, on y mettait deux Vaisseaux qui aboutissent aussi à ces deux ouvertures;
mais qui fuſſent larges en quelques endroits, eſtroits en d’autres, & enfin tous irreguliers dans toute leur eſtenduë;	mais qui fussent larges en quelques endroits, étroits en d’autres, et enfin tous irréguliers dans toute leur étendue;
en y verſant des Liqueurs à la hauteur que nous auons dit, ces Liqueurs ſeroient auſſi bien en Equilibre dans ces tuyaux irreguliers, que dans les vniformes;	en y versant des Liqueurs à la hauteur que nous avons dit, ces Liqueurs seraient aussi bien en Équilibre dans ces tuyaux irréguliers, que dans les uniformes;
parce que les Liqueurs ne peſent que ſuiuant leur hauteur, & non pas ſuiuant leur largeur.	parce que les Liqueurs ne pèsent que suivant leur hauteur, et non pas suivant leur largeur.
Et la demonſtration en ſeroit facile, en inſcriuant en l’vn & en l’autre pluſieurs petits tuyaux reguliers;	Et la démonstration en serait facile, en inscrivant en l’un et en l’autre plusieurs petits tuyaux réguliers;
car on feroit voir par ce que nous auons démontré, que deux de ces tuyaux inſcripts, qui ſe correſpondent dans les deux vaiſſeaux, ſont en Equilibre: donc tous ceux d’vn Vaiſſeau ſeroient en Equilibre auec tous ceux de l’autre. Ceux qui ſont accoûtumez aux inſcriptions & aux circonſcriptions de la Geometrie, n’auront nulle peine à entendre cela;	car on ferait voir par ce que nous avons démontré, que deux de ces tuyaux inscrits, qui se correspondent dans les deux vaisseaux, sont en Équilibre: donc tous ceux d’un Vaisseau seraient en Équilibre avec tous ceux de l’autre. Ceux qui sont accoutumés aux inscriptions et aux circonscriptions de la Géométrie, n’auront nulle peine à entendre cela;
& il ſeroit bien difficile de le démontrer aux autres au moins Geometriquement.	et il serait bien difficile de le démontrer aux autres au moins Géométriquement.
Figure IX. Si l’on met dans vne riuiere vn tuyau recourbé par le bout d’en bas, plein de vif argent, en ſorte toutefois que le bout d’en haut ſoit hors de l’eau, le vif argent tombera en partie, juſques à ce qu’il ſoit baiſſé à vne certaine hauteur, & puis il ne baiſſera plus, mais demeurera ſuſpendu en cét eſtat;	Figure IX. Si l’on met dans une rivière un tuyau recourbé par le bout d’en bas, plein de vif-argent, en sorte toutefois que le bout d’en haut soit hors de l’eau, le vif-argent tombera en partie, jusqu’à ce qu’il soit baissé à une certaine hauteur, et puis il ne baissera plus, mais demeurera suspendu en cet état;
Figure IX.	Figure IX.
en ſorte que ſa hauteur ſoit la quatorziéme partie de la hauteur de l’eau au deſſus du bout recourbé;	en sorte que sa hauteur soit la quatorzième partie de la hauteur de l’eau au-dessus du bout recourbé;
de ſorte que ſi depuis le haut de l’eau juſques au bout recourbé, il y a quatorze pieds, le vif argent tombera juſques à ce qu’il ſoit arriué à vn pied ſeulement plus haut que le bout recourbé, à laquelle hauteur il demeurera ſuſpendu;	de sorte que si depuis le haut de l’eau jusqu’au bout recourbé, il y a quatorze pieds, le vif-argent tombera jusqu’à ce qu’il soit arrivé à un pied seulement plus haut que le bout recourbé, à laquelle hauteur il demeurera suspendu;
car le poids du vif argent qui peſe au dedans, ſera en Equilibre auec le poids de l’eau qui peſe au dehors du tuyau, à cauſe que ces Liqueurs ont leurs hauteurs proportionnées à leurs poids, & que leurs largeurs ſont indifferentes dans l’Equilibre;	car le poids du vif-argent qui pèse au-dedans, sera en Équilibre avec le poids de l’eau qui pèse au-dehors du tuyau, à cause que ces Liqueurs ont leurs hauteurs proportionnées à leurs poids, et que leurs largeurs sont indifférentes dans l’Équilibre;
& il eſt auſſi indifferent par la meſme raiſon, que le bout recourbé ſoit large ou non, & qu’ainſi peu ou beaucoup d’eau y peſe.	et il est aussi indifférent par la même raison, que le bout recourbé soit large ou non, et qu’ainsi peu ou beaucoup d’eau y pèse.
Auſſi ſi on enfonce le tuyau plus auant, le vif argent remonte, car le poids de l’eau eſt plus grand;	Aussi si on enfonce le tuyau plus avant, le vif-argent remonte, car le poids de l’eau est plus grand;
& ſi on le hauſſe au contraire, le vif argent baiſſe, car ſon poids ſurpaſſe l’autre;	et si on le hausse au contraire, le vif-argent baisse, car son poids surpasse l’autre;
& ſi on panche le tuyau, le vif argent remonte, juſques à ce qu’il ſoit reuenu à la hauteur neceſſaire, qui auoit eſté diminuée en le panchant;	et si on penche le tuyau, le vif-argent remonte, jusqu’à ce qu’il soit revenu à la hauteur nécessaire, qui avait été diminuée en le penchant;
car vn tuyau panché n'a pas tant de hauteur que debout.	car un tuyau penché n’a pas tant de hauteur que debout.
Figure X. La meſme choſe arriue en vn tuyau ſimple, c’eſt à dire qui n’eſt point recourbé;	Figure X. La même chose arrive en un tuyau simple, c’est-à-dire qui n’est point recourbé;
Figure X.	Figure X.
car ce tuyau ouuert par en haut & par en bas, eſtant plein de vif argent, & enfoncé dans vne riuiere, pourueu que le bout d’en haut ſorte hors de l’eau, ſi le bout d'en bas eſt à quatorze pieds auant dans l’eau, le vif argent tombera, juſques à ce qu’il n’en reſte plus que la hauteur d’vn pied;	car ce tuyau ouvert par en haut et par en bas, étant plein de vif-argent, et enfoncé dans une rivière, pourvu que le bout d’en haut sorte hors de l’eau, si le bout d’en bas est à quatorze pieds avant dans l’eau, le vif-argent tombera, jusqu’à ce qu’il n’en reste plus que la hauteur d’un pied;
& là il demeurera ſuſpendu par le poids de l’eau: ce qui eſt aiſé à entendre;	et là il demeurera suspendu par le poids de l’eau: ce qui est aisé à entendre;
car l’eau touchant le vif argent par deſſous, & non pas par deſſus, fait effort pour le pouſſer en haut, comme pour chaſſer vn Piſton, & auec d’autant plus de force qu'elle a plus de hauteur;	car l’eau touchant le vif-argent par-dessous, et non pas par-dessus, fait effort pour le pousser en haut, comme pour chasser un Piston, et avec d’autant plus de force qu’elle a plus de hauteur;
tellement que le poids de ce vif argent ayant autant de force pour tomber, que le poids de l’eau en a pour le pouſſer en haut, tout demeure en contrepoids.	tellement que le poids de ce vif-argent ayant autant de force pour tomber, que le poids de l’eau en a pour le pousser en haut, tout demeure en contre-poids.
Auſſi ſi le vif argent n’y eſtoit pas, il eſt viſible que l’eau entreroit dans ce tuyau, & y monteroit à quatorze pieds de hauteur, qui eſt celle de ſon niueau;	Aussi si le vif-argent n’y était pas, il est visible que l’eau entrerait dans ce tuyau, et y monterait à quatorze pieds de hauteur, qui est celle de son niveau;
donc ce pied de vif argent peſant autant que ces quatorze pieds d’eau, dont il tient la place, il eſt naturel qu’il tienne l’eau dans le meſme Equilibre ou ces quatorze pieds d’eau la tiendroient.	donc ce pied de vif-argent pesant autant que ces quatorze pieds d’eau, dont il tient la place, il est naturel qu’il tienne l’eau dans le même Équilibre ou ces quatorze pieds d’eau la tiendraient.
Mais ſi on mettoit le tuyau ſi auant dans l’eau, que le bout d’en haut y entrât, alors l’eau entreroit dans le tuyau, & le vif argent tomberoit;	Mais si on mettait le tuyau si avant dans l’eau, que le bout d’en haut y entrât, alors l’eau entrerait dans le tuyau, et le vif-argent tomberait;
car l’eau peſant auſſi bien au dedans qu’au dehors du tuyau, le vif argent ſeroit ſans vn contrepoids neceſſaire pour eſtre ſoûtenu.	car l’eau pesant aussi bien au-dedans qu’au-dehors du tuyau, le vif-argent serait sans un contre-poids nécessaire pour être soutenu.
NOVS allons maintenant donner des exemples de l’Equilibre de l’eau auec des corps maſſifs, comme auec vn Cilindre de cuiure maſſif, car on le fera nager dans l’eau en cette ſorte.	NOUS allons maintenant donner des exemples de l’Équilibre de l’eau avec des corps massifs, comme avec un Cylindre de cuivre massif, car on le fera nager dans l’eau en cette sorte.
Fig. XI. Il faut auoir vn tuyau fort long, comme de vingt pieds, qui s’élargiſſe par le bout d’en bas, comme ce qu’on appelle vn entonnoir: ſi ce bout d'en bas eſt rond, & qu’on y mette vn Cilindre de cuiure, fait au tour auec tant de juſteſſe, qu’il puiſſe entrer & ſortir dans l’ouuerture de cét entonnoir, & y couler ſans que l’eau puiſſe du tout couler entre deux, & qu’il ſerue ainſi de Piſton, ce qui eſt aiſé à faire;	Fig. XI. Il faut avoir un tuyau fort long, comme de vingt pieds, qui s’élargisse par le bout d’en bas, comme ce qu’on appelle un entonnoir: si ce bout d’en bas est rond, et qu’on y mette un Cylindre de cuivre, fait au tour avec tant de justesse, qu’il puisse entrer et sortir dans l’ouverture de cet entonnoir, et y couler sans que l’eau puisse du tout couler entre deux, et qu’il serve ainsi de Piston, ce qui est aisé à faire;
Fig. XI.	Fig. XI.
on verra, qu’en mettant le Cilindre & cét entonnoir enſemble dans vne riuiere, en ſorte toutefois que le bout du tuyau ſoit hors de l’eau, ſi l’on tient le tuyau auec la main, & qu’on abandonne le Cilindre de cuiure à ce qui deura arriuer, ce Cilindre maſſif ne tõbera point, mais demeurera ſuſpendu, parce que l’eau le touche par deſſous & non par deſſus (car elle ne peut entrer dans le tuyau;) & ainſi l’eau le pouſſe en haut de la meſme ſorte qu'elle pouſſoit le vif argent dans l’exemple precedent, & auec autant de force que le poids de cuiure en a pour tomber en bas;	on verra, qu’en mettant le Cylindre et cet entonnoir ensemble dans une rivière, en sorte toutefois que le bout du tuyau soit hors de l’eau, si l’on tient le tuyau avec la main, et qu’on abandonne le Cylindre de cuivre à ce qui devra arriver, ce Cylindre massif ne tombera point, mais demeurera suspendu, parce que l’eau le touche par-dessous et non par-dessus (car elle ne peut entrer dans le tuyau;) et ainsi l’eau le pousse en haut de la même sorte qu’elle poussait le vif-argent dans l’exemple précédent, et avec autant de force que le poids de cuivre en a pour tomber en bas;
& ainſi ces efforts contraires ſe contrebalancent. Il eſt vray qu’il faut pour cét effet qu’il ſoit aſſez auant dans l’eau, pour faire qu’elle ait la hauteur neceſſaire pour contrepeſer le cuiure: de ſorte que ſi ce Cilindre a vn pied de haut, il faut que depuis le haut de l’eau juſques au bas du Cilindre, il y ait neuf pieds, à cauſe que le cuiure peſe de luy meſme neuf fois autant que l’eau;	et ainsi ces efforts contraires se contrebalancent. Il est vrai qu’il faut pour cet effet qu’il soit assez avant dans l’eau, pour faire qu’elle ait la hauteur nécessaire pour contre-peser le cuivre: de sorte que si ce Cylindre a un pied de haut, il faut que depuis le haut de l’eau jusqu’au bas du Cylindre, il y ait neuf pieds, à cause que le cuivre pèse de lui même neuf fois autant que l’eau;
auſſi ſi l’eau n’a pas aſſez de hauteur, comme ſi on retire le tuyau plus vers le haut de l’eau, ſon poids l’emporte, & il tombe, mais ſi on l'enfonce encore plus auant qu’il ne faut, comme à vingt pieds;	aussi si l’eau n’a pas assez de hauteur, comme si on retire le tuyau plus vers le haut de l’eau, son poids l’emporte, et il tombe, mais si on l’enfonce encore plus avant qu’il ne faut, comme à vingt pieds;
tant s’en faut qu’il puiſſe tomber par ſon poids, qu’au contraire il faudroit employer vne grande force pour le ſeparer & l’arracher d’auec l’entonnoir, car le poids de l’eau le pouſſe en haut auec la force de vingt pieds de haut. Mais ſi on perce le tuyau, & que l’eau y entre, & peſe auſſi bien ſur le Cilindre comme par deſſous, lors le Cilindre tombera par ſon poids, comme le vif argent dans l’autre exemple, parce qu’il n’a plus le contrepois qu’il faut pour le ſoûtenir.	tant s’en faut qu’il puisse tomber par son poids, qu’au contraire il faudrait employer une grande force pour le séparer et l’arracher d’avec l’entonnoir, car le poids de l’eau le pousse en haut avec la force de vingt pieds de haut. Mais si on perce le tuyau, et que l’eau y entre, et pèse aussi bien sur le Cylindre comme par dessous, lors le Cylindre tombera par son poids, comme le vif argent dans l’autre exemple, parce qu’il n’a plus le contre-poids qu’il faut pour le soutenir.
Fig. XII. Si ce tuyau tel que nous le venons de figurer eſt recourbé, & qu’on y mette vn Cilindre de bois, & le tout dans l’eau, en ſorte neanmoins que le bout d’en haut ſorte de l’eau;	Fig. XII. Si ce tuyau tel que nous le venons de figurer est recourbé, et qu’on y mette un Cylindre de bois, et le tout dans l’eau, en sorte néanmoins que le bout d’en haut sorte de l’eau;
Fig. XII.	Fig. XII.
le bois ne remontera pas, quoy que l’eau l’enuironne;	le bois ne remontera pas, quoique l’eau l’environne;
mais au contraire il s’enfoncera dans le tuyau, à cauſe qu’elle le touche par deſſus & non pas par deſſous, car elle ne peut entrer dans le tuyau;	mais au contraire il s’enfoncera dans le tuyau, à cause qu’elle le touche par-dessus et non pas par-dessous, car elle ne peut entrer dans le tuyau;
& ainſi elle le pouſſe en bas par tout ſon poids, & point du tout en haut, car elle ne le touche pas par deſſous.	et ainsi elle le pousse en bas par tout son poids, et point du tout en haut, car elle ne le touche pas par-dessous.
Figure XIII. Que ſi ce Cilindre eſtoit à fleur d’eau, c’eſt à dire qu’il fût enfoncé ſeulement, en ſorte que l’eau ne fût pas au deſſus de luy, mais auſſi qu’il n’eût riẽ hors de l’eau;	Figure XIII. Que si ce Cylindre était à fleur d’eau, c’est-à-dire qu’il fût enfoncé seulement, en sorte que l’eau ne fût pas au-dessus de lui, mais aussi qu’il n’eût rien hors de l’eau;
Figure XIII.	Figure XIII.
lors il ne ſeroit pouſſé ny en haut ny en bas par le poids de l’eau, car elle ne le touche ny par deſſus ny par deſſous, puis qu’elle ne peut entrer dans le tuyau;	lors il ne serait poussé ni en haut ni en bas par le poids de l’eau, car elle ne le touche ni par-dessus ni par-dessous, puisqu’elle ne peut entrer dans le tuyau;
& elle le touche ſeulement par tous ſes coſtez: ainſi il ne remonteroit pas, car rien ne l’éleue, & il tomberoit au contraire, mais par ſon propre poids ſeulement.	et elle le touche seulement par tous ses côtés: ainsi il ne remonterait pas, car rien ne l’élève, et il tomberait au contraire, mais par son propre poids seulement.
Que ſi le bout d’en bas du tuyau eſtoit tourné de coſté, comme vne croſſe, & qu’on y mît vn Cilindre, & le tout dans l’eau, en ſorte toûjours que le bout d’en haut ſorte hors de l’eau, le poids de l’eau le pouſſera de coſté au dedans du tuyau, parce qu'elle ne le touche pas du coſté qui luy eſt oppoſé, & elle agira de cette ſorte auec d’autant plus de force, qu'elle aura plus de hauteur.	Que si le bout d’en bas du tuyau était tourné de côté, comme une crosse, et qu’on y mît un Cylindre, et le tout dans l’eau, en sorte toujours que le bout d’en haut sorte hors de l’eau, le poids de l’eau le poussera de côté au-dedans du tuyau, parce qu’elle ne le touche pas du côté qui lui est opposé, et elle agira de cette sorte avec d’autant plus de force, qu’elle aura plus de hauteur.
Figure XV. NOVS voyons par là que l'eau pouſſe en haut les corps qu’elle touche par deſſous;	Figure XV. NOUS voyons par là que l’eau pousse en haut les corps qu’elle touche par dessous;
Figure XV.	Figure XV.
qu'elle pouſſe en bas ceux qu’elle touche par deſſus;	qu’elle pousse en bas ceux qu’elle touche par dessus;
& qu'elle pouſſe de coſté ceux qu'elle touche par le coſté oppoſé: d’où il eſt aiſé de conclure, que quand vn corps eſt tout dans l’eau, comme l’eau le touche par deſſus, par deſſous, & par tous les coſtez, elle fait effort pour le pouſſer en haut, en bas, & vers tous les coſtés: mais comme ſa hauteur eſt la meſure de la force qu'elle a dans toutes ces impreſſions on verra bien aiſément lequel de tous ces efforts doit preualoir.	et qu’elle pousse de côté ceux qu’elle touche par le côté opposé: d’où il est aisé de conclure, que quand un corps est tout dans l’eau, comme l’eau le touche par-dessus, par-dessous, et par tous les côtés, elle fait effort pour le pousser en haut, en bas, et vers tous les côtés: mais comme sa hauteur est la mesure de la force qu’elle a dans toutes ces impressions on verra bien aisément lequel de tous ces efforts doit prévaloir.
Car il paroiſt d’abord que comme elle a vne pareille hauteur ſur toutes les faces des coſtés, elle les pouſſera également;	Car il paraît d’abord que comme elle a une pareille hauteur sur toutes les faces des côtés, elle les poussera également;
& partant ce corps ne receura aucune impreſſion vers aucun coſté, non plus qu’vne giroüette entre deux vents égaux. Mais comme l’eau a plus de hauteur ſur la face d’en bas que ſur celle d’en haut, il eſt viſible qu’elle le pouſſera plus en haut qu'en bas;	et partant ce corps ne recevra aucune impression vers aucun côté, non plus qu’une girouette entre deux vents égaux. Mais comme l’eau a plus de hauteur sur la face d’en bas que sur celle d’en haut, il est visible qu’elle le poussera plus en haut qu’en bas;
& comme la difference de ces hauteurs de l’eau eſt la hauteur du corps meſme, il eſt aiſé d’entendre que l’eau le pouſſe plus en haut qu’en bas, auec vne force égale au poids d’vn volume d’eau pareil à ce corps.	et comme la différence de ces hauteurs de l’eau est la hauteur du corps même, il est aisé d’entendre que l’eau le pousse plus en haut qu’en bas, avec une force égale au poids d’un volume d’eau pareil à ce corps.
Un corps dans l'eau eſt contrepeſé par un volume d'eau pareil. De ſorte qu'vn corps qui eſt dans l’eau y eſt porté de la meſme ſorte, que s’il eſtoit dans vn baſſin de balance, dont l’autre fût chargé d’vn volume d’eau égal au ſien.	Un corps dans l’eau est contre-pesé par un volume d’eau pareil. De sorte qu’un corps qui est dans l’eau y est porté de la même sorte, que s’il était dans un bassin de balance, dont l’autre fût chargé d’un volume d’eau égal au sien.
Un corps dans l'eau eſt contrepeſé par un volume d'eau pareil.	Un corps dans l’eau est contre-pesé par un volume d’eau pareil.
De là vient que quelques corps y tombent. D’où il paroiſt que s’il eſt de cuiure ou d’vne autre matiere qui peſe plus que l’eau en pareil volume, il tombe;	De là vient que quelques corps y tombent. D’où il paraît que s’il est de cuivre ou d’une autre matière qui pèse plus que l’eau en pareil volume, il tombe;
De là vient que quelques corps y tombent.	De là vient que quelques corps y tombent.
car ſon poids l’emporte ſur celuy qui le contrebalance.	car son poids l’emporte sur celui qui le contrebalance.
D'autres y montent. S’il eſt de bois ou d’vne autre matiere plus legere que l’eau en pareil volume, il monte auec toute la force dont le poids de l’eau le ſurpaſſe.	D’autres y montent. S’il est de bois ou d’une autre matière plus légère que l’eau en pareil volume, il monte avec toute la force dont le poids de l’eau le surpasse.
D'autres y montent.	D’autres y montent.
D'autres n’y montent ny ne deſcendent. Et s’il peſe également, il ne deſcend ny ne monte;	D’autres n’y montent ni ne descendent. Et s’il pèse également, il ne descend ni ne monte;
D'autres n’y montent ny ne d'eſcendent.	D’autres n’y montent ni ne descendent.
comme la cire qui ſe tient à peu prés dans l’eau au lieu où on l’a met.	comme la cire qui se tient à peu près dans l’eau au lieu où on l’a met.
De là vient que le ſeau d’vn puis n’eſt pas difficile à hauſſer tant qu’il eſt dans l’eau, & qu’on ne ſent ſon poids que quand il commence à en ſortir, de meſme qu’vn ſeau plein de cire ne ſeroit non plus difficile à hauſſer eſtant dans l’eau: Ce n'eſt pas que l’eau auſſi bien que la cire, ne peſent autant dans l’eau que dehors;	De là vient que le seau d’un puits n’est pas difficile à hausser tant qu’il est dans l’eau, et qu’on ne sent son poids que quand il commence à en sortir, de même qu’un seau plein de cire ne serait non plus difficile à hausser étant dans l’eau: Ce n’est pas que l’eau aussi bien que la cire, ne pèsent autant dans l’eau que dehors;
mais c’eſt qu’eſtant dans l’eau, ils ont vn contrepoids qu’ils n’ont plus quand ils en ſont tirés;	mais c’est qu’étant dans l’eau, ils ont un contrepoids qu’ils n’ont plus quand ils en sont tirés;
de meſme qu’vn baſſin de balance chargé de cent liures n’eſt pas difficile à hauſſer, ſi l’autre l’eſt également.	de même qu’un bassin de balance chargé de cent livres n’est pas difficile à hausser, si l’autre l’est également.
Du cuiure peſe plus en l'air que dãs l'eau. De là vient que quand du cuiure eſt dans l’eau, on le ſent moins peſant preciſément du poids d’vn volume d’eau égal au ſien;	Du cuivre pèse plus en l’air que dans l’eau. De là vient que quand du cuivre est dans l’eau, on le sent moins pesant précisément du poids d’un volume d’eau égal au sien;
Du cuiure peſe plus en l'air que dãs l'eau.	Du cuivre pèse plus en l’air que dans l’eau.
de ſorte que s’il peſe neuf liures en l’air, il ne peſe plus que huit liures dans l’eau;	de sorte que s’il pèse neuf livres en l’air, il ne pèse plus que huit livres dans l’eau;
parce que l’eau en pareil volume qui le contrebalance peſe vne liure: & dans l’eau de la mer il peſe moins;	parce que l’eau en pareil volume qui le contrebalance pèse une livre: et dans l’eau de la mer il pèse moins;
parce que l’eau de la mer peſe plus, à peu prés d’vne quarante-cinquieſme partie.	parce que l’eau de la mer pèse plus, à peu près d’une quarante-cinquième partie.
Deux corps eſtant en Equilibre en l'air, ne le ſont point dans l'eau. Par la meſme raiſon deux corps, l’vn de cuiure, l’autre de plomb, eſtant également peſants, & par conſequent de different volume, puis qu’il faut plus de cuiure pour faire la meſme peſanteur;	Deux corps étant en Équilibre en l’air, ne le sont point dans l’eau. Par la même raison deux corps, l’un de cuivre, l’autre de plomb, étant également pesants, et par conséquent de différents volume, puisqu’il faut plus de cuivre pour faire la même pesanteur;
Deux corps eſtant en Equilibre en l'air, ne le ſont point dans l'eau.	Deux corps étant en Équilibre en l’air, ne le sont point dans l’eau.
on les trouuera en Equilibre, en les mettant chacun dans vn baſſin de balance: mais ſi on met cette balance dans l’eau, ils ne ſont plus en Equilibre;	on les trouvera en Équilibre, en les mettant chacun dans un bassin de balance: mais si on met cette balance dans l’eau, ils ne sont plus en Équilibre;
car chacun eſtant contrepeſé par vn volume d’eau égal au ſien, le volume de cuiure eſtant plus grand que celuy de plomb, il a vn plus grand contrepoids;	car chacun étant contre-pesé par un volume d’eau égal au sien, le volume de cuivre étant plus grand que celui de plomb, il a un plus grand contrepoids;
& partant le poids du plomb eſt le maiſtre.	et partant le poids du plomb est le maître.
Ny meſmes dans l’air humide. Ainſi deux poids de differente matiere eſtant ajuſtez dans vn parfait Equilibre, de la derniere juſteſſe où les hommes peuuent arriuer;	Ni mêmes dans l’air humide. Ainsi deux poids de différente matière étant ajustés dans un parfait Équilibre, de la dernière justesse où les hommes peuvent arriver;
Ny meſmes dans l’air humide.	Ni même dans l’air humide.
s’ils ſont en Equilibre, quand l’air eſt fort ſec, ils ne le ſont plus quand l’air eſt humide.	s’ils sont en Équilibre, quand l’air est fort sec, ils ne le sont plus quand l’air est humide.
L'eau pouſſe tous les corps qui y ſont en haut par ſon poids, & non pas enbas. C’eſt par le meſme principe, que quand vn homme eſt dans l’eau, tant s’en faut que le poids de l’eau le pouſſe en bas, qu’au contraire elle le pouſſe en haut;	L’eau pousse tous les corps qui y sont en haut par son poids, et non pas en bas. C’est par le même principe, que quand un homme est dans l’eau, tant s’en faut que le poids de l’eau le pousse en bas, qu’au contraire elle le pousse en haut;
L'eau pouſſe tous les corps qui y ſont en haut par ſon poids, & non pas enbas.	L’eau pousse tous les corps qui y sont en haut par son poids, et non pas en bas.
mais il peſe plus qu'elle;	mais il pèse plus qu’elle;
& c’eſt pourquoy il ne laiſſe pas de tomber, mais auec bien moins de violence qu'en l’air: parce qu’il eſt contrepeſé par vn volume d’eau pareil au ſien, qui peſe preſque autant que luy;	et c’est pourquoi il ne laisse pas de tomber, mais avec bien moins de violence qu’en l’air: parce qu’il est contre-pesé par un volume d’eau pareil au sien, qui pèse presque autant que lui;
& s’il peſoit autant il nageroit. Auſſi en donnant vn coup à terre, ou faiſant le moindre effort contre l’eau, il s’éleue & nage: & dans les bains d’eau bourbeuſe, vn homme ne ſçauroit enfoncer;	et s’il pesait autant il nagerait. Aussi en donnant un coup à terre, ou faisant le moindre effort contre l’eau, il s’élève et nage: et dans les bains d’eau bourbeuse, un homme ne saurait enfoncer;
& ſi on l'enfonce, il remonte de luy meſme.	et si on l’enfonce, il remonte de lui-même.
Par la meſme cauſe, quand on ſe baigne dans vne cuue, on n’a point de peine à hauſſer le bras, tant qu’il eſt dans l’eau;	Par la même cause, quand on se baigne dans une cuve, on n’a point de peine à hausser le bras, tant qu’il est dans l’eau;
mais quand on le ſort de l’eau, on ſent qu’il peſe beaucoup;	mais quand on le sort de l’eau, on sent qu’il pèse beaucoup;
à cauſe qu’il n’a plus le contrepoids d’vn volume d’eau pareil au ſien, qu’il auoit eſtant dans l’eau.	à cause qu’il n’a plus le contrepoids d’un volume d’eau pareil au sien, qu’il avait étant dans l’eau.
Comment les corps nagent. Enfin, les corps qui nagent ſur l’eau, peſent preciſément autant que l’eau dont ils occupent la place;	Comment les corps nagent. Enfin, les corps qui nagent sur l’eau, pèsent précisément autant que l’eau dont ils occupent la place;
Comment les corps nagent.	Comment les corps nagent.
car l’eau les touchant par deſſous, & non pas par deſſus, les pouſſe ſeulement en haut.	car l’eau les touchant par dessous, et non pas par dessus, les pousse seulement en haut.
Et c’eſt pourquoy vne platine de plomb eſtant miſe en figure conuexe, elle nage;	Et c’est pourquoi une platine de plomb étant mise en figure convexe, elle nage;
parce qu’elle occupe vne grande place dans l’eau par cette figure;	parce qu’elle occupe une grande place dans l’eau par cette figure;
au lieu que ſi elle eſtoit maſſiue, elle n’occuperoit jamais dans l’eau que la place d’vn volume d’eau égal au volume de ſa matiere, qui ne ſuffiroit pas pour la contrepeſer.	au lieu que si elle était massive, elle n’occuperait jamais dans l’eau que la place d’un volume d’eau égal au volume de sa matière, qui ne suffirait pas pour la contre-peser.
ON voit par tout ce que j’ay montré, de quelle ſorte l’eau agit contre tous les corps qui y ſont, en les preſſant par tous les coſtez;	ON voit par tout ce que j’ai montré, de quelle sorte l’eau agit contre tous les corps qui y sont, en les pressant par tous les côtés;
d’où il eſt aiſé à juger, que ſi vn corps compreſſible y eſt enfoncé, elle doit le comprimer en dedans vers le centre;	d’où il est aisé à juger, que si un corps compressible y est enfoncé, elle doit le comprimer en dedans vers le centre;
& c’eſt auſſi ce qu’elle fait, comme on va voir dans les exemples ſuiuans.	et c’est aussi ce qu’elle fait, comme on va voir dans les exemples suivants.
Figure XIV. Si vn ſoufflet qui a le tuyau fort long, comme de vingt pieds, eſt dans l’eau, en ſorte que le bout du fer ſorte hors de l’eau;	Figure XIV. Si un soufflet qui a le tuyau fort long, comme de vingt pieds, est dans l’eau, en sorte que le bout du fer sorte hors de l’eau;
Figure XIV.	Figure XIV.
il ſera difficile à ouurir ſi on a bouché les petits trous qui ſont à l’vne des ailes;	il sera difficile à ouvrir si on a bouché les petits trous qui sont à l’une des ailes;
au lieu qu’on l’ouuriroit ſans peine, s’il eſtoit en l’air;	au lieu qu’on l’ouvrirait sans peine, s’il était en l’air;
à cauſe que l’eau le comprime	à cause que l’eau le comprime
