POVRQVOY tant balancer, quand pour vous tout conſpire?	POURQUOI tant balancer, quand pour vous tout conspire?
Vous devez vous ſaiſir des reſnes de l’Empire,	Vous devez vous saisir des rênes de l’Empire,
Babylone eſt pour vous; Aléxandre en mourant,	Babylone est pour vous; Alexandre en mourant,
Vous a donné du Trône un illuſtre Garant,	Vous a donné du trône un illustre Garant,
Seigneur, & ſur vous ſeul remetant ſa Couronne,	Seigneur, et sur vous seul remettant sa Couronne,
C’eſt avec ſon Anneau l'Univers qu’il vous donne.	C’est avec son anneau l’Univers qu’il vous donne.
Ce jour doit décider de tant de diférens,	Ce jour doit décider de tant de différends,
La Terre veut un Maiſtre, & non pas des Tyrans.	La Terre veut un maître, et non pas des tyrans.
Le fier Leonatus, Cratere, & Ptolomée,	Le fier Léonatus, Cratère, Ptolomée,
Ont mis dans leur party la moitié de l'Armée,	Ont mis dans leur parti la moitié de l’Armée,
On veut nous aſſieger, mais on voit Seleucus,	On veut nous assiéger, mais on voit Seleucus,
Eumenes, Alcetas, Python, Antigonus,	Eumenes, Alcetas, Python, Antigonus,
Qui ſoûtenant le droit où voſtre eſpoir ſe fonde,	Qui soutenant le droit où votre espoir se fonde,
Veulent vous élever à l'Empire du Monde;	Veulent vous élever à l’Empire du Monde;
L’imbécille Philipe eſt-il né pour régner?	L’imbécile Philipe est-il né pour régner?
Les Macédoniens ont ſçeu le dédaigner.	Les Macédoniens ont su le dédaigner.
Bien que Fils de Philipe & Frere d'Aléxandre,	Bien que fils de Philipe et Frère d’Alexandre,
Eſt-il digne du ſang dont on l’a veu deſcendre?	Est-il digne du sang dont on l’a vu descendre?
Peut-il ſeul commander à cent Peuples vaincus,	Peut-il seul commander à cent Peuples vaincus,
Et Frere d'Aléxandre en a t-il les vertus?	Et Frère d’Alexandre en a-t-il les vertus?
Ce n’eſt point luy qu’au Trône Aléxandre déſigne,	Ce n’est point lui qu’au trône Alexandre désigne,
Ce Monarque en mourant le remet au plus digne,	Ce Monarque en mourant le remet au plus digne,
Par là ſans vous nommer il vous nomme en effet,	Par là sans vous nommer il vous nomme en effet,
Et ſcelle de ſa main le don qu'il vous en fait.	Et scelle de sa main le don qu’il vous en fait.
Je ſçais trop d’Aléxandre honorer la mémoire,	Je sais trop d’Alexandre honorer la mémoire,
Seigneur, pour me flater de tant de vaine gloire;	Seigneur, pour me flatter de tant de vaine gloire;
Il eſt vray que ſon choix ſemble tomber ſur moy,	Il est vrai que son choix semble tomber sur moi,
Mais apres ce Héros peut-on élire un Roy?	Mais après ce Héros peut-on élire un Roi?
Quand la Terre a perdu ſon Vainqueur & ſon Maître,	Quand la Terre a perdu son vainqueur et son Naître,
Eſt-il un Sueceſſeur qu'elle puiſſe connoître?	Est-il un Successeur qu’elle puisse connaître?
Le préſent qu'il m’a fait n'a point dû m'ébloüir,	Le présent qu’il m’a fait n’a point dû m’éblouir,
Il peut eſtre fatal à qui veut en joüir;	Il peut être fatal à qui veut en jouir;
Quand de la Macédoine Alexandre eut l’élite,	Quand de la Macédoine Alexandre eut l’élite,
Il avoit moins de Chefs que de Roys à ſa ſuite,	Il avait moins de Chefs que de Rois à sa suite,
Et ce Héros vainqueur des Medes, des Perſans,	Et ce Héros vainqueur des Mèdes, des Persans,
Ne nommoit plus de Roys que par ſes Lieutenans.	Ne nommait plus de Rois que par ses Lieutenants.
Je n’ay donc point voulu me parer d’un vain Titre,	Je n’ai donc point voulu me parer d’un vain Titre,
De tous ſes Succeſſeurs je veux eſtre l’Arbitre,	De tous ses successeurs je veux être l’Arbitre,
J’en ay fait nommer un pour le faire haïr,	J’en ai fait nommer un pour le faire haïr,
Et n’ay choiſy qu’un Roy qui me ſçeut obeïr.	Et n’ai choisis qu’un Roi qui me sut obéir.
Ce n’eſt donc point ce nom ou mon cœur doit prétendre,	Ce n’est donc point ce nom où mon cœur doit prétendre,
Seigneur, nous adorons les Veuves d’Aléxandre,	Seigneur, nous adorons les Veuves d’Alexandre,
Pourquoy le taire encor? pourquoy diſſmuler?	Pourquoi le taire encore? pourquoi dissimuler?
Caſſander, il eſt temps d'agir & de parler;	Cassandre, il est temps d’agir et de parler;
J’adore Statira, vous adorez Roxane,	J’adore Statira, vous adorez Roxane,
Et vous aimez en vain cette fiere Perſane,	Et vous aimez en vain cette fière persane,
J’aime en vain Statira,mais il faut découvrir	J’aime en vain Statira, mais il faut découvrir
Nos Rivaux trop heureux, & les faire périr;	Nos Rivaux trop heureux, et les faire périr;
II faur que noſtre adreſſe à nos forces réponde,	Il faut que notre adresse à nos forces réponde,
Maiſtres de Babylone, il faut l’eſtre du Monde;	Maîtres de Babylone, il faut l’être du Monde;
En vain Leonatus prétend nous aſſieger,	En vain Léonatus prétend nous assiéger,
Nous ſçauronsle combatre, & meſme nous vanger;	Nous saurons le combattre, et même nous venger;
Pour gouverner l'Empire où nous devons prétendre,	Pour gouverner l’Empire où nous devons prétendre,
Il faut nous aſſurer des Veuves d’Aléxandre,	Il faut nous assurer des Veuves d’Alexandre,
Et fondez ſur des droits juſtes & ſouverains,	Et fonder sur des droits justes et souverains,
Partager ſon Empire & celuy des Humains.	Partager son Empire et celui des Humains.
Ce procedé, Seigneur, me paroît trop ſincere,	Ce procédé, Seigneur, me paraît trop sincère,
Pour cacher plus longtemps ce que j’ay voulu taire?	Pour cacher plus longtemps ce que j’ai voulu taire?
Oüy, j’adore Roxane, & ſon cœur orgueilleux	Oui, j’adore Roxane, et son cœur orgueilleux
Dédaigne mes ſoûpirs, & rejete mes vœux;	Dédaigne mes soupirs, et rejette mes vœux;
Fiere d’avoir un Fils auſſi-bien que Barſine,	Fière d’avoir un fils aussi bien que Barsine,
Roxane à l’Univers pour Maiſtre le deſtine,	Roxane à l’Univers pour Maître le destine,
Sans ſonger que ce Fils né d’un ſang ennemy,	Sans songer que ce fils né d’un sang ennemi,
Le Fils d’une Perſane eſt Eſclave à demy,	Le fils d’une Persane est esclave à demi,
Et que la Macédoine a des Peuples trop braves	Et que la Macédoine a des Peuples trop braves
Pour ſe faire des Roys du ſang de leurs Eſclaves;	Pour se faire des Rois du sang de leurs Esclaves;
Mais puis que nous voyons ces Trônes, ces Etats,	Mais puisque nous voyons ces Trônes, ces États,
Payez de noſtre ſang, & conquis par nos bras,	Payer de notre sang, et conquis par nos bras,
Nous pouvons entre nous les partager ſans crime,	Nous pouvons entre nous les partager sans crime,
Puis qu’il n’a point laiſſé d’Heritier légitime,	Puisqu’il n’a point laissé d’héritier légitime,
Les armes à la main, nous ferons voir à tous	Les armes à la main, nous ferons voir à tous
Qu'Aléxandre n’a point de Succeſſeurs que nous.	Qu’Alexandre n’a point de Successeurs que nous.
Nos deſſeins ſont pareils ainſi que nos tendreſſes,	Nos desseins sont pareils ainsi que nos tendresses,
Mais, Seigneur, il s’agit du cœur des deux Princeſſes,	Mais, Seigneur, il s’agit du cœur des deux Princesses,
Nous aimons l'un & l'autre, & peut-eſtre tous deux	Nous aimons l’un et l’autre, et peut-être tous deux
Nous aurons meſme fort pour de ſemblables feux;	Nous aurons même sort pour de semblables feux;
J'ay ſauvé Statira des fureurs de Roxane	J’ai sauvé Statira des fureurs de Roxane
En bute aux cruautez de la fiere Perſane,	En butte aux cruautés de la fière Persane,
Cette illuſtre Princeſſe auroit perdu le jour	Cette illustre Princesse aurait perdu le jour
Sans les ſoins empreſſez qu’elle doit à l’amour;	Sans les soins empressés qu’elle doit à l’amour;
Nous devons penétrer quelle jàlouſe envie	Nous devons pénétrer quelle jalouse envie
L'a fait inceſſamment armer contre ſa vie,	L’a fait incessamment armer contre sa vie,
Peut-eſtre qu’un Rival aimé de toutes deux	Peut-être qu’un Rival aimé de toutes deux
Leur a fait rejeter nos ſervices, nos vœux;	Leur a fait rejeter nos services, nos vœux;
Starira malgré moy veut ſuivre Ptolomée,	Statira malgré moi veut suivre Ptolomée,
Peut-eſtre ce Rival eſt-il dans ſon Armée?	Peut-être ce Rival est-il dans son Armée?
Leonatus peut-eſtre, ah! Seigneur, j'en frémis....	Léonatus peut-être, ah! Seigneur, j’en frémis…
Oüy, c'eſt le plus mortel de tous vos Ennemis,	Oui, c’est le plus mortel de tous vos Ennemis,
Leonatus, Seigneur, dans le party contraire	Léonatus, Seigneur, dans le parti contraire
Sans-doute eſt ce Rival que leur cœur nous préfere?	Sans doute est-ce Rival que leur cœur nous préfère?
Je ſçais trop, à ſon nom , & mes yeux me l'ont dit,	Je sais trop, à son nom, et mes yeux me l’ont dit,
Que Statira ſoûpire, & Roxane rougit;	Que Statira soupire, et Roxane rougit;
C’eſt aſſez pour tirer de fortes conjectures,	C’est assez pour tirer de fortes conjectures,
Penétrons leurs deſſeins pour prendre nos meſures,	Pénétrons leurs desseins pour prendre nos mesures,
Il faut a profondir ce miſtere en ce jour,	Il faut approfondir ce mystère en ce jour,
Icy la politique eſt unie à l’Amour.	Ici la Politique est unie à l’Amour.
Roxane vient, parlez, l'occaſion eſt belle,	Roxane vient, parlez, l’occasion est belle,
Seigneur, je me retire, & vous laiſſe avecque elle.	Seigneur, je me retire, et vous laisse avec elle.
NOus ſommes invertis, déja Leonatus	NOus sommes investis, déjà Léonatus
Nous menace & nous compte au nõbre des Vaincus;	Nous menace et nous compte au nombre des Vaincus;
Mais avant que ſon Bras oſe rien entreprendre,	Mais avant que son Bras ose rien entreprendre,
Il demande à nous voir, Seigneur, il faut l'entendre,	Il demande à nous voir, Seigneur, il faut l’entendre,
Il m'a fait demander un Oſtage, & je viens	Il m’a fait demander un otage, et je viens
D'envoyer Alcetas ſuivy de deux des miens,	D’envoyer Alcetas suivi de deux des miens,
Dans peu nous le verrons....	Dans peu nous le verrons…
Hé! que voulez-vous faire?	Hé! que voulez-vous faire?
Recevoir dans nos murs un mortel Adverſaire?	Recevoir dans nos murs un mortel Adversaire?
Vient-il nous menacer? & quel eſt ſon deſſein?	Vient-il nous menacer? et quel est son dessein?
Laiſſez-nous luy parler les armes à la main,	Laissez-nous lui parler les armes à la main,
Et Perdiccas & moy, Madame...	Et Perdiccas et moi, Madame…
Il faut l’entendre,	Il faut l’entendre,
Ce Prince redoutable eſt du ſang d’Alexandre,	Ce Prince redoutable est du sang d’Alexandre;
On doit le reſpecter. Peut-eſtre en ce moment	On doit le respecter. Peut-être en ce moment
Vient-il nous propoſer quelque accomodement.	Vient-il nous proposer quelque accommodement.
Seigneur, j'ay mes deſſeins....	Seigneur, j’ai mes desseins…
Et nous avons les noſtres,	Et nous avons les nôtres,
Que nous ſçaurons régler, Madame, ſur les voſtres.	Que nous saurons régler, Madame, sur les vôtres.
Alexandre n’eſt plus: Dans ce débris commun	Alexandre n’est plus: dans ce débris commun
Il laiſſe à l'Univers vingt Maiſtres au lieu d’un;	Il laisse à l’Univers vingt maîtres au lieu d’un;
Vous en avez un Fils, vous luy devez un Trône,	Vous en avez un fils, vous lui devez un Trône,
Madame, çhoiſiſſez la Perſe & Babylone,	Madame, choisissez la Perse et Babylone,
Le Pont, la Macédoine, ou tant d'autres Païs	Le Pont, la Macédoine, et tant d’autres Pays
Où nous pourions dans peu couronner voſtre fils;	Où nous pourrions dans peu couronner votre fils;
Mais il faut à ce Fils un Tuteur qui ſoûtienne	Mais il faut à ce fils un Tuteur qui soutienne
Toute voſtre grandeur unie avec la ſienne.	Toute votre grandeur unie avec la sienne.
Voyez, examinez, s'il n’eſt point parmy nous	Voyez, examinez, s’il n’est point parmi nous
De Prince, ou de Héros qui ſoit digne de vous.	De Prince, ou de Héros qui soit digne de vous.
Ne pouvez-vous choiſir?	Ne pouvez-vous choisir?
Hé qui pouroit prétendre	Hé qui pourrait prétendre
A remplir dans mon cœur la place d'Aléxandre?	À remplir dans mon cœur la place d’Alexandre?
Pourois-je m’abaiſſer à ſouffrir qu’en ce lieu	Pourrais-je m’abaisser à souffrir qu’en ce lieu
Un Mortel uſurpaſt le rang d'un Demy-Dieu?	Un Mortel usurpât le rang d’un Demi-Dieu?
Hé! Madame, les Dieux que ce diſcours offence,	Hé! Madame, les Dieux, que ce discours offense,
Par ces raiſons peut-eſtre ont haſté leur vangeance,	Par ces raisons peut-être ont hâté leur vengeance,
Irritez qu’un Mortel juſques ſur leurs Autels	Irrités qu’un Mortel jusques sur leurs Autels
S'oſaſt placer vivant au rang des Immortels;	S’osât placer vivant au rang des Immortels;
Leur juſtice a fait voir que ce grand Alexandre,	Leur justice a fait voir que ce grand Alexandre,
Ce Fils de Jupiter, n’eſtoit qu’un peu de cendre,	Ce Fils de Jupiter, n’était qu’un peu de cendre,
Pardonnez un diſcours qui ſemble injurieux;	Pardonnez un discours qui semble injurieux;
Mais icy Caſſander prend la cauſe des Dieux.	Mais ici Cassandre prend la cause des Dieux.
Ne l’avons-nous pas veu par ce nouveau caprice	Ne l’avons-nous pas vu par ce nouveau caprice
Ayant de ſon orgueil la Fortune complice,	Ayant de son orgueil la Fortune complice,
Rougir de paroiſtre Homme, & pour le démentir,	Rougir de paraître homme, et pour le démentir,
Deſavoüer le ſang dont on l'a veu ſortir?	Désavouer le sang dont on l’a vu sortir?
Et ſans-doute qu’un jour ce Vainqueur teméraire	Et sans doute qu’un jour ce vainqueur téméraire
Auroit de ſavoüé Jupiter pour ſon Pere,	Aurait désavoué Jupiter pour son père,
Si ſon ambition avoit pû le fiater	Si son ambition avait pu le flatter
De trouver quelque Dieu plus grand que Jupiter.	De trouver quelque Dieu plus grand que Jupiter.
Vous ne le craignez plus, mais s’il vivoit, peut-eſtre	Vous ne le craignez plus, mais s’il vivait, peut-être
Vous ne parleriez pas ſi haut de voſtre Maiſtre,	Vous ne parleriez pas si haut de votre Maître,
Caſſander, & ſon nom vous auroit fait trembler,	Cassandre, et son nom vous aurait fait trembler,
lors qu’un de ſes regards vous pouvoir accabler.	Lorsqu’un de ses regards vous pouvait accabler.
J'ay remarqué toûjours qu’envieux de ſa gloire	J’ai remarqué toujours qu’envieux de sa gloire
Sans ceſſe vous tâchez d’obſcurcir ſa mémoire;	Sans cesse vous tâchez d’obscurcir sa mémoire;
Je n’examine point le caprice des Dieux,	Je n’examine point le caprice des Dieux,
Ils ont eu leurs raiſons pour l’oſter à nos yeux.	Ils ont eu leurs raisons pour l’ôter à nos yeux.
Dûſſay-je m’attirer l'éclat de leur colere.	Dussé-je m’attirer l’éclat de leur colère,
Il fiſt ſeul ce qu’eux tous auroient eu peine à faire,	Il fit seul ce qu’eux tous auraient eu peine à faire;
Et ſans-doute ces Dieux de ſa gloire jaloux	Et sans doute ces Dieux de sa gloire jaloux
N’ont pû ſouffirir qu’il fuſt adoré parmy nous.	N’ont pu souffrir qu’il fut adoré parmi nous.
J’en dis trop. Mais enfin pour reparer la gloire	J’en dis trop. Mais enfin pour réparer la gloire
D'un Demy-Dieu, je dois élever ſa mémoire;	D’un Demi-Dieu, je dois élever sa mémoire;
Et vous devez ſonger qu’apres un tel Epoux	Et vous devez songer qu’après un tel époux,
Je ne puis m’abaiſſer d’en choiſir parmy vous,	Je ne puis m’abaisser d’en choisir parmi vous,
Qu’ayant mõté ſi haut, mon cœur ne peut deſcendrez,	Qu’ayant monté si haut, mon cœur ne peut descendre,
Et qu'il faut à Roxane un ſecond Aléxandre.	Et qu’il faut à Roxane un second Alexandre.
En eſt-il un encor?..	En est-il un encore?…
Le ſeul Leonatus	Le ſeul Léonatus
Sort du ſang d’Aléxandre, il en a les vertus;	Sort du sang d’Alexandre, il en a les vertus;
Mais Statira, Madame, à vos deſirs fatale,	Mais Statira, Madame, à vos désirs fatale,
Peut-eſtre dans ſon cœur vous donne une Rivale;	Peut-être dans son cœur vous donne une Rivale;
Le ſang de Darius qui vous donna des Loix,	Le sang de Darius qui vous donna des lois,
Sa beauté, ſon mérite, autoriſent ce choix.	Sa beauté, son mérite, autorisent ce choix.
Vous pourrez donc, Seigneur, en la trouvant ſi belle,	Vous pourriez donc, Seigneur, en la trouvant si belle,
Luy préſenter vos vœux, & ſoûpirer pour elle,	Lui présenter vos vœux, et soupirer pour elle,
De ſa gloire mon cœur ne ſera point jaloux,	De sa gloire mon cœur ne sera point jaloux,
Et meſme je conſens à luy parler pour vous.	Et même je consens à lui parler pour vous.
A luy parler pour moy! Juſtes Dieux! Mais, Madame,	À lui parler pour moi! Justes Dieux! Mais, Madame,
Vous ne ſçavez que trop le ſecret de mon ame,	Vous ne savez que trop le secret de mon âme,
J’attens Leonatus; peut-eſtre que ſon cœur	J’attends Léonatus; peut-être que son cœur
Découvrant ſes deſſeins, fera voir mon erreur;	Découvrant ses desseins, fera voir mon erreur;
Mais ſi pour Starira j’avois l’ame inquiéte,	Mais si pour Statira j’avais l’âme inquiète,
Je ne vous prîrois pas d’eſtre mon Interprete,	Je ne vous prierais pas d’être mon Interprète,
Et peut-eſtre mes vœux ſeroient-ils mieux reçeus,	Et peut-être mes vœux seraient-ils mieux reçus,
Si je faiſois pres d'elle agir Leonatus?	Si je faisais près d’elle agir Léonatus?
Ce trait vous eſt ſenſible, & vous frape, Madame,	Ce trait vous est sensible, et vous frappe, Madame,
Je connois dans vos yeux le trouble de voſtre ame,	Je connais dans vos yeux le trouble de votre âme,
Mais enfin dans les miens voyez à voſtre tour,	Mais enfin dans les miens voyez à votre tour,
Avec mon deſeſpoir, ma rage & mon amour.	Avec mon désespoir, ma rage et mon amour.
Caſſander, vous pouſſez trop loin voſtre inſolence,	Cassandre, vous poussez trop loin votre insolence,
C'eſt à vous devant moy de garder le ſilence,	C’est à vous devant moi de garder le silence,
Et ſans aprofondir qui j’aime, ou qui je hais,	Et sans approfondir qui j’aime, ou qui je hais,
Ayez plus de reſpect, & n’en parlez jamais,	Ayez plus de respect, et n’en parlez jamais,
Retirez-vous.	Retirez-vous.
Hé bien? Je vous quite, Madame,	Hé bien? Je vous quitte, Madame,
Vous ſçavez mon fecret, je connois voſtre flame,	Vous savez mon secret, je connais votre flamme,
Il ſuffit. Mais enfin ſi mes voeux ſont déçeus,	Il suffit. Mais enfin si mes vœux sont déçus,
Dans peu je ſerviray ceux de Leonatus.	Dans peu je servirai ceux de Léonatus.
L'Orgueilleux Caſſander ſe déclare, & me brave,	L’Orgueilleux Cassandre se déclare, et me brave,
Luy, qui de mon Epoux eſtoit preſque l’Eſclave,	Lui, qui de mon époux était presque l’Esclave,
Il inſulte à ſa gloire, & ſans reſpecter rien,	Il insulte à sa gloire, et sans respecter rien,
M'oſe parler en Maiſtre, & veut eſtre le mien;	M’ose parle en Maître, et veut être le mien;
li vient avec fierté me découvrir ſa flame,	Il vient avec fierté me découvrir sa flamme,
Il veut aprofondir le ſecret de mon ame,	Il veut approfondir le secret de mon âme,
J'en rougis, Heſione, & mes ſens trop émeus	J’en rougis, Hésione, et mes sens trop émus
Au nom de ma Rivale & de Leonatus,	Au nom de ma Rivale et de Léonatus,
Qui réveillant tous deux ma haine & ma tendreſſe,	Qui réveillant tous deux ma haine et ma tendresse,
Malgré tout mon orgueil ont fait voir ma foibleſſe;	Malgré tout mon orgueil ont fait voir ma faiblesse;
Je verray mes attraits peut-eſtre humiliez,	Je verrai mes attraits peut-être humiliés,
Moy, qui vis le Vainqueur de la Terre à mes pieds,	Moi, qui vis le vainqueur de la Terre à mes pieds,
Moy, qui devrois au nom de Veuve d’Aléxandre	Moi, qui devrais au nom de la veuve d’Alexandre
Aller m'enſevelir dans ſa ſuperbe cendre,	Aller m’ensevelir dans sa superbe cendre,
J’oſe encor luy ſurvivre, & mon perfide cœur	J’ose encore lui survivre, et mon perfide cœur
Soûpire, & malgré moy luy donne un Succeſſeur,	Soupire, et malgré moi lui donne un successeur.
Dans ce trouble mortel je me connois à peine,	Dans ce trouble mortel je me connais à peine,
J’aperçois mon amour à travers de ma haine,	J’aperçois mon amour à travers de ma haine,
Et je dis en tremblant à mes ſens éperdus,	Et je dis en tremblant à mes sens éperdus,
Si je hais Starira, j’aime Leonatus.	Si je hais Statira, j’aime Léonatus.
Mais, Madame, apres tout oſeray-je ſans crime	Mais, Madame, après tout oserai-je sans crime
Sçavoir quelle raiſon contr’elle vous anime?	Savoir quelle raison contre elle vous anime?
Seul reſte des Enfans du ſang de Darius,	Seul reste des enfants du sang de Darius,
Elle a mille beautez, elle a mille vertus;	Elle a mille beautés, elle a mille vertus;
Quand Perdiccas & vous la retenez captive,	Quand Perdiccas et vous la retenez captive,
A peine malgré luy vous ſouffrez qu’elle vive.	À peine malgré lui vous souffrez qu’elle vive,
Que vous a-t-elle fait?	Que vous a-t-elle fait?
Dieux, ce qu’elle m'a fait!	Dieux, ce qu’elle m'a fait!
Heſione, elle eſt belle, & c’eſt là ſon forfait;	Hésione, elle est belle, et c’est là son forfait;
Elle ſçeut m’enlever tous les vœux d’Aléxandre,	Elle su m’enlever tous les vœux d’Alexandre,
Elle a droit ſur un Trône où mon Fils doit prétendre;	Elle a droit sur un Trône où son fils doit prétendre;
Mille jeunes appas qu’elle traîne apres ſoy,	Mille jeunes appas qu’elle traîne après soi,
Et toutes ſes vertus, ſont des crimes pour moy;	Et toutes ses vertus, sont des crimes pour moi;
Elle eſt ma Concurrente à la Perſe, à l’Empire,	Elle est ma Concurrente à la Perse, à l’Empire,
Mais elle eſt ma Rivale, & mon cœur en ſoûpire;	Mais elle est ma rivale, et mon cœur en soupire;
Je la trouve par tout, ſes charmes odieux	Je la trouve partout, ses charmes odieux
Ont toûjours balancé le pouvoir de mes yeux.	Ont toujours balancé le pouvoir de mes yeux.
Il me ſouvient du jour qu’on trompa ma vangeance,	Il me souvient du jour qu’on trompa ma vengeance,
Je vis Leonatus courir à ſa défenſe,	Je vis Léonatus courir à sa défense,
Des ſoins de Perdiccas il prenoit la moitié	Des soins de Perdiccas il prenait la moitié
Par d'autres intéreſts que ceux de la pitié;	Par d’autres intérêts que ceux de la pitié;
Sans leur cruel amour, ſans leur pitié fatale,	Sans leur cruel amour, sans leur pitié fatale,
Roxane en cet inſtant n’avoit plus de Rivale,	Roxane en cet instant n’avait plus de Rivale,
Et terminant ſon ſort pour raſſurer le mien,	Et terminant son sort pour rassurer le mien,
J’allois eſtre en état de ne craindre plus rien.	J’allais être en état de ne craindre plus rien.
Mais Barſine, Madame, eſt plus à craindre qu’elle,	Mais Barsine, Madame, est plus à craindre qu’elle;
Et bien que Statira ſoit plus jeune & plus belle,	Et bien que Statira soit plus jeune et plus belle,
Barſine a d’Alexandre un Fils de qui les droits	Barsine a d’Alexandre un fils de qui les droits
La rendront plus coupable à vos yeux.	La rendront plus coupable à vos yeux.
Je le vois,	Je le vois,
La ſeule Statira cependant m’épouvante,	La seule Statira cependant m’épouvante,
Et Barſine moins belle eſt bien plus innocente.	Et Barsine moins belle est bien plus innocente.
J’ay dans mes intéreſts, & dans ceux de mon Fils,	J’ai dans mes intérêts, et dans ceux de mon fils,
Eumenes, Seleucus, & cent autres Amis;	Eumenes, Seleucus, et cent autres amis;
Mais ſi Leonatus ſe déclare pour elle,	Mais si Léonatus se déclare pour elle,
S’il me porte aujourd’huy cette atteinte mortelle,	S’il me porte aujourd’hui cette atteinte mortelle;
Statira doit trembler... Ce Prince que j’atens	Statira doit trembler… Ce Prince que j’attends
Retient encor mon ame & mes vœux en ſuſpens;	Retient encore mon âme et mes vœux en suspens;
D'une foible elpérance en fecret je me flate,	D’une faible espérance en secret je me flatte,
Il faut que fon deſſein ou ſon amour éclate.	Il faut que son dessein ou son amour éclate.
Dieux! j’en tremble, Heſione, & mon cœur agité...	Dieux! J’en tremble, Hésione, et mon cœur agité…
Mais quelqu’un vient à nous d’un pas précipité.	Mais quelqu’un vient à nous d’un pas précipité.
LEonatus arrive, & Perdiccas l’emmeine;	LÉonatus arrive, et Perdiccas l’emmène;
Madame, ils ſont déja dans la Chambre prochaine,	Madame, ils sont déjà dans la Chambre prochaine,
Vous l’allez voir, il vient.	Vous l’allez voir, il vient.
Ah quel trouble preſſant!	Ah quel trouble pressant!
Cachons mieux, s’il ſe peut, ce que mon cœur reſſent.	Cachons mieux, s’il se peut, ce que mon cœur ressent.
AVant que de nous faire une ſanglante guerre	AVant que de nous faire une sanglante guerre
Dont les grands intéreſts arment toute la Terre,	Dont les grands intérêts arment toute la Terre,
Madame, & vous Seigneurs, nous devons balancer	Madame, et vous Seigneurs, nous devons balancer
Ce qui peut la finir, loin de la commencer.	Ce qui peut la finir, loin de la commencer.
Avant que noſtre Armée oſe rien entreprendre,	Avant que notre Armée ose rien entreprendre,
Nous devons ce reſpect aux manes d'Alexandre,	Nous devons ce respect aux mânes d’Alexandre,
De ne pas renverſer un Etat ſi puiſſant	De ne pas renverser un État si puissant
Que ſon Bras a rendu ſuperbe & floriſſant.	Que son Bras a rendu superbe et florissant.
Il faut qu’un grand deſſein ſur l’équité ſe fonde,	Il faut qu’un grand dessein sur l’équité se fonde,
Il s’agit du deſtin de l’Empire du Monde,	Il s’agit du destin de l’Empire du Monde,
Et nous devons, vainqueurs de cent Peuples divers,	Et nous devons, vainqueurs de cent Peuples divers,
Partager, & non pas déchirer l’Univers.	Partager, et non pas déchirer l’Univers.
Sur tant de Nations qui ſont fieres & braves,	Sur tant de Nations qui sont fières et braves,
De Maiſtres nous allons devenir les Eſclaves,	De Maîtres nous allons devenir les Esclaves,
Et travaillant nous-meſme à nos propres débris,	Et travaillant nous-mêmes à nos propres débris,
Nous allons par nos bras vanger nos Ennemis.	Nous allons par nos bras venger nos Ennemis.
Oüy, déja l'Indien, le Perſan & le Scyte,	Oui, déjà l’Indien, le Persan et le Scythe,
S’apreſtent à briſer le joug qui les irrite,	S’apprêtent à briser le joug qui les irrite,
Et ces Peuples vaincus à demy révoltez	Et ces peuples vaincus à demi révoltés
Nous deſtinent déja les fers qu’ils ont portez.	Nous destinent déjà les fers qu’ils ont portés.
Quand nous ſerons en proye à la guerre civile,	Quand nous serons en proies à la guerre civile,
Un Ennemy défait en fera naître mille,	Un Ennemi défait en fera naître mille,
Qui joüiſſans du fruit de nos communs malheurs,	Qui jouissant du fruit de nos communs malheurs,
Vangerons les Vaincus aux deſpens des Vainqueurs,	Vengeront les vaincus aux dépens des Vainqueurs,
Qui devenant alors victimes de leur gloire,	Qui devenant alors victimes de leur gloire,
Se verront accablez par leur propre victoire;	Se verront accablés par leur propre victoire;
Ainſi ſans nous flater de nos prétentions,	Ainsi sans nous flatter de nos prétentions,
Donnons ordre au plutoſt à nos diviſions.	Donnons ordre au plutôt à nos divisions.
Philipe a-t-il d’un Roy la veritable marque?	Philipe a-t-il d’un Roi la véritable marque?
Non, vous n'avez en luy que l’ombre d’un Monarque,	Non, vous n’avez en lui que l’ombre d’un Monarque,
Un Maiſtre qui vous ſert formé de voſtre main,	Un Maître qui vous sert formé de votre main,
Et vous faites mouvoir un Fantôme ſi vain.	Et vous faites mouvoir un Fantôme si vain.
L’Univers peut-il eſtre un Trône hereditaire?	L’Univers peut-il être un Trône héréditaire?
La Victoire a des droits plus forts que ceux d'un Frere,	La Victoire a des droits plus forts que ceux d’un Frère,
Et puis que par nos mains un Héros l’a conquis,	Et puisque par nos mains un Héros l’a conquis,
Alexandre eſt le Pere, & nous ſommes les Fils.	Alexandre est le Père, et nous sommes les Fils.
Madame, on aura ſoin des intéreſts du voſtre,	Madame, on aura soin des intérêts du vôtre,
l’intéreſt de Barſine eſt déja joint au noſtre,	L’intérêt de Barsine est déjà joint au nôtre,
Ainſi ſur cet article on poura décider;	Ainsi sur cet article on pourra décider;
Mais, Madame, il m’en reſte un autre à demander.	Mais, Madame, il m’en reste un autre à demander.
On tient dans ce Palais Starira priſonniere,	On tient dans ce Palais Statira prisonnière,
Qu’on luy rende aujourd'huy liberté toute entiere,	Qu’on lui rende aujourd’hui liberté toute entière,
Tout le Camp la demande, & Ptolomée, & moy.	Tout le Camp la demande, et Ptolomée, et moi.
Statira?	Statira?
Comme vous elle eſt Veuve du Roy.	Comme vous elle est Veuve du Roi.
Madame, comme vous elle eſt libre, elle eſt Reyne;	Madame, comme vous elle est libre, elle est Reine;
De plus, cent mille Bras viendront briſer ſa chaîne,	De plus, cent mille bras viendront briser sa chaîne,
Si l'on nous la refuſe, & qu’on oſe arreſter	Si l’on nous la refuse, et qu’on ose arrêter
Une Reyne d’un ſang que l'on doit reſpecter.	Une Reine d’un sang que l’on doit respecter.
Ciel! qu’entens-je?	Ciel! qu’entends-je?
Seigneur, vous ignorez peut-eſtre	Seigneur, vous ignorez peut-être
Que nous parler ainſi c’eſt nous parler en Maiſtre,	Que nous parler ainsi c’est nous parler en Maître,
Et vous devez agir avec moins de hauteur;	Et vous devez agir avec moins de hauteur;
Attendez qu’un Combat vous rende le vainqueur.	Attendez qu’un Combat vous rende le vainqueur.
Mais je veux vous ouvrir mon ame toute entiere,	Mais je veux vous ouvrir mon âme toute entière,
Oüy, c’eſt moy qui retiens la Reyne priſonniere,	Oui, c’est moi qui retiens la reine prisonnière,
Mais ſçachez que les fers que j'oſe luy donner	Mais sachez que les fers que j’ose lui donner
Ne rattachent icy que pour l'y couronner.	Ne l’attachent ici que pour l’y couronner.
La couronner, vous?	La couronner, vous?
Moy. Je prétens & j'eſpere	Moi. Je prétends et j'espère
Que cette main la place au Trône de ſon Pere.	Que cette main la place au Trône de son Père.
Mais la Reyne, Seigneur, ſuivant ce grand deſſein,	Mais la Reine, Seigneur, suivant ce grand dessein,
Voudra-t-elle d’un Trône offert de voſtre main?	Voudra-t-elle d’un Trône offert de votre main?
Et pourquoy non, Seigneur? Statira pouroit-elle	Et pourquoi non, Seigneur? Statira pourrait-elle
Refuſer une place où Perdiccas l'apelle?	Refuser une place où Perdiccas l’appelle?
Madame, Statira feroit plutoſt refus	Madame, Statira ferait plutôt refus
De l’Univers offert, que de Leonatus.	De l’Univers offert, que de Léonatus.
Je ne ſçay; mais, Seigneur, quoy qu’il arrive,	Je ne sais; mais, Seigneur, quoi qu’il arrive,
Roxane & Perdiccas la retiendront captive.	Roxane et Perdiccas la retiendront captive.
AH Madame! ou les Dieux n’auront point d’équité,	Ah Madame! ou les Dieux n’auront point d’équité,
Ou nous l'arracherons à la captivité.	Ou nous l’arracherons à la captivité.
Au lieu de prévenir une funeſte guerre,	Au lieu de prévenir une funeste guerre,
Vous allez l’allumer aux deux bouts de la Terre,	Vous allez l’allumer aux deux bouts de la Terre,
Madame.	Madame.
Et nous, Seigneur, nous ſçaurons ſoûtenir	Et nous, Seigneur, nous saurons soutenir
Ces éclats dangereux que I'on peut prévenir.	Ces éclats dangereux que l’on peut prévenir.
Vous pouvez cependant aſſurer Ptolomée	Vous pouvez cependant assurer Ptolomée
Que nous ne craignons point ny luy, ny ſon Armée.	Que nous ne craignons point ni lui, ni son Armée.
Sortons, Seigneur.	Sortons, Seigneur.
JE voy qu'on nous brave tous deux,	JE vois qu'on nous brave tous deux,
Roxane nous inſulte & mépriſe mes feux,	Roxane nous insulte et méprise mes feux,
Perdiccas m’abandonne & s’unit avecque elle,	Perdiccas m’abandonne et s’unit avec elle,
Je les quite, Seigneur, & prens voſtre querelle,	Je les quitte, Seigneur, et prends votre querelle,
Dans une heure je puis délivrer Starira,	Dans une heure je puis délivrer Statira,
Ou dans ce grand deſſein Caſſander périra.	Ou dans ce grand dessein Cassandre périra.
Quoy, Seigneur, ſe peut-il que par voſtre aſſiſtance...	Quoi, Seigneur, se peut-il que par votre assistance…
Seigneur, voſtre intereſt s’unit à ma vangeance,	Seigneur, votre intérêt s’unit à ma vengeance,
J'en ay des moyens ſeúrs, mais pour les conſulter,	J’en ai des moyens sûrs, mais pour les consulter,
Sortons, de peur qu’icy l’on nous puiſſe écouter.	Sortons, de peur qu’ici l’on nous puisse écouter.
A ſuperbe Roxane eſt toujours irritée,	LA superbe Roxane est toujours irritée,
Leonatus, enfin, rend ſon ame agitée;	Léonatus, enfin, rend son âme agitée;
Quoy qu’elle diſſimule & flate Perdiccas,	Quoi qu’elle dissimule et flatte Perdiccas,
Ses yeux ont prononcé l'Arreſt de mon trépas:	Ses yeux ont prononcé l’Arrêt de mon trépas:
Oüy, Cleone, c’eſt là ce que j’en dois attendre;	Oui, Cléone, c’est là ce que j’en dois attendre;
Fille de Darius, & Veuve d'Aléxandre,	Fille de Darius, et Veuve d’Alexandre,
Ces grands noms ſi fameux, ſi crains dans l’Univers,	Ces grands noms si fameux, si craints dans l’Univers,
Ne ſervent aujourd’huy qu’à me charger de fers;	Ne servent aujourd’hui qu’à me charger de fers;
Ces grands noms aujourd'huy font ma peine & mon crime,	Ces grands noms aujourd’hui font ma peine et mon crime,
Et de la Politique innocente Victime,	Et de la Politique innocente Victime,
En bute à cent périls, je me vois tour à tour	En butte à cent périls, je me vois tour à tour
Et l’objet de la haine, & l’objet de l'amour.	Et l’objet de la haine, et l’objet de l’amour.
Lors que Leonatus eſt venu de l’Armée,	Lors que Léonatus est venu de l’Armée,
Madame, l’on a veu que Roxane allarmée,	Madame, l’on a vu que Roxane alarmée,
Unie à Perdiccas, a ſçeu tout refuſer	Unie à Perdiccas, a su tout refuser
Ce que Leonatus eſt venu propoſer.	Ce que Léonatus est venu proposer.
Mais d’où vient que Roxane à vos jours ſi fatale...	Mais d’où vient que Roxane à vos jours si fatale…
Pourquoy t’en étonner? Roxane eſt ma Rivale;	Pourquoi t’en étonner? Roxane est ma Rivale;
Sa rage, ſes chagrins, ſes fureurs, ſes refus,	Sa rage, ses chagrins, ses fureurs, ses refus,
Tout me dit que Roxane aime Leonatus.	Tout me dit que Roxane aime Léonatus.
Mais écoute, Cleone, il eſt temps de t’aprendre	Mais écoute, Cléone, il est temps de t’apprendre
Le ſecret & l’amour des Veuves d'Alexandre;	Le secret et l’amour des Veuves d’Alexandre;
Mes feux, mes-triſtes feux, ne ſont point criminels,	Mes feux, mes tristes feux, ne sont points criminels,
Quand j’adore apres luy le plus grand des Mortels,	Quand j’adore après lui le plus grand des Mortels,
Car ſi de l'Univers il n’eut eſté le Maître,	Car si de l’Univers il n’eut été le Maître,
Le ſeul Leonatus eſtoit digne de l'eſtre.	Le seul Léonatus était digne de l’être.
Aprens donc mon amour, ma crainte, mes ennuis,	Apprends donc mon amour, ma crainte, mes ennuis,
Et l’état pitoyable où mes jours ſont réduits.	Et l’état pitoyable où mes jours sont réduits.
Helas! te ſouvient-il de ce jour mémorable	Hélas! te souvient-il de ce jour mémorable
Qui fit de Darius le deſtin déplorable?	Qui fit de Darius le destin déplorable?
Quand le monde ébranlé par ce premier revers	Quand le monde ébranlé par ce premier revers
Commença de trembler nous voyant dans les fers;	Commença de trembler nous voyant dans les fers;
Que dans le Champ d’Iſſus Aléxandre eut la gloire	Que dans le Champ d’Issus Alexandre eut la gloire
D'honorer de nos fers ſa premiere victoire,	D’honorer de nos fers sa première victoire,
Nous attendions en pleurs le deſtin des Vaincus,	Nous attendions en pleurs le destin des Vaincus,
Lors qu'on nous annonça la mort de Darius:	Lors qu’on nous annonça la mort de Darius:
De cent cris douloureux nos Tentes retentirent,	De cent cris douloureux nos Tentes retentirent,
Les Vaincus, les Vainqueurs, cõme nous en gémirent,	Les Vaincus, les Vainqueurs, comme nous en gémirent;
Ma Mere évanoüye, avec Syſigambis,	Ma Mère évanouie, avec Sysigambis,
Nous faiſoit redoubler nos ſanglots & nos cris,	Nous faisait redoubler nos sanglots et nos cris,
Nous eſtions à leurs pieds dans ces triſtes allarmes,	Nous étions à leurs pieds dans ces tristes alarmes,
Et pour les ſecourir nous n’avions que nos larmes.	Et pour les secourir nous n’avions que nos larmes.
Alexandre touché que par un faux raport	Alexandre touché que par un faux rapport
Nous eſtions allarmez pour cette feinte mort,	Nous étions alarmés pour cette feinte mort,
Voulut ſecher les pleurs qu'il nous faiſoit répandre,	Voulut sécher les pleurs qu’il nous faisait répandre;
Leonatus entra de la part d’Aléxandre,	Léonatus entra de la part d’Alexandre,
Et ce Prince attendry de nos vives douleurs	Et ce Prince attendri de nos vives douleurs
D'un ſeul mot arreſta la ſource de nos pleurs.	D’un seul mot arrêta la source de nos pleurs.
Ciel! avec quelle grace il aborda ma Mere	Ciel! avec quelle grâce il aborda ma Mère
Lors qu’il nous détrompa de la mort de mon Pere!	Lorsqu’il nous détrompa de la mort de mon Père!
Que ſon air eſtoit libre & remply de grandeur!	Que son air était libre et rempli de grandeur!
Et qu’il me parût propre à conſoler un cœur!	Et qu’il me parût propre à consoler un cœur!
Je ne ſçay ſi déja pour mon Pere attendrie,	Je ne sais si déjà pour mon Père attendrie,
Lors que Leonatus m'aſſuroit de ſa vie,	Lorsque Léonatus m’assurait de sa vie,
Mon coeur ſans y penſer, par un juſte retour,	Mon cœur sans y penser, par un juste retour,
Fiſt ſervir l’amitié de paſſage à l’amour:	Fit servir l’amitié de passage à l’amour:
Enfin dans cet inſtant je ne pûs me défendre	Enfin dans cet instant je ne pus me défendre
De ſentir pour ce Prince un mouvement trop tendre;	De sentir pour ce Prince un mouvement trop tendre;
Et ſoit que le Deſtin ou l’Amour le voulut,	Et soit que le Destin ou l’Amour le voulut,
Il me vit, je luy plûs, je le vis, il me plût.	Il me vit, je lui plus, je le vis, il me plût.
Mais, Madame, depuis, malgré ce cœur ſi tendre,	Mais, Madame, depuis, malgré ce cœur si tendre,
Leonatus vous vit l'Epouſe d’Aléxandre,	Léonatus vous vit l’Épouse d’Alexandre,
Et cet illuſtre nom qui vous couvre d’éclat...	Et cet illustre nom qui vous couvre d’éclat…
Il fallut obeïr en Victime d'Etat;	Il fallut obéir en Victime d’État;
Leonatus remply d’une douleur extréme,	Léonatus rempli d’une douleur extrême,
Deſeſperé, tremblant, vint m’annoncer luy-meſme	Désespéré, tremblant; vint m’annoncer lui-même
Qu'Aléxandre dans peu me devoit épouſer,	Qu’Alexandre dans peu me devait épouser,
Et qu’il l’avoit chargé de me le propoſer.	Et qu’il l’avait chargé de me le proposer.
Juge de ſa douleur, Cleone, & de la mienne,	Juge de sa douleur, Cléone, et de la mienne,
Ma flame eſtoit déja preſque égale à la ſienne,	Ma flamme était déjà presque égale à la sienne,
Et dans ce dur moment, je ne puis le celer,	Et dans ce dur moment, je ne puis le celer,
Je voulus luy répondre, & ne ſçeus luy parler;	Je voulus lui répondre, et ne sus lui parler;
Mais tous deux de concert dans ces vives allarmes,	Mais tous deux de concert dans ces vives alarmes,
Nous laiſſâmes parler nos ſoûpirs & nos larmes.	Nous laissâmes parler nos soupirs et nos larmes.
Je voyois à regret ce Prince mon Amant,	Je voyais à regret ce Prince mon Amant,
Luy-meſme à ma grandeur s’immoler tendrement;	Lui-même à ma grandeur s’immoler tendrement;
Aléxandre vainqueur, quoyqu’il fiſt pour me plaire,	Alexandre vainqueur, quoiqu’il fit pour me plaire,
Ne m’en parût pas moins le vainqueur de mon Pere;	Ne m’en parût pas moins le vainqueur de mon Père;
Raviſſeur de nos biens, maiſtre de nos Etats,	Ravisseur de nos biens, maître de nos États,
J'admiré ce Héros, mais je ne l'amay pas,	J’admirais ce Héros, mais je ne l’aimais pas,
Il fallut obeïr cependant, & mon ame	Il fallut obéir cependant, et mon âme
Par un triſte devoir ſçeut combatre ma flame,	Par un triste devoir sut combattre ma flamme,
Et de Leonatus effaçant tous les traits,	Et de Léonatus effaçant tous les traits,
Luy dire en ſoúpirant un adieu pour jamais.	Lui dire en soupirant un adieu pour jamais.
Depuis, grace aux Dieux, mon cœur pour luy moins tendre,	Depuis, grâces aux Dieux, mon cœur pour lui moins tendre,
A ſoútenu le nom d'Epouſe d'Aléxandre;	A soutenu le nom d’Épouse d’Alexandre;
Une vertu ſevere, un auſtere devoir,	Une vertu sévère, un austère devoir,
M’ont cent fois arrachée au plaiſir de le voir;	M’ont cent fois arrachée au plaisir de le voir;
Loin de luy je tâchois d’étouffer ma tendreſſe,	Loin de lui je tâchais d’étouffer ma tendresse,
Je l'évitois helas! & le trouvois ſans ceſſe.	Je l’évitais hélas! et le trouvais sans cesse.
Le Roy qui luy donnoit comme à ſon Favory	Le Roi qui lui donnait comme à son Favori,
Le rang d’Epheſtion qu’il avoit tant chery,	Le rang d’Éphestion qu’il avait tant chéri,
Vit que Leonatus me faiſoit de la peine,	Vit que Léonatus me faisait de la peine,
Et me crut pour ce Prince une ſecrete haine,	Et me crut pour ce Prince une secrète haine,
Et ſouvent malgré luy l’amenant devant moy.	Et souvent malgré lui l’amenant devant moi.
M'arrachoit des ſoúpirs qu'il voloit à ma foy,	M’arrachait des soupirs qu’il volait à ma foi,
Souvent il me prioit dans ſa tendreſſe extréme	Souvent il me priait dans sa tendresse extrême
D’aimer Leonatus comme il l’aimoit luy-meſme.	D’aimer Léonatus comme il l’aimait lui-même.
Moy, qui dans cet inſtant eus voulu la haïr,	Moi, qui dans cet instant eus voulu la haïr,
Cleone, je tremblois de luy trop obeïr,	Cléone, je tremblais de lui trop obéir,
Et ce Prince confus des bontez de ſon Maiſtre,	Et ce Prince confus de bontés de son Maître,
M’évitoit auſſitoſt qu’il me voyoit paroiſtre.	M’évitait aussitôt qu’il me voyait paraître.
Mais, Madame, à préſent qu’Aléxandre n’eſt plus;	Mais, Madame, à présent qu’Alexandre n’est plus;
Vous pouvez ſans ſcrupule aimer Leonatus;	Vous pouvez sans scrupule aimer Léonatus;
Un Prince de ſon ſang peut apres luy prétendre....	Un Prince de son sang peut après lui prétende…
Je puis, ſans offencer les manes d’Alexandre,	Je puis, sans offenser les mânes d’Alexandre,
Ranimer aujourd’huy dans mon cœur abatu	Ranimer aujourd’hui dans mon cœur abattu
Un amour immolé longtemps à ma vertu;	Un amour immolé longtemps à ma vertu;
Mais Roxane a trouvé Leonatus aimable,	Mais Roxane a trouvé Léonatus aimable,
Et ma flame à ſes yeux me va rendre coupable;	Et ma flamme à ses yeux me va rendre coupable;
Cleone, elle peut tout, les Macédoniens	Cléone, elle peut tout, les Macédoniens
Prennent ſes intereſts, & négligent les miens.	Prennent ses intérêts, et négligent les miens.
Le ſeul Leonatus qui veut briſer ma chaîne,	Le seul Léonatus, qui veut briser ma chaîne,
Redouble de Roxane & l’amour & la haine,	Redouble de Roxane et la l’amour et la haine,
Et la force à la main, pour me tirer des fers,	Et la force à la main, pour me tirer des fers,
Veut contre Perdiccas armer tout l’Univers.	Veut contre Perdiccas armer tout l’Univers.
Je tremble qu’il n'expoſe une ſi chere Teſte	Je tremble qu’il n’expose une si chère Tête
A cent périls afreux où ſa valeur s’apreſte,	À cent périls affreux où sa valeur s’apprête,
Et que pour me vanger, ou pour me conquérir,	Et que pour me venger, ou pour me conquérir,
Ce Héros ne ſe mette en danger de périr.	Ce Héros ne se mette en danger de périr.
Madame, Caſſander vient à nous.	Madame, Cassandre vient à nous.
Ah! Cleone,	Ah! Cléone,
Que veut-il?	Que veut-il?
JE le voy, mon abord vous étonne,	JE le vois, mon abord vous étonne,
Mais je viens yous aprendre un projet important.	Mais je viens vous apprendre un projet important.
Quoy donc?	Quoi donc?
Leonatus, Madame, vous attend,	Léonatus, Madame, vous attend,
Un ſemblable intéreſt nous unit l’un & l'autre,	Un semblable intérêt nous unit l’un et l’autre,
Il m’a dit ſon ſecret, & je connois le voſtre,	Il m’a dit son secret, et je connais le vôtre,
Il vous faut aujourd’huy rendre la liberté,	Il vous faut aujourd’hui rendre la liberté,
Et vous faire ſçavoir ce que j’ay concerté.	Et vous faire savoir ce que j’ai concerté.
Avec Leonatus qu’allez vous entreprendre,	Avec Léonatus qu’allez-vous entreprendre,
Seigneur?	Seigneur?
Dans Babylone il doit bientoſt ſe rendre,	Dans Babylone il doit bientôt se rendre,
J’apuyray ſes deſſeins, & malgré Perdiccas	J’appuierai ses desseins, et malgré Perdiccas
Dont j’ay depuis longtemps gagné tous les Soldats,	Dont j’ai depuis longtemps gagné tous les Soldats,
Qui ſuivant autrefois Antipater mon Pere,	Qui suivant autrefois Antipater mon Père,
Tous dévoüez à moy, m’ont promis de tout faire.	Tous dévoués à moi, m’ont promis de tout faire.
Je feray relever la Garde, & dans ce temps	Je ferai relever la Garde, et dans ce temps
Arbate qui commande à tous les Habitans,	Arbate qui commande à tous les Habitants,
Doit à Leonatus faire ouvrir une Porte,	Doit à Léonatus faire ouvrir une Porte,
Vous conduire en ſecret, & vous ſervit d’Eſcorte;	Vous conduire en secret, et vous servir d’Escorte;
Voſtre Garde eſt à moy, mais il faut amuſer	Votre Garde est à moi, mais il faut amuser
Roxane & Perdiccas, & contre eux tout oſer.	Roxane et Perdiccas, et contre eux tout oser.
Pour mieux les éboüir, je connois l'art de freindre,	Pour mieux les éblouir, je connais l’art de feindre,
Je les flate tous deux, & je ſçay me contraindre,	Je les flatte tous deux, et je sais me contraindre,
Mais ils pouront connoiſtre avant la fin du jour,	Mais ils pourront connaître avant la fin du jour,
Madame, que je ſers ma haine & voſtre amour.	Madame, que je sers ma haine et votre amour.
Ne vous étonnez pas, Seigneur, de ma ſurpriſe,	Ne vous étonnez pas, Seigneur, de ma surprise,
Caſſander eſt l’autheur d’une telle entrepriſe,	Cassandre est l’auteur d’une telle entreprise,
Un Amant de Roxane!	Un Amant de Roxane!
Un Amant outragé,	Un Amant outragé,
Oüy, Madame, un Amant qui veut eſtre vangé;	Oui, Madame, un Amant qui veut être vengé;
Ses mépris (devant vous j’avoûray ma foibleſſe)	Ses mépris (devant vous j’avouerai ma faiblesse)
Loin d’éteindre mes feux, augmentent ma tendreſſe;	Loin d’éteindre mes feux, augmentent ma tendresse;
J'en soûpire de rage, & vois Leonatus	J’en soupire de rage, et vois Léonatus
Me dérober un cœur l’objet de ſes refus,	Me dérober un cœur l’objet de ses refus,
Et nous n’ignorons pas qu’en ce deſordre extréme	Et nous n’ignorons pas qu’en ce désordre extrême
Il vous aime, il la hait, elle me hait, je l'aime;	Il vous aime, il la hait, elle me hait, je l’aime;
Ainſi pour me vanger & pour mieux l’obtenir,	Ainsi pour me venger et pour mieux l’obtenir,
Avec Leonatus je ſçauray vous unir;	Avec Léonatus je saurai vous unir;
Peut-eſtre que Roxane en perdant l'eſpérancé,	Peut-être que Roxane en perdant l’espérance,
Couronnera mes feux & ma perſéverance,	Couronnera mes feux et ma persévérance,
Et pour vous engager par de ſi forts liens,	Et pour vous engager par de si forts liens,
J'unis vos intereſts, Madame, avec les miens.	J’unis vos intérêts, Madame, avec les miens.
Je reſpire, Seigneur, & commence à comprendre	Je respire, Seigneur, et commence à comprendre
Qu’un Hõme tel que vous poura tout entreprendre;	Qu’un Homme tel que vous pourra tout entreprendre;
Vous aimez, il ſuffit, & vous avez promis....	Vous aimez, il suffit, et vous avez promis…
Mais, Seigneur, cõtre vous quel nombre d'Ennemis?	Mais, Seigneur, contre vous quel nombre d’Ennemis?
Leonatus peut-il ſeconder voſtre attente?	Léonatus peut-il seconder votre attente?
Perdiccas eſt jaloux, & Roxane eſt Amante.	Perdiccas est jaloux, et Roxane est Amante.
Que de périls, grands Dieux!	Que de périls, grands Dieux!
Quoy, Madame?	Quoi, Madame?
Seigneur,	Seigneur,
Ce grand projet me trouble & me glace le cœur.	Ce grand projet me trouble et me glace le cœur.
Quand je trace à mes yeux une fidelle image	Quand je trace à mes yeux une fidèle image
De mille affreux périls où ce pas vous engage,	De mille affreux périls où ce pas vous engage,
Je ſoûpire, je tremble, & n'y puis conſentir,	Je soupire, je tremble et n’y puis consentir,
Je ne ſçay quels malheurs mon cœur ſçait preſſentir.	Je ne sais quels malheurs mon cœur sait pressentir.
Dieux! ſi Leonatus dans ſa funeſte envie	Dieux! Si Léonatus dans sa funeste envie
Payoit ma liberté de ſon ſang, de ſa vie,	Payait ma liberté de son sang, de sa vie,
Qu'il vint tõber ſanglant à mes pieds.... J’en frémis,	Qu’il vint tomber sanglant à mes pieds… J’en frémis,
Et ne veux point, Seigneur, eſtre libre à ce prix.	Et ne veux point, Seigneur, être libre à ce prix.
Madame, au nom des Dieux, ſoyez moins allarmée,	Madame, au nom des Dieux, soyez moins alarmée;
Vous verrez aujourd'huy le Camp de Ptolomée,	Vous verrez aujourd’hui le Camp de Ptolomée,
Laiſſez-moy tout conduire, allez en ce moment,	Laissez-moi tout conduire, allez en ce moment,
En attendant Arbate, en voſtre Apartement;	En attendant Arbate, en votre Appartement;
Là, Madame, dans peu vous le verrez paroiſtre,	Là, Madame, dans peu vous le verrez paraître,
Un plus long entretien ſeroit ſuſpect peut-eſtre,	Un plus long entretien serait suspect peut-être,
Si Roxane en ces lieux me trouvoit avec vous,	Si Roxane en ces lieux me trouvait avec vous,
Sa jalouſie....	Sa jalousie…
Hé bien, évitons ſon couroux;	Hé bien, évitons son courroux;
Mais ſongez bien, Seigneur, quoy que l'on entreprenne	Mais songez bien, Seigneur, quoi que l’on entreprenne,
A ſauver une vie où j’atache la mienne,	À sauver une vie où j’attache la mienne,
C’eſt vous en dire trop. Adieu.	C’est vous en dire trop. Adieu.
LEonatus	LÉonatus
Allarme Statira, rend ſes deſirs confus;	Alarme Statira, rend ses désirs confus;
Mais, Seigneur, vous devez bientoſt briſer ſa chaîne.	Mais, Seigneur, vous devez bientôt briser sa chaîne.
Mon intéreſt eſt: joint à celuy de la Reyne;	Mon intérêt est joint à celui de la Reine;
Voy donc ma politique, & connois mes deſſeins,	Vois donc ma politique, et connais mes desseins,
Peuceſtas, je la ſers, cependant je la plains;	Peucestas, je la sers, cependant je la plains;
Une telle entrepriſe aux yeux de ſa Rivale	Une telle entreprise aux yeux de sa Rivale
Peut enfin eſtre heureuſe, ou devenir fatale;	Peut enfin être heureuse, ou devenir fatale;
Mais qu’elle réüſſiſſe, ou non, je me promets,	Mais qu’elle réussisse, ou non, je me promets,
D'en avoir pour mes feux l’infaillible ſuccés.	D’en avoir pour mes feux l’infaillible succès.
Leonatus qui craint les ennuis d'un long Siege,	Léonatus qui craint les ennuis d’un long Siège,
Voulant les prévenir, court de luy-meſme au piege,	Voulant les prévenir, court de lui-même au piège,
Il le veut, je le ſers. Si le succés heureux	Il le veut, je le sers. Si le succès heureux
Luy donne ſa Princeſſe, il couronne mes feux;	Lui donne sa Princesse, il couronne mes feux;
S’il périt, mon Rival deviendra ma victime,	S’il périt, mon Rival deviendra ma victime,
Et ſa propre valeur va m’épargner un crime;	Et sa propre valeur va m’épargner un crime;
Je hais Leonatus, il me fait de l’horreur,	Je hais Léonatus, il me fait de l’horreur,
Tu vois que de Roxane il m'enleve le cœur,	Tu vois que de Roxane il m’enlève le cœur,
Et quoy qu’enfin le ſien pour Statira ſoûpire,	Et quoiqu’enfin le sien pour Statira soupire,
De l'amour de Roxane il ne faut pas l'inſtruire,	De l’amour de Roxane il ne faut pas l’instruire,
Il l'ignore, & je veux qu’il l’ignore toûjours,	Il l’ignore, et je veux qu’il l’ignore toujours,
Ou qu’il n’en ſoit inſtruit qu’aux deſpẽs de ſes jours;	Ou qu’il n’en soit instruit qu’aux dépens de ses jours;
Mais Roxane qui craint le pouvoir de mon Pere,	Mais Roxane qui craint le pouvoir de mon Père,
Qui ſçait qu’Antipater peut ſervir ma colere,	Qui sait qu’Antipater peut servir ma colère,
Que ſon Armée avance, a connu que tantôt	Que son Armée avance, a connu que tantôt
Son eſprit irrité m’avoit parlé trop haut.	Son esprit irrité m’avait parlé trop haut.
Dieux! ſi ſon cœur pouvoir.... La voicy, la cruelle,	Dieux! Si son cœur pouvait… La voici, la cruelle,
Cours prendre garde à tout, & me laiſſe avecque elle.	Cours prendre garde à tout, et me laisse avec elle.
JE vous cherchois, Seigneur, vous en eſtes ſurpris,	JE vous cherchais, Seigneur, vous en êtes surpris,
Mais nous devons quiter l’aigreur & le-mépris,	Mais nous devons quitter l’aigreur et le mépris,
Nos eſprits inquiets en avoient l’un & l'autre,	Nos esprits inquiets en avaient l’un et l’autre,
Mon cœur en eſtoit plein auſſi-bien que le voſtre,	Mon cœur en était plein aussi bien que le vôtre,
Dans un péril preſſant nous devons les banir,	Dans un péril pressant nous devons les bannir,
Et de grands intéreſts nous doivent réünir,	Et de grands intérêts nous doivent réunir,
Je rends à vos vertus un tribut légitime,	Je rends à vos vertus un tribut légitime,
Voyons, ſi vous voulez mériter mon eſtime.	Voyons, si vous voulez mériter mon estime.
Je feray tout, Madame, & pour la mériter,	Je ferai tout, Madame, et pour la mériter,
Que faut-il....	Que faut-il…
Un deſſein qu’il faut exécuter.	Un dessein qu’il faut exécuter.
Le fier Leonatus nous brave, nous menace,	Le fier Léonatus nous brave, nous menace,
Et déja Ptolomée aſſiege cette Place,	Et déjà Ptolomée assiège cette Place,
Il apoche, on l'a veu du haut de nos Rempars	Il approche, on l’a vu du haut de nos Remparts
Faire contre nos Murs marches ſes Etendars;	Faire contre nos Murs marcher ses Étendards;
Nous pourrons d’un ſeul coup prévenir la tempeſte,	Nous pourrions d’un seul coup prévenir la tempête,
Il ne faudroit, Seigneur, abatre qu’une Teſte,	Il ne faudrait, Seigneur, abattre qu’une Tête,
Punir Leonatus de ſa temérité....	Punir Léonatus de sa témérité…
Contre luy voſtre cœur ſeroit-il irrité,	Contre lui votre cœur serait-il irrité,
Madame, & pouriez-vous m'aſſurer d’une haine....	Madame, et pourriez-vous m’assurer d’une haine…
De ma haine, Seigneur! Dieux! elle eſt trop certaine,	De ma haine, Seigneur! Dieux! elle est trop certaine,
Roxane contre luy n’en a point à demy,	Roxane contre lui n’en a point à demi,
Je hay Leonatus en mortel Ennemy,	Je hais Léonatus en mortel Ennemi,
Luy qui prétend nous faire une ſanglante guerre,	Lui qui prétend nous faire une sanglante guerre,
Qui contre nous ſoûleve & le Ciel & la Terre,	Qui contre nous soulève et le Ciel et la Terre,
Leonatus, enfin, que je veux deſormais....	Léonatus, enfin, que je veux désormais…
Pourquoy me demander, Seigneur, ſi je le hais?	Pourquoi me demander, Seigneur, si je le hais?
Hé bien? à vous ſervir ma main eſt toute preſte;	Hé bien? À vous servir ma main est toute prête;
Mais, Madame, oſez vous me demander ſa Teſte?	Mais, Madame, osez vous me demander sa Tête?
De qui?	De qui?
D’un Ennemy qui vous eſt odieux,	D’un Ennemi qui vous est odieux,
Qui vient....	Qui vient…
Ce n’eſt pas là, Seigneur, ce que je veux,	Ce n’est pas là, Seigneur, ce que je veux,
Mais je veux l’attaquer par un autre Luy-meſme,	Mais je veux l’attaquer par un autre Lui-même,
Et ne veux le punir que dans l’Objet qu’il aime;	Et ne veux le punir que dans l’Objet qu’il aime;
li nous faut ébloüir & tromper Perdiccas,	Il nous faut éblouir et tromper Perdiccas.
Immolons en ſecret les funeſtes appas	Immolons en secret les funestes appas
Pour qui Leonatus....	Pour qui Léonatus…
Je vous entens, Madame,	Je vous entends, Madame,
Vous voulez que je preſte un crime à voſtre flame;	Vous voulez que je prête un crime à votre flamme;
Et que mon propre bras à mon amour fatal,	Et que mon propre bras à mon amour fatal,
Perde voſtre Rivale, & ſerve mon Rival;	Perde votre Rivale, et serve mon Rival;
Bien loin de le haïr, ſon amour vous outrage,	Bien loin de le haïr, son amour vous outrage,
Et vous en ſoûpirez de douleur & de rage;	Et vous en soupirez de douleur et de rage;
Faites mieux. Puniſſez qui vous oſe outrager,	Faites mieux. Punissez qui vous ose outrager,
Et donnez à mon bras le ſoin de vous vanger;	Et donnez à mon bras le soin de vous venger;
Vous l'aimez, & l’Ingrat peut-il en aimer d’autres?	Vous l’aimez, et l’Ingrat peut-il en aimer d’autres?
Peut-on eſtre touché d'autres yeux que des voſtres?	Peut-on être touché d’autres yeux que des vôtres?
Madame, ſi ce Prince adoroit vos attraits,	Madame, si ce Prince adorait vos attraits,
Tout mon Rival qu’il eſt, je luy pardonnerois;	Tout mon rival qu’il est, je lui pardonnerais;
Mais pour luy pardonner vous n’avez point d’excuſe,	Mais pour lui pardonner vous n’avez point d’excuse,
Je luy veux arracher ce cœur qu’il vous refuſe,	Je lui veux arracher ce cœur qu’il vous refuse,
Et pour voir aujourd’huy ſes crimes expiez,	Et pour voir aujourd’hui ses crimes expiés,
Vous l’aporter ſanglant, & le mettre à vos pieds.	Vous l’apporter sanglant, et le mettre à vos pieds.
Je ne veux point, Seigneur, de pareilles Victimes,	Je ne veux point, Seigneur, de pareilles Victimes,
Un ſoûpir ſeul pouroit expier tous ſes crimes,	Un soupir seul pourrait expier tous ses crimes,
Vous m’aimez, je vous plains, je ne puis rien de plus.	Vous m’aimez, je vous plains, je ne puis rien de plus.
Ah Dieux! que Caſſander n’eſt il Leonatus,	Ah Dieux! Que Cassandre n’est-il Léonatus,
Ou que Leonatus changeant de coeur & d’ame,	Ou que Léonatus, changeant de cœur et d’âme,
N’a-t-il de Caſſander les tranſports & la flame?	N’a-t-il de Cassandre les transports et la flamme?
MAdame, Statira n’eſt plus dans le Palais,	MAdame, Statira n’est plus dans le Palais,
On vient de l’enlever par des ordres ſecrets,	On vient de l’enlever par des ordres secrets,
Pluſieurs Gardes gagnez ont fait cette ſurpriſe,	Plusieurs Gardes gagnés ont fait cette surprise,
Mais on ne connoît point l'Autheur de l'entrepriſe.	Mais on ne connaît point l’Auteur de l’entreprise.
Il périra, le Traiſtre. Allons, ſortons, Seigneur,	Il périra, le Traître. Allons, sortons, Seigneur,
Empeſchons....	Empêchons…
Demeurer, j'en puniray l’Auteur;	Demeurer, j'en punirai l’Auteur;
Mais peut-eſtre qu’auſſi par de fauſſes allarmes....	Mais peut-être qu’aussi par de fausses alarmes…
Non, Seigneur, Perdiccas a déjà pris les armes,	Non, Seigneur, Perdiccas a déjà pris les armes,
Et par un grand Combat pres de la Porte....	Et par un grand Combat près de la Porte…
Helas!	Hélas!
Seigneur, allez, courez ſoútenir Perdiccas,	Seigneur, allez, courez soutenir Perdiccas,
Prenez ma Garde encor, & joignez-y la voſtre,	Prenez ma Garde encore, et joignez-y la vôtre,
Partez....	Partez…
Voſtre intéreſt n’eſt que trop joint au noſtre,	>Votre intérêt n’est que trop joint au nôtre,
Repoſez vous ſur moy, Madame, & demeurez,	Reposez-vous sur moi, Madame, et demeurez,
J’y cours.	J’y cours.
Rendez le calme à mes ſens égarez;	Rendez le calme à mes sens égarés;
Sur tout, ſi vous m’aimez, Seigneur, quoyqu’il arrive,	Surtout, si vous m’aimez, Seigneur, quoiqu’il arrive,
S’il ſe peut, en ces lieux ramenez ma Captive.	S’il se peut, en ces lieux ramenez ma Captive.
LEonatus ſans-doute a formé ce deſſein,	LÉonatus sans doute a formé ce dessein,
Ce grand coup, Heſione, eſt party de ſa main,	Ce grand coup, Hésione, est parti de sa main,
Ils s’aiment, avecque elle il eſt d’intelligence,	Ils s’aiment, avec elle il est d’intelligence,
Et tantoſt ſa fierté marquoit ſon aſſurance.	Et tantôt sa fierté marquait son assurance.
Ciel! avec quelle audace il nous a demandé	Ciel! Avec quelle audace il nous a demandé
Ce que déja luy-meſme il s’eſtoit accordé?	Ce que déjà lui-même il s’était accordé?
Et ce Prince content & fier de ſa tendreſſe,	Et ce Prince content et fier de sa tendresse,
Parloit en Amant ſeúr du cœur de ſa Maiſtreſſe;	Parlait en Amant sûr du cœur de sa Maîtresse;
Mon amour en partant cent fois m'a ſçeu tenter,	Mon amour en partant cent fois m’a su tenter,
Contre le droit des Gens, de le faire arreſter,	Contre le droit des Gens, de le faire arrêter,
Mais il m'a prévenuë, & ſon ardeur fatale	Mais il m’a prévenue, et son ardeur fatale
Avec tout mon eſpoir m’enleve ma Rivale;	Avec tout mon espoir m’enlève ma Rivale;
Cependant on combat, Heſione, & je crains	Cependant on combat, Hésione, et je crains
Peut-eſtre qu’avec luy Perdiccas eſt aux mains;	Peut-être qu’avec lui Perdiccas est aux mains;
Peut-eſtre que.... Sortons, car je n’oſe me dire....	Peut-être que… Sortons, car je n’ose me dire…
Madame, Perdiccas va de tout vous inſtruire,	Madame, Perdiccas va de tout vous instruire,
Le voicy.	Le voici.
SCavez-vous que je viens d'arreſter	Savez-vous que je viens d'arrêter
Un cruel attentat preſt à s'exécuter?	Un cruel attentat prêt à s’exécuter?
J'ay repris Statira, Madame.	J’ai repris Statira, Madame.
Quelle joye!	Quelle joie!
Quoy, vous avez repris une ſi belle proye?	Quoi, vous avez repris une si belle proie?
Oüy, Madame, & la Reyne eſtoit preſte à ſortir,	Oui, Madame, et la Reine était prête à sortir,
Lors qu'un Garde fidelle eſt venu m’avertir:	Lorsqu’un Garde fidèle est venu m’avertir:
Auſſitoſt j’ay couru, ſuivy de quelque Eſcorte,	Aussitôt j’ai couru, suivi de quelque Escorte,
Quand l’infidelle Arbate a fait ouvrir la Porte.	Quand l’infidèle Arbate a fait ouvrir la Porte.
Là pluſieurs Gens armez apuyant-ſes deſſeins,	Là plusieurs Gens armés appuyant ses desseins,
Ont avancé vers nous, & ſont venus aux mains;	Ont avancé vers nous, et sont venus aux mains;
Mon amour a rendu ma fureur occupée,	Mon amour a rendu ma fureur occupée,
Arbate eſt le premier tombe ſous mon Epée;	Arbate est le premier tombé sous mon Épée;
Mais certain Inconnu, qui le Caſque abaiſſé,	Mais certain Inconnu, qui le Casque abaissé,
A travers mille Dards vers moy s’eſt élancé,	À travers mille dards vers moi s’est élancé,
Glaçant tous nos Soldats de ſes cris redoutables,	Glaçant tous nos Soldats de ses cris redoutables,
S’eſt fait jour parmy nous par des coups effroyables.	S’est fait jour parmi nous par des coups effroyables.
La Porte ſe referme; alors de toutes parts	La Porte se referme; alors de toutes parts
On tourne contre luy les Piques & les Dards;	On tourne contre lui les Piques et les Dards;
Les ſiens envelopez de tous coſtez ſuccombent,	Les siens enveloppés de tous côtés succombent,
Mais luy ſeul soútient tout quand tous les autres tombent:	Mais lui seul soutient tout quand tous les autres tombent:
Auſſitoſt j’ay couru reprendre Statira,	Aussitôt j’ai couru reprendre Statira,
Qui toute en pleurs....	Qui toute en pleurs…
Mais Dieux! l’Inconnu périra, Seigneur?	Mais Dieux! L’Inconnu périra, Seigneur ?
Non, non, Madame, & j'ay dit qu'on l'emmeine,	Non, non, Madame, et j’ai dit qu’on l’emmène,
De cette trahiſon il recevra la peine;	De cette trahison il recevra la peine;
J’en veux ſçavoir l’Auteur, j’en veux eſtre éclaircy,	J’en veux savoir l’Auteur, j’en veux être éclairci,
Sur tout j’ay commandé qu’on l’amenât icy,	Surtout j’ai commandé qu’on l’amenât ici,
Vous l’allez voir. A moins qu’un coup trop légitime	Vous l’allez voir. À moins qu’un coup trop légitime
N’ait déja fait payer la peine de ſon crime,	N’ait déjà fait payer la peine de son crime,
Il eſtoit tout couvert de ſang.	Il était tout couvert de sang.
Ciel! que d’efffoy?	Ciel! Que d’effroi?
Je tremble, je friſſonne & je ne ſçay pourquoy;	Je tremble, je frissonne, et je ne sais pourquoi;
Mais, Heſione, hélas! d’où vient que j’en ſoúpire?	Mais, Hésione, hélas! d’où vient que j’en soupire?
Il eſt couvert de ſang, & peut-eſtre il expire,	Il est couvert de sang, et peut-être il expire,
Il n’en faut plus douter; ah! regrets ſuperflus!	Il n’en faut plus douter; ah! regrets superflus!
Seigneur, vous avez fait périr Leonatus.	Seigneur, vous-avez fait périr Léonatus.
Seroit-ce luy, Madame?	Serait-ce lui, Madame?
Oüy, Seigneur, c'eſt luy-meſme;	Oui, Seigneur, c'est luy-même;
Statira, ſon amour, cette valeur ſupréme,	Statira, son amour, cette valeur suprême,
Tout me dit que c’eſt luy qu’on a ſçeu trop punir;	Tout me dit que c’est lui qu’on a su trop punir;
Enfin cet Inconnu tarde trop à venir;	Enfin cet Inconnu tarde trop à venir;
Il faut, pour diſſiper mes mortelles allarmes,	Il faut, pour dissiper mes mortelles alarmes,
Chercher cet Ennemy qui me coúte des larmes.	Chercher cet ennemi qui me coûte des larmes.
Ah! Dieux, d’un tel deſſein je demeure ſurpris;	Ah! Dieux, d’un tel dessein je demeure surpris;
Seroit-ce mon Rival enfin qui ſeroit pris?	Serait-ce mon Rival enfin qui serait pris?
Suivons Roxane, allons penétrer ce miſtere,	Suivons Roxane, allons pénétrer ce mystère,
Et voir ce que le Sort ou l’Amour ont pú faire.	Et voir ce que le Sort ou l’Amour ont pu faire.
CLEONE, en cet inſtant, quel eſpoir m'eſt permis?	CLÉONE, en cet instant, quel espoir m’est permis?
Leonatus eſt ſeul contre mille Ennemis;	Léonatus est seul contre mille Ennemis;
Preſſé de tous coſtez, à mille traits en bute,	Pressé de tous côtés, à mille traits en butte,
Quel ſecours, ou quel Dieu peut retarder ſa chute?	Quel secours, ou quel Dieu peut retarder sa chute?
Caſſander l'a trahy ſans-doute, & Perdiccas	Cassandre l’a trahi sans-doute, et Perdiccas
M'enferme en ce Palais, & vole à ſon trépas;	M’enferme en ce Palais, et vole à son trépas;
Son bras & ſa valeur l’ont trop fait reconnoître,	Son bras et sa valeur l’ont trop fait reconnaître,
On l'attaque, on le preſſe, il ſuccombe peut-eſtre;	On l’attaque, on le presse, il succombe peut-être;
Quelle horreur ſe répand dans mes ſens éperdus!	Quelle horreur se répand dans mes sens éperdus!
Mon Amant eſt Captif, ou peut-eſtre il n’eſt plus,	Mon Amant est captif, ou peut-être il n’est plus,
Son deſeſpoir marquoit ſa trop funeſte envie,	Son désespoir marquait sa trop funeste envie,
Il ne combatoit plus pour défendre ſa vie,	Il ne combattait plus pour défendre sa vie,
Et ſi-toſt qu’il a veu Perdiccas m'enlever,	Et sitôt qu’il a vu Perdiccas m’enlever,
Il a voulu la perdre, & non pas la ſauver.	Il a voulu la perdre, et non pas la sauver.
Dieux! le nombre l'accable, & ç'en eſt fait ſans doute,	Dieux! le nombre l’accable, et s’en est fait sans doute;
Voila ce qu'aujourd'huy ſa tendreſſe luy coûte;	Voilà ce qu’aujourd’hui sa tendresse lui coûte;
Cleone, chaque inſtant redouble mon effroy,	Cléone, chaque instant redouble mon effroi,
Les traits qui vont à luy ſemblent tomber ſur moy:	Les traits qui vont à lui semblent tomber sur moi,
C’eſt moy qui l'ay perdu, malheureuſe Princeſſe,	C’est moi qui l’ai perdu, malheureuse Princesse,
Pourquoy Leonatus eut-il tant de tendreſſe?	Pourquoi Léonatus eut-il tant de tendresse?
Sans mes coupables yeux il n’eut rien entrepris;	Sans mes coupables yeux il n’eut rien entrepris;
Faut-il qu’il en reçoive un ſi funeſte prix?	Faut-il qu’il en reçoive un si funeste prix?
Que ſon a me ait eſté pour moy trop enflâmée?	Que son âme ait été pour moi trop enflammée?
Il n'auroit point péry, s’il m'avoit moins aimée.	Il n’aurait point péri, s’il m’avait moins aimée.
Non, Madame, les Dieux prendrõt ſoin de ſes jours,	Non, Madame, les Dieux prendront soin de ses jours,
J'ay veu de loin voler Roxane à ſon ſecours,	J’ai vu de loin voler Roxane à son secours,
Son cœur (n’en doutez point) dãs ce péril extréme,	Son cœur (n’en doutez point) dans ce péril extrême,
L’entraîne & la cõduit pour ſauver ce qu’elle aime;	L’entraîne et la conduit pour sauver ce qu’elle aime;
Elle ſçaura calmer la fureur des Soldats,	Elle saura calmer la fureur des Soldats,
Et dérober ſa vie au fer de Perdiccas;	Et dérober sa vie au fer de Perdiccas;
Oüy, Madame, eſpérez....	Oui, Madame, espérez…
Eſpérance fatale!	Espérance fatale!
Quoy, mon Amant dévroit la vie à ma Rivale?	Quoi, mon Amant devrait la vie à ma Rivale?
Ciel, en me raſſurant, tu redoubles ma peur,	Ciel, en me rassurant, tu redoubles ma peur,
Et pour me conſoler, tu me perces le cœur.	Et pour me consoler, tu me perces le cœur.
Cruelle, voy mon ame également atteinte,	Cruelle, vois mon âme également atteinte,
Frémir de l'eſpérance autant que de la crainte,	Frémir de l’espérance autant que de la crainte,
L’une & l’autre m’accable, & me fait ſoûpirer;	L’une et l’autre m’accablent, et me font soupirer;
Hélas! que dois-je craindre, ou que dois-je eſpérer?	Hélas! que dois-je craindre, ou que dois-je espérer?
Mais je voy Perdiccas, & je crains de l'entendre,	Mais je vois Perdiccas, et je crains de l’entendre,
Il vient à nous.	Il vient à nous.
SEigneur, que venez-vous m’aprendre?	SEigneur, que venez-vous m’apprendre?
Avez-vous aſſouvy voſtre in juſte fureur?	Avez-vous assouvi votre injuste fureur?
Avez vous immolé, grands Dieux! mon Défenſeur,	Avez-vous immolé, grands Dieux! mon Défenseur,
Ce Héros qui pour moy....	Ce Héros qui pour moi…
Vous le pleuriez, Madame,	Vous le pleuriez, Madame,
Il eſt vivant. Je voy le plaiſir de voſtre ame,	Il est vivant. Je vois le plaisir de votre âme,
Et que vous aſſurant de ſes jours, je prévois	Et que vous assurant de ses jours, je prévois
Que vous m’écouterez pour la premiere fois.	Que vous m’écouterez pour la première fois.
Oüy dans l’heureux inſtant que je vous ay repriſe,	Oui, dans l’heureux instant que je vous ai reprise,
Et qu’il alloit payer ſa coupable entrepriſe,	Et qu’il allait payer sa coupable entreprise,
Que tout couvert du ſang de qui l’environnoit,	Que tout couvert du sang de qui l’environnait,
J’ay connu mon Rival aux grãds coups qu'il dõnoit,	J’ai connu mon Rival aux grands coups qu’il donnait,
Madame, je luy dois rendre ce témoignage,	Madame, je lui dois rendre ce témoignage,
Tout mon Rival qu'il eſt, j’admirois ſon courage,	Tout mon Rival qu’il est, j’admirais son courage,
Et preſt à le combatre, helas! j’eſtois jaloux	Et prêt à le combattre, hélas! j’étais jaloux
Que tout autre que moy voulut mourir pour vous.	Que tout autre que moi voulut mourir pour vous.
Mais Roxane en ces lieux par l’amour amenée,	Mais Roxane en ces lieux par l’amour amenée,
A ſuivy le panchant dont elle eſt entraînée,	A suivi le penchant dont elle est entraînée,
Et malgré mille traits s’eſtant miſe entre nous,	Et malgré mille traits s’étant mise entre nous,
A dérobé ſa vie à mon juſte couroux;	A dérobé sa vie à mon juste courroux;
Cependant pour ſes jours ne ſoyez plus en peine,	Cependant pour ses jours ne soyez plus en peine,
Ils ſont eu ſeûreté dans les mains delà Reyne.	Il sont en sûreté dans les mains de la Reine.
Vous frémiſſez, Madame, & voſtre joye enfin	Vous frémissez, Madame, et votre joie enfin
Se diſſipe & ſe change en un ſombre chagrin.	Se dissipe et se change en un sombre chagrin.
Dans les mains de Roxane il a voulu ſe rendre,	Dans les mains de Roxane il a voulu se rendre,
Luy, qui de mille Bras avoit pû ſe défendre;	Lui, qui de mille Bras avait pu se défendre;
Roxane ſeule, ah Dieux! l’a donc ſçeu deſarmer?	Roxane seule, ah Dieux! L’a donc su désarmer?
Par ſon amour peut-eſtre il s’eſt laiſſé charmer,	Par son amour peut-être il s’est laissé charmer,
Et voyant par mes ſoins ſon attente trompée,	Et voyant par mes soins son attente trompée,
Dans les mains de Roxane il a mis ſon Epée,	Dans les mains de Roxane il a mis son Épée,
Qui briſée à demy, marque de ſa valeur....	Qui brisée à demi, marque de sa valeur…
Il s’en devoit plonger les reſtes dans le cœur,	Il s’en devait plonger les restes dans le cœur,
Plutoſt que de la rendre à Roxane.	Plutôt que de la rendre à Roxane.
Madame,	Madame,
Ce Prince doit la vie à l’ardeur de ſa flame,	Ce Prince doit la vie à l’ardeur de sa flamme,
Sans l’amour de Roxane il alloit ſuccomber,	Sans l’amour de Roxane il allait succomber,
Et ſous ce bras peut-eſtre on l’auroit veu tomber;	Et sous ce bras peut-être on l’aurait vu tomber;
Mais il faut qu’il réponde à noſtre juſte envie,	Mais il faut qu’il réponde à notre juste envie,
Qu’il luy donne ſon cœur pour le prix de ſa vie;	Qu’il lui donne son cœur pour le prix de sa vie;
Ah Dieux! vous pâliſſez, Madame, à ce diſcours.	Ah Dieux! vous pâlissez, Madame, à ce discours.
Eſt-ce à vous à régler ſa fortune & ſes jours?	Est-ce à vous à régler sa fortune et ses jours?
Quoy, le ſang d’Alexandre eſt-il donc voſtre Eſclave?	Quoi, le sang d’Alexandre est-il donc votre Esclave?
Vous nous parlez en Maiſtre, & voſtre orgueil nous brave;	Vous nous parlez en Maître, et votre orgueil nous brave;
Et depuis quand, Seigneur, eſtes-vous noſtre Roy?	Et depuis quand, Seigneur, êtes-vous notre Roi?
Vous n’avez aucun droit ny ſur luy, ny ſur moy,	Vous n’avez aucun droit ni sur lui, ni sur moi,
Sur ſes jours cependant vous parlez d’entreprendre,	Sur ses jours cependant vous parlez d’entreprendre,
Vous oſez retenir la Veuve d’Alexandre,	Vous osez retenir la Veuve d’Alexandre,
Pour me donner les fers de ceux qu’il a vaincus?	Pour me donner des fers de ceux qu’il a vaincus?
C’eſt allez que je ſois Fille de Darius,	C’est assez que je sois Fille de Darius,
Et bien que je doive eſtre indépendante & Reyne,	Et bien que je doive être indépendante et Reine,
Le ſang de Darius eſtoit né pour la chaîne,	Le sang de Darius était né pour la chaîne,
Je le vois.	Je le vois.
Non, Madame, il eſt né pour régner,	Non, Madame, il est né pour régner,
Le Trône de la Perſe eſt-il à dédaigner,	Le Trône de la Perse est-il à dédaigner,
Je vous l'offre.... Mais Dieux! je voy qu’on me mépriſe,	Je vous l’offre… Mais Dieux! je vois qu’on me méprise,
Que de Leonatus voſtre ame eſt trop épriſe,	Que de Léonatus votre âme est trop éprise,
Il n’en faut plus douter, mon Rival eſt heureux,	Il n’en faut plus douter, mon Rival est heureux,
J’ay gémy trop longtemps, & j’ay trop fait de vœux,	J’ai gémi trop longtemps, et j’ai trop fait de vœux,
Je connois voſtre amour par voſtre jalouſie,	Je connais votre amour par votre jalousie,
Madame, cet amour luy peut coûter la vie,	Madame, cet amour lui peut coûter la vie,
Il eſt entre nos mains ce Rival fortuné,	Il est entre nos mains ce Rival fortuné,
Voyez à quels malheurs il ſera deſtiné,	Voyez à quels malheurs il sera destiné,
Il y va d’un Empire, il y va de vous-meſme,	Il y va d’un Empire, il y va de vous-même,
Je ſuis le malheureux, on me mépriſe, on l’aime;	Je suis le malheureux, on me méprise, on l’aime;
Mais ſi vous dédaignez mes ſoûpirs & ma foy.	Mais si vous dédaignez mes soupirs et ma foi.
Je puis enſevelir mon Rival avec moy.	Je puis ensevelir mon Rival avec moi.
Ah! je vois que pour luy voſtre ame eſt allarmée,	Ah! Je vois que pour lui votre âme est alarmée,
Et la mienne eſt de rage & d’amour enflamée.	Et la mienne est de rage et d’amour enflammée.
Roxane va venir; mais ſans vous étonner,	Roxane va venir; mais sans vous étonner,
Pour luy, ſuivez l’avis qu’elle doit vous donner,	Pour lui, suivez l’avis qu’elle doit vous donner,
Il faut que voſtre cœur deſormais l’abandonne,	Il faut que votre cœur désormais l’abandonne,
Et ſur tout que dans peu Roxane le couronne.	Et surtout que dans peu Roxane le couronne.
C’eſt vous en dire aſſez. Adieu, Madame.	C’est vous en dire assez. Adieu, Madame.
Helas!	Hélas!
Qu’entens-je? que dit-il? quel afreux embaras!	Qu’entends-je? que dit-il? Quel affreux embarras!
Pour ce Prince, Cleone, à peine je reſpire,	Pour ce Prince, Cléone, à peine je respire,
Que l’on m’aprend qu’il faut.... Ah! mon cœur en ſoûpire,	Que l’on m’apprend qu’il faut… Ah! mon cœur en soupire,
Et Perdiccas (d’horreur je m’en ſens friſſonner)	Et Perdiccas (d’horreur je m’en sens frissonner)
Ne luy laiſſe le jour que pour m’abandonner.	Ne lui laisse le jour que pour m’abandonner.
Vois donc à quels malheurs le Deſtin me cõdamne,	Vois donc à quels malheurs le Destin me condamne,
Verray-je mon Amant couronné par Roxane?	Verrai-je mon amant couronné par Roxane?
Verray-je Perdiccas l’immoler... Que d’effroy!	Verrai-je Perdiccas l’immoler… Que d’effroi!
Mais s’il vit pour Roxane, eſt-il pas mort pour moy?	Mais s’il vit pour Roxane, est-il pas mort pour moi?
Ne craignez rien, Madame, il vous ſera fidelle,	Ne craignez rien, Madame, il vous sera fidèle,
Ce Prince, qui pour vous....	Ce Prince, qui pour vous…
Helas! Roxane eſt belle,	Hélas! Roxane est belle,
Leonatus a veu pour luy ce qu’elle a fait.	Léonatus a vu pour lui ce qu’elle a fait.
Dieux! ne l’a-t-elle pas deſarmé tout-à-fait?	Dieux! ne l’a-t-elle pas désarmé tout-à-fait?
Peut-eſtre qu’ébloüy de l’éclat de ſes charmes,	Peut-être qu’ébloui de l’éclat de ses charmes,
Ce n’eſt qu'à ſa beauté qu’il a rendu les armes;	Ce n’est qu’à sa beauté qu’il a rendu les armes;
Peut-eſtre que touché de ſon empreſſement,	Peut-être que touché de son empressement,
Il oublie à ſes pieds qu’il eſtoit mon Amant;	Il oublie à ses pieds qu’il était mon Amant;
Elle eſt belle, elle l’aime; ah que de jalouſie!	Elle est belle, elle aime; ah que de jalousie!
Des mains de Perdiccas elle a ſauvé ſa vie,	Des mains de Perdiccas elle a sauvé sa vie,
Il peut eſtre atendry d’un amour ſi preſſant,	Il peut être attendri d’un amour si pressant,
Cleone, ſi ſon cœur eſtoit reconnoiſſant?	Cléone, si son cœur était reconnaissant?
Ciel! de quel ſouvenirmon ame eſt combatuë!	Ciel! de quel souvenir mon âme est combattue!
Ma Rivale le ſauve, & c’eſt moy qui le tuë,	Ma Rivale le sauve, et c’est moi qui le tue,
C’eſt moy qui l’ay conduit dans cet inſtant fatal,	C’est moi qui l’ai conduit dans cet instant fatal,
Dans les bras d’une Amante, & dans ceux d’un Rival.	Dans les bras d’une Amante, et dans ceux d’un Rival.
Mais Roxane paroît; que j’en ſuis allarmée!	Mais Roxane paraît; que j’en suis alarmée!
Elle a l’air trop content pour n’eſtre pas aimée.	Elle a l’air trop content pour n’être pas aimée.
VOus me devez icy quelque remercîment,	VOus me devez ici quelque remerciement,
Madame, j’ay ſauvé le jour à voſtre Amant;	Madame, j’ai sauvé le jour à votre Amant;
Vous voyez de quel air pour vous je m'intéreſſe:	Vous voyez de quel air pour vous je m’intéresse:
Mais, Madame, d’où vient cette ſombre triſteſſe?	Mais, Madame, d’où vient cette sombre tristesse?
Eſtoit-ce pour vos yeux un ſpéctacle plus doux,	Était-ce pour vos yeux un spectacle plus doux,
De voir Leonatus preſt à mourir pour vous?	De voir Léonatus prêt à mourir pour vous?
Il eut mieux par ſa mort ſignalé ſa tendreſſe;	Il eut mieux par sa mort signalé sa tendresse;
Mais c’eſt pouſſer trop loin voſtre délicateſſe,	Mais c’est pousser trop loin votre délicatesse,
Je vous viens d’épargner de ſenſibles regrets,	Je vous viens d’épargner de sensibles regrets,
Nous avons un Oſtage aſſuré de la Paix;	Nous avons un Otage assuré de la Paix;
Pour peu qu’à mes deſſeins ſa prudence réponde,	Pour peu qu’à mes desseins sa prudence réponde,
Nous allons diſpoſer de l’Empire du Monde.	Nous allons disposer de l’Empire du Monde.
Madame, je prens part à ce rare bonheur,	Madame, je prends part à ce rare bonheur,
Mais avez-vous déja diſpoſé de ſon cœur?	Mais avez-vous déjà disposé de son cœur?
Vous eſtes genéreuſe, il eſt vray, je l’avouë,	Vous êtes généreuse, il est vrai, je l’avoue,
Ce que vous avez fait mérité qu’on vous louë;	Ce que vous avez fait mérite qu’on vous loue;
Il vous doit tout enfin... Mais, Madame, entre nous,	Il vous doit tout enfin… Mais, Madame, entre nous,
Vous l’avez cõſervé moins pour moy que pour vous.	Vous l’avez conservé moins pour moi que pour vous.
J’ay fait ce que j’ay dû, mais à parler ſans feindre,	J’ai fait ce que j’ai dû, mais à parler sans feindre,
Madame, pour ſes jours un Rival eſt à craindre;	Madame, pour ses jours un Rival est à craindre;
Un Rival mépriſé, jaloux, & furieux,	Un Rival méprisé, jaloux, et furieux,
Peut le faire expirer malgré nous à nos yeux:	Peut le faire expirer malgré nous à nos yeux:
Je l’ay veu, ſa fureur m’a paru ſans égale,	Je l’ai vu, sa fureur m’a paru sans égale,
Et pour moy ſi j’aimois, que j’euſſe une Rivale,	Et pour moi si j’aimais, que j’eusse une Rivale,
Mon plaiſir le plus doux, je ne puis le celer,	Mon plaisir le plus doux, je ne puis le celer,
Ce ſeroit à mes yeux de la faire immoler;	Ce serait à mes yeux de la faire immoler;
J’entre dans ſes tranſports, & connois ſa tendreſſe,	J’entre dans ses transports, et connais sa tendresse,
C’eſt pour Leonatus que ma crainte vous preſſe,	C’est pour Léonatus que ma crainte vous presse,
Perdiccas eſt puiſſant, Madame, & vos refus	Perdiccas est puissant, Madame, et vos refus
Vont faire malgré nous périr Leonatus.	Vont faire malgré nous périr Léonatus.
Je ne répons de rien dans ſa fureur extréme.	Je ne réponds de rien dans sa fureur extrême.
Moy, je répons de tout, puis que Roxane l’aime,	Moi, je réponds de tout, puis que Roxane l’aime,
Il eſt entre vos mains, Madame, c’eſt aſſez,	Il est entre vos mains, Madame, c’est assez,
Il eſt en ſeûreté plus que vous ne penſez.	Il est en sûreté plus que vous ne pensez.
Non, ce n’eſt pas aſſez pour aſſurer ſa vie,	Non, ce n’est pas assez pour assurer sa vie,
Il faut qu’à Perdiccas Starira ſoit unie.	Il faut qu’à Perdiccas Statira soit unie.
Moy, Madame?	Moi, Madame?
Oüy, vous. C’eſt l’unique moyen	Oui, vous. C’est l’unique moyen
De retenir ſon bras auſſi-bien que le mien;	De retenir son bras aussi-bien que le mien;
Sans balancer, Madame, il faut qu’il vous épouſe,	Sans balancer, Madame, il faut qu’il vous épouse,
Perdiccas eſt jaloux, & Roxane eſt jalouſe;	Perdiccas est jaloux, et Roxane est jalouse;
Mais ce n’eſt pas aſſez: je viens vous avertir	Mais ce n’est pas assez: je viens vous avertir
Qu’aux yeux de voſtre Amant il y faut conſentir;	Qu’aux yeux de votre Amant il y faut consentir;
J’attens Leonatus, & c’eſt en ma préſence	J’attends Léonatus, et c’est en ma présence
Qu’il vous faut accepter une telle alliance,	Qu’il vous faut accepter une telle alliance,
Qu'il faut le recevoir avecque un air glacé,	Qu’il faut le recevoir avec un air glacé,
Qu'avec luy le préſent démente le paſſé;	Qu’avec lui le présent démente le passé;
De concert avec moy Perdiccas ſçait l'inſtruire	De concert avec moi Perdiccas sait l’instruire
Que voſtre cœur conſent à l’Hymen qu’il deſire;	Que votre cœur consent à l’Hymen qu’il désire;
Il va venir ſans-doute, inquiet, allarmé,	Il va venir sans-doute, inquiet, alarmé,
Mais il faut que par vous cet Hymen confirmé....	Mais il faut que par vous cet Hymen confirmé…
Quoy? je pourois pour luy....	Quoi? je pourrais pour lui…
Du moins il faut le feindre;	Du moins il faut le feindre;
Pour luy, pour vous, pour moy, vous avez tout à craindre;	Pour lui, pour vous, pour moi, vous avez tout à craindre;
Vous m'entendez, ſongez qu’en ce fatal moment	Vous m’entendez, songez qu’en ce fatal moment
Vous allez cécider du ſort de voſtre Amant;	Vous allez décider du sort de votre Amant;
Vous avez dans vos mains voſtre vie & la ſienne,	Vous avez dans vos mains votre vie et la sienne,
Celle de Perdiccas auſſi bien que la mienne,	Celle de Perdiccas aussi bien que la mienne,
Et ſi nous n’avons pas ce que nous chériſſons,	Et si nous n’avons pas ce que nous chérissons,
Nous pourons perdre au moins ce que nous haïſſons;	Nous pourrons perdre au moins ce que nous haïssons;
Songez par des froideurs à préparer ſon ame,	Songez par des froideurs à préparer son âme,
A changer comme vous & d’objet & de flame,	À changer comme vous et d’objet et de flamme,
Ou tremblez....	Ou tremblez…
Hé, mon cœur pouroit-il obeïr?	Hé, mon cœur pourrait-il obéir?
Mes yeux & mes ſoúpirs, tout ſçaura me trahir.	Mes yeux et mes soupirs, tout saura me trahir.
Dois-je faire à mes feux l'indigne violence?...	Dois-je faire à mes feux l’indigne violence?…
Vos feux, de Perdiccas armeront la vangeance;	Vos feux, de Perdiccas armeront la vengeance;
Mais croyez-moy, feignez, il y va de vos jours.	Mais croyez-moi, feignez, il y va de vos jours.
Cruelle, faudra-t-il que je feigne toûjours?	Cruelle, faudra-t-il que je feigne toujours?
Peut-eſtre que ſa mort ſçaura moins vous cõtraindre,	Peut-être que sa mort saura moins vous contraindre,
Et Perdiccas....	Et Perdiccas…
Hé bien? Il faut tâcher de feindre;	Hé bien? Il faut tâcher de feindre;
Dieux! il vient; ah ſortons.	Dieux! il vient; ah sortons.
Madame, demeurez,	Madame, demeurez,
Et ſongez bien ſur tout à ce que vous direz.	Et songez bien surtout à ce que vous direz.
JE ne ſuis point, Madame, accablé de ma chûte,	JE ne suis point, Madame, accablé de ma chute,
A de plus grands malheurs je vois mon ame en bute,	À de plus grands malheurs je vois mon âme en butte,
Je pers la liberté, c’eſt un leger revers;	Je perds la liberté, c’est un léger revers;
Mais, Madame, on m’aprẽd de plus, que je vous pers.	Mais, Madame, on m’apprend de plus, que je vous perds.
Vous me voyez ſurpris d’une étrange nouvelle,	Vous me voyez surpris d’une étrange nouvelle,
Elle vient cependant d’une bouche fidelle,	Elle vient cependant d’une bouche fidèle,
Perdiccas me l’aſſure, & c’eſt luy dont je tiens	Perdiccas me l’assure, et c’est lui dont je tiens
Que l’Hymen doit unir vos feux avec les ſiens;	Que l’Hymen doit unir vos feux avec les siens;
J'auray peine à le croire, à moins que voſtre bouche	J’aurais peine à le croire, à moins que votre bouche
Ne confirme elle-meſme un Arreſt qui me touche;	Ne confirme elle-même un Arrêt qui me touche;
Parlez, qu’en dites vous?... Vous ne répondez pas,	Parlez qu’en dites-vous?… Vous ne répondez pas,
Madame.... Juſte Ciel! croiray-je Perdiccas?	Madame… Juste Ciel! croirai-je Perdiccas?
Sans trop vous expliquer icy ce que je penſe,	Sans trop vous expliquer ici ce que je pense,
Vous devriez, Seigneur, entendre mon ſilence.	Vous devriez, Seigneur, entendre mon silence.
Je ne l’entens que trop ce ſilence odieux,	Je ne l’entends que trop ce silence odieux,
Mon Rival a charmé voſtre cœur & vos yeux.	Mon Rival a charmé votre cœur et vos yeux.
Ah! tantoſt j’en frémis; avec quelle tendreſſe	Ah! tantôt j’en frémis; avec quelle tendresse
A-t-il volé luy-meſme aupres de ſa Maiſtreſſe?	A-t-il volé lui-même auprès de sa Maîtresse?
De quel feu ſon viſage eſtoit-il enflamé!	De quel feu son visage était-il enflammé!
Il combatoit trop bien, pour n’eſtre pas aimé.	Il combattait trop bien, pour n’être pas aimé.
Quoy, Madame, ſes ſoins pendant ma lõgue abſence	Quoi, Madame, ses soins pendant ma longue absence
Ont-ils.... Garderez-vous ce funeſte ſilence,	Ont-ils… Garderez-vous ce funeste silence,
Madame?	Madame?
Helas!	Hélas!
Seigneur, elle a d’autres deſſeins,	Seigneur, elle a d’autres desseins,
Il faut qu’elle aime ailleurs; vous l’aimez, je vous plains.	Il faut qu’elle aime ailleurs; vous l’aimez, je vous plains.
Je vous entens, Madame, & la Reyne infidelle	Je vous entends, Madame, et la Reine infidèle
Me ſacrifie apres ce que j’ay fait pour elle.	Me sacrifie après ce que j’ai fait pour elle.
Quand on ſe taiſt helas! c’eſt parler à demy;	Quand on se tait hélas! c’est parler à demi;
Dieux! elle me préfere un mortel Ennemy,	Dieux! elle me préfère un mortel Ennemi,
A ſon cœur Perdiccas malgré moy peut prétendre,	À son cœur Perdiccas malgré moi peut prétendre,
Moy qui n’eus autrefois pour Rival qu'Alexandre;	Moi qui n’eus autrefois pour Rival qu’Alexandre;
A moy-meſme pour vous je l’avois préféré,	À moi-même pour vous je l’avais préféré,
Cependant voſtre cœur en avoit ſoûpiré,	Cependant votre cœur en avait soupiré,
Et ces tendres ſoúpir, où mon eſpoir ſe fonde,	Et ces tendres soupirs, où mon espoir se fonde,
Me rendoient plus heureux que le Maître du Monde.	Me rendaient plus heureux que le Maître du Monde.
Il m’en ſouvient helas! mais vous en ſoupirez,	Il m’en souvient hélas! mais vous en soupirez,
Que vois-je, juſtes Dieux! Madame, vous pleurez,	Que vois-je, juste Dieux! Madame, vous pleurez,
Pourquoy me cachez-vous ces larmes que j’adore?	Pourquoi me cachez-vous ces larmes que j’adore?
Mais quel eſt ce miſtere, & faut-il que j’ignore....	Mais quel est ce mystère, et faut-il que j’ignore…
Un ſecret....	Un secret…
Non, Seigneur, ne vous y trompez pas,	Non, Seigneur, ne vous y trompez pas,
Au nom des Dieux, croyez que j’aime Perdiccas.	Au nom des Dieux, croyez que j’aime Perdiccas.
Ah! ç’en eſt trop, cruelle, & cet aveu funeſte	Ah! c’en est trop, cruelle, et cet aveu funeste
Arrache de mon cœur tout l’amour qui luy reſte:	Arrache de mon cœur tout l’amour qui lui reste:
Et, Madame, tantoſt pourquoy voſtre ſecours	Et, Madame, tantôt pourquoi votre secours
Vous fiſt-il épargner de ſi malheureux jours?	Vous fit-il épargner de si malheureux jours?
On ne m’a conſervé, (quelle pitié cruelle!)	On ne m’a conservé, (quelle pitié cruelle!)
Que pour voir aujourd’huy ma Princeſſe infidelle,	Que pour voir aujourd’hui ma Princesse infidèle,
Et l’on prétend encor par un Hymen fatal	Et l’on prétend encor par un Hymen fatal
M’atacher en triomphe au Char de mon Rival;	M’attacher en triomphe au Char de mon Rival;
Au lieu de m’acabler d’une importune vie,	Au lieu de m’accabler d’une importune vie,
Rendez-moy cette mort que vous m’avez ravie.	Rendez-moi cette mort que vous m’avez ravie.
Le jour que de ma main vous devez accepter,	Le jour que de ma main vous devez accepter,
Ne vous fuſt pas rendu, Seigneur, pour vous l’oſter.	Ne vous fut pas rendu, Seigneur, pour vous l’ôter.
Non, ſans-doute la vie a pour vous trop de charmes,	Non, sans-doute la vie a pour vous trop de charmes,
Vous la devez à qui vous rendites les armes.	Vous la devez à qui vous rendîtes les armes.
Madame, mon amour deſeſperé, jaloux,	Madame, mon amour désespéré, jaloux,
Ne m’a rendu Captif que pour l’eſtre avec vous;	Ne m’a rendu Captif que pour l’être avec vous;
J’avois fait mes efforts pour briſer voſtre chaîne,	J’avais fait mes efforts pour briser votre chaîne,
Je n’ay pû. J’avois crû qu’une mort plus certaine	Je n’ai pu. J’avais crû qu’une mort plus certaine
M’afranchiroit du moins des maux que j'ay ſoufers;	M’affranchirait du moins des maux que j’ai souffert;
Mais n’ayant pû mourir, j’ay partagé vos fers,	Mais n’ayant pu mourir, j’ai partagé vos fers,
Et trouvois pres de vous, perdant toute eſpérance,	Et trouvais prés de vous, perdant toute espérance,
L’eſclavage, ou la mort moins cruels que l’abſence.	L’esclavage, ou la mort, moins cruels que l’absence.
Mais je vous parle en vain, & j’ay beau proteſter,	Mais je vous parle en vain, et j’ai beau protester,
Ciel! vous ne voulez pas ſeulement m’écouter,	Ciel! vous ne voulez pas seulement m’écouter,
Cependant vous pleurez, oüy, Madame, & je doute...	Cependant vous pleurez, oui, Madame, et je doute…
Croyez tout, & tremblez que je ne vous écoute.	Croyez tout, et tremblez que je ne vous écoute.
Hé bien, je croiray tout, puis que vous le voulez;	Hé bien, je croirai tout, puisque vous le voulez;
Aux feux de Perdiccas les miens ſont immoſez,	Aux feux de Perdiccas les miens sont immolés,
Vous haïſſez la Reyne Ah! ſi j’oſois, Madame,	Vous haïssez la Reine. Ah! si j’osais, Madame,
Vous donner à ſes yeux & mon cœur & mon ame,	Vous donnez à ses feux et mon cœur et mon âme,
Si ce cœur mépriſé ne l’eſtoit pas de vous....	Si ce cœur méprisé ne l’était pas de vous…
Que faites-vous, Seigneur, dans ce tranſport jaloux?	Que faites-vous, Seigneur, dans ce transport jaloux?
Et n’entendez-vous pas un langage ſi tendre?	Et n’entendez-vous pas un langage si tendre?
Mais que dis-je, grands Dieux! je me fais trop enendre:	Mais que dis-je, grands Dieux! je me fais trop entendre:
Dûſſay-je cependant irriter ſon eſprit,	Dussé-je cependant irriter son esprit,
Seigneur, ne croyez rien de tout ce que j'ay dit.	Seigneur, ne croyez rien de tout ce que j’ai dit.
Dieux! que veut-elle dire? &quelle eſt ſa cõtrainte?	Dieux! que veut-elle dire? Et quelle est sa contrainte?
Eſt-ce une verité, Madame, eſt-ce une feinte?	Est-ce une vérité, Madame, est-ce une feinte?
Elle dit devant vous qu’elle aime Perdiccas,	Elle dit devant vous qu’elle aime Perdiccas,
Mais ſes pleurs, ſes ſoûpirs, ne me le diſent pas;	Mais ses pleurs, ses soupirs, ne me le disent pas;
De grace, expliquez-moy cet étrange miſtere.	De grâce, expliquez-moi cet étrange mystère.
Elle n’a que trop dit ce qu’elle devoit taire,	Elle n’a que trop dit ce qu’elle devait taire,
Et lors que voſtre cœur a trop ſçeu l’écouter,	Et lorsque votre cœur a trop su l’écouter,
Ses pleurs & ſes ſoûpirs pouront vous en coûter.	Ses pleurs et ses soupirs pourront vous en coûter.
Mais Seigneur, il eſt temps que Roxane s’explique,	Mais Seigneur, il est temps que Roxane s’explique,
La fiere Statira détruit ma politique;	La fière Statira détruit ma politique;
Si ma haine contre elle a pû vous étonner,	Si ma haine contre elle a pu vous étonner,
J’aime, j’adore.... un Fils que je veux couronner:	J’aime, j’adore… un Fils que je veux couronner:
Elle prétend, Seigneur, régner dans Babylone,	Elle prétend, Seigneur, régner dans Babylone,
Elle eſt contre mon Fils, ma Rivale a ce Trône,	Elle est contre mon fils, ma Rivale à ce Trône,
Nos deſſeins ſont pareils, nos intéreſts égaux,	Nos desseins sont pareils, nos intérêts égaux,
Mais le Trône, Seigneur, ne veut point de Rivaux,	Mais le Trône, Seigneur, ne veut point de Rivaux,
Je ne la puis ſoufrir, je la hais, & je tremble....	Je ne la puis souffrir, je la hais, et je tremble…
Ah! Madame, je vais vous réünir enſemble,	Ah! Madame, je vais vous réunir ensemble,
J’y feray conſentir tous nos Chefs avec nous,	J’y ferai consentir tous nos Chefs avec nous,
Randez moy Satira, Babylone eſt à vous.	Rendez-moi Statira, Babylone est à vous.
Vous la rendre, Seigneur? Avant que m'y réſoudre,	Vous la rendre, Seigneur? Avant que m’y résoudre,
On verra ce Palais & Babylone en poudre;	On verra ce Palais et Babylone en poudre;
Trahirois-je un Amy qui me preſte ſon bras?	Trahirais-je un Ami qui me prête son bras?
Ce ſeroit me trahir, que trahir Perdiccas;	Ce serait me trahir, que trahir Perdiccas;
Il aime Statira quand Roxane l’abhorre;	Il aime Statira quand Roxane l’abhorre;
Elle ne vit qu’autant que Perdiccas l’adore,	Elle ne vit qu’autant que Perdiccas l’adore,
Il prend mes intéreſts, je dois prendre les ſiens,	Il prend mes intérêts, je dois prendre les siens,
Et ſans-doute ils me ſont auſſi chers que les miens.	Et sans-doute ils me sont aussi chers que les miens.
Madame, j’avois crû que cédant Babylone,	Madame, j’avais cru que cédant Babylone,
Vous borniez vos deſirs à l’eſpoir de ce Trône;	Vous borniez vos désirs à l’espoir de ce Trône;
Mais quoy? de Perdiccas les intéreſts trahis	Mais quoi? de Perdiccas les intérêts trahis
Vous ſeront-ils plus chers que ceux de voſtre Fils?	Vous seront-ils plus chers que ceux de votre Fils?
Seigneur, à ce diſcours faut-il que je réponde?	Seigneur, à ce discours faut-il que je réponde?
Un cœur m’eſtoit plus cher que l’Empire du Monde;	Un cœur m’était plus cher que l’Empire du Monde;
Vous m'entẽdez... mais non, vous ne m'entẽdez pas,	Vous m’entendez… mais non, vous ne m’entendez pas,
Vos yeux cherchent l’objet des feux de Perdiccas;	Vos yeux cherchent l’objet des feux de Perdiccas;
Egarez & diſtraits, il vous ſouvient à peine	Égarés et distraits, il vous souvient à peine
Que je ſuis devant vous, que je ſuis voſtre Reyne;	Que je suis devant vous, que je suis votre Reine;
Il eſt vray, j’oubliois & ma gloire & mon Fils,	Il est vrai, j’oubliais et ma gloire et mon Fils,
Pour le ſeul Perdiccas mon cœur les a trahis;	Pour le seul Perdiccas mon cœur les a trahis;
Mais ſoútenons le nom de Veuve d’Aléxandre,	Mais soutenons le nom de Veuve d’Alexandre,
A ce grand ſouvenir Roxane doit ſe rendre,	À ce grand souvenir Roxane doit se rendre,
Et pour placer ſon Fils au Trône de Cyrus,	Et pour placer son fils au Trône de Cyrus,
Achevons d’immoler le ſang de Darius.	Achevons d’immoler le sang de Darius.
Eh! contre Starira quelle fureur extréme?	Eh! contre Statira quelle fureur extrême?
Vous ne la haïſſez que parce que je l’aime;	Vous ne la haïssez que parce que je l’aime;
Faiſant tomber ſur elle un injuſte couroux,	Faisant tomber sur elle un injuste courroux,
C’eſt moins elle que moy qu’on veut percer de coups,	C’est moins elle que moi qu’on veut percer de coups,
Voſtre haine pour moy fuſt toûjours ſans égale....	Votre haine pour moi fut toujours sans égale…
Oüy, je te haïs, Ingrat, autant que ma Rivale:	Oui, je te hais, Ingrat, autant que ma Rivale:
Mais que dis je, grands Dieux! en ce fatal moment,	Mais que dis-je, grands Dieux! en ce fatal moment,
Quand on hait la Rivale, eſt-ce haïr l’Amant?	Quand on hait la Rivale, est-ce haïr l’amant?
Mais, enfin, devant toy Roxane s’eſt trahie,	Mais, enfin, devant toi Roxane s’est trahie,
Perdiccas eſt hay, j’aime, & je ſuis haïe;	Perdiccas est haï, j’aime, et je suis haïe;
Je vais voir ton Rival; avant la fin du jour,	Je vais voir ton Rival; avant la fin du jour,
Si nous n’eſpérons plus du coſté de l’Amour,	Si nous n’espérons plus du côté de l’Amour,
Ayant entre nos mains la vangeance certaine,	Ayant entre nos mains la vengeance certaine,
Du moins nous joüirons des fureurs de la haine.	Du moins nous jouirons des fureurs de la haine.
Gardes, qu’on le remeine à ſon Apartement.	Gardes, qu’on le remmène à son Appartement.
De grace, helas! Madame, arreſtez un moment;	De grâce, hélas! Madame, arrêtez un moment;
Elle fuit. Je vois trop ſa fatale tendreſſe...	Elle fuit. Je vois trop sa fatale tendresse…
Ciel! pers moy ſi tu veux, mais ſauve ma Princeſſe.	Ciel! perds-moi si tu veux, mais sauve ma Princesse.
OUY, Seigneur, Caſſander m'envoye aupres de vous,	Oui, Seigneur, Cassandre m’envoie auprès de vous,
Pour apaiſer Roxane, & fléchir ſon couroux;	Pour apaiser Roxane, et fléchir son courroux;
On ſçait qu’Antipater vient avecque une Armée,	On sait qu’Antipater vient avec une Armée,
Et qu’ils pouroient tous deux ſe joindre à Ptolomée;	Et qu’ils pourraient tous deux se joindre à Ptolomée;
Mais il aime Roxane, & ſon cœur incertain	Mais il aime Roxane, et son cœur incertain
Ne peut contre elle encor former aucun deſſein;	Ne peut contre elle encore former aucun dessein;
Cependant Seleucus, Eumenes, & mille autres,	Cependant Seleucus, Eumenes, et mille autres,
Prenant ſes intéreſts, peuvent quiter les voſtres.	Prenant ses intérêts, peuvent quitter les vôtres.
Je le ſçais, Peuceſtas, & le Ciel en couroux	Je le saïs, Peucestas, et le Ciel en courroux
Dans le meſme malheur nous envelope tous;	Dans le même malheur nous enveloppe tous;
Aléxandre luy-meſme avoit ſçeu le prédire,	Alexandre lui-même avait su le prédire,
Et s’il n’a pas reglé le deſtin de l’Empire,	Et s’il n’a pas réglé le destin de l’Empire,
Ou s’il n’a pas oſé nommer un Succeſleur,	Ou s’il n’a pas osé nommer son Successeur,
C’eſt qu’il n’en pût trouver digne de cet honneur;	C’est qu’il n’en pût trouver digne de cet honneur;
Il l’avoit bien préveu, par des crimes celebres	Il l’avait bien prévu, par des crimes célèbres
On luy va préparer d’étranges jeux funebres,	On lui va préparer d’étranges jeux funèbres,
Quand tous nos Chefs rangez, de diférens Partis,	Quand tous nos Chefs rangés, de différends Partis,
Du monde chancelant vont hâter le débris;	Du monde chancelant vont hâter le débris;
Nous y travaillons tous, en vain tu t’en étonnes,	Nous y travaillons tous, en vain tu t’en étonnes,
Le Ciel ordonne ainſi du deſtin des Couronnes.	Le Ciel ordonne ainsi du destin des Couronnes.
Les Barbares, Seigneur, pouroient bien profiter	Les Barbares, Seigneur, pourraient bien profiter
Des troubles dangereux qui vont vous agiter,	Des troubles dangereux qui vont vous agiter,
Ils pouroient aſſembler des Troupes effroyables,	Ils pourraient assembler des Troupes effroyables,
Telles que Darius....	Telles que Darius…
Ces Troupes innombrables,	Ces Troupes innombrables,
Qui tant & tant de fois porterent nos liens,	Qui tant et tant de fois portèrent nos liens,
N’ont jamais étonné les Macédoniens;	N’ont jamais étonné les Macédoniens;
Les Barbares, croy-moy, ne peuvent plus nous nuire,	Les Barbares, crois-moi, ne peuvent plus nous nuire,
Nous ſeuls pouvons nous vaincre, & pouvons nous détruire;	Nous seuls pouvons nous vaincre, et pouvons nous détruire;
Mais j’abandonne icy le ſoin de ma grandeur,	Mais j’abandonne ici le soin de ma grandeur,
Starira, je l’avouë, occupe tout mon cœur,	Statira, je l’avoue, occupe tout mon cœur,
C’eſt le ſeul intéreſt où Perdicas s’aplique,	C’est le seul intérêt où Perdicas s’applique,
Un Amant en fureur eſt mauvais Politique,	Un Amant en fureur est mauvais Politique,
Et négligeant la guerre en ce funeſte jour,	Et négligeant la guerre en ce funeste jour,
Je ne ſuis occupe que des ſoins de l’amour.	Je ne suis occupé que des soins de l’amour.
Mon Rival eſt aimé, ma fatale victoire	Mon Rival est aimé, ma fatale victoire
Ne tourne qu’à ma honte, & ne ſert qu’à ſa gloire,	Ne tourne qu’à ma honte, et ne sert qu’à sa gloire,
Roxane apuye en vain mes projets & les ſiens,	Roxane appuie en vain mes projets et les siens,
Mais il va décider de ſes jours & des miens;	Mais il va décider de ses jours et des miens;
Roxane pour ſervir ſa flame & ma tendreſſe,	Roxane pour servir sa flamme et ma tendresse,
Voudroit ſans balancer m’unir à la Princeſſe,	Voudrait sans balancer m’unir à la Princesse,
Et je voudrois auſſi par un hymen fatal	Et je voudrais aussi par un hymen fatal
Unir en ce moment Roxane à mon Rival.	Unir en ce moment Roxane à mon Rival.
Ah! ſans plus nous geſner d’une indigne contrainte,	Ah! sans plus nous gêner d’une indigne contrainte,
Au defaut de l’amour, ſervons-nous de la crainte,	Au défaut de l’amour, servons-nous de la crainte,
Ils voudront ſe ſauver l’un & l’autre à leur tour,	Ils voudront se sauver l’un et l’autre à leur tour,
Et leur amour tremblant peut ſervir noſtre amour,	Et leur amour tremblant peut servir notre amour,
Statira doit venir. J’ay ſçeu luy faire entendre	Statira doit venir. J’ai su lui faire entendre
Que dans peu ſon Amant en ce lieu ſe doit rendre,	Que dans peu son Amant en ce lieu se doit rendre,
Je conſens qu’il la voye, & vais l’y préparer,	Je consens qu’il la voit, et vais l’y préparer,
Mais ils ne ſe verront que pour ſe ſéparer.	Mais ils ne se verront que pour se séparer.
Je la vois, elle vient dans une douce attente.	Je la vois, elle vient dans une douce attente.
AH! Seigneur, ſe peut-il que Roxane conſente	Ah! Seigneur, se peut-il que Roxane consente
A ſouffrir que je voye un Prince malheureux?	À souffrir que je voie un Prince si malheureux?
Oüy, Madame, il eſt vray, vous vous verrez tous deux,	Oui, Madame, il est vrai, vous vous verrez tous deux,
Cette entreveuë à vous, a nous, eſt néceſſaire,	Cette entrevue à vous, à nous, est nécessaire,
Il vous en faut icy découvrir le miſtere;	Il vous en faut ici découvrir le mystère;
Roxane vous permet un ſi doux entretien,	Roxane vous permet un si doux entretien,
Mais c’eſt pour ménager voſtre ſort & le ſien;	Mais c’est pour ménager votre sort et le sien;
Vos feux ont rallumé tous les feux de la guerre,	Vos feux ont rallumé tous les feux de la guerre,
Madame, nous eſtions les maîtres de la Terre;	Madame, nous étions les maîtres de la Terre;
Vous voyez cependant pour vous ce que je pers,	Vous voyez cependant pour vous ce que je perds,
Voſtre amour aujourd’huy me coûte l’Univers;	Votre amour aujourd’hui me coûte l’Univers;
Vous nous faites verſer & du ſang & des larmes,	Vous nous faites verser et du sang et des larmes,
Nous ſommes incertains du ſuccés de nos armes,	Nous sommes incertains du succès de nos armes,
Le temps preſſe, & du moins par un dernier effort	Le temps presse, et du moins par un dernier effort
Il faut Roxane & moy terminer noſtre ſort,	Il faut Roxane et moi terminer notre sort,
Roxane eſt irritée, elle eſt voſtre ennemie,	Roxane est irritée, elle est votre ennemie,
Vous aimez mon Rival, & ma flame eſt trahie;	Vous aimez mon Rival, et ma flamme est trahie;
Avant que Ptolomée ait pû le ſecourir,	Avant que Ptolomée ait pu le secourir,
Il faut le couronner, ou le faire périr,	Il faut le couronner, ou le faire périr,
Son ſalut ou ſa mort dépend de ſa réponſe;	Son salut ou sa mort dépend de sa réponse;
Madame, en vous voyant, faites qu’il y renonce,	Madame, en vous voyant, faites qu’il y renonce,
Roxane mépriſée en cet inſtant fatal	Roxane méprisée en cet instant fatal
Eſt plus à craindre encor que le bras d’un Rival,	Est plus à craindre encore que le bras d’un Rival,
Il faut ſans balancer les unir l’un & l’autre,	Il faut sans balancer les unir l’un et l’autre,
Ou que je perce un cœur qui m’arrache le voſtre.	Ou que je perce un cœur qui m’arrache le vôtre.
Ah! Seigneur, arreſtez, dûſſay-je me trahir,	Ah! Seigneur, arrêtez; devais-je me trahir,
A Roxane irritée il nous faut obeïr;	À Roxane irritée il nous faut obéir;
Quand je devrois ſur moy faire tomber la foudre,	Quand je devrais sur moi faire tomber la foudre,
Qu'on le faſſe venir, & je vais l'y réſoudre;	Qu’on le fasse venir, et je vais l’y résoudre;
Oüy, pour tourner ſon cœur à ce funeſte choix,	Oui, pour tourner son cœur à ce funeste choix,
Laiſſez moy luy parler pour la derniere fois.	Laissez-moi lui parler pour la dernière fois.
Hé bien? vous le verrez, mais ſongez l’un & l’autre	Hé bien? vous le verrez, mais songez l’un et l’autre
A regler noſtre ſort auſſi bien que le voſtre;	À régler notre sort aussi-bien que le vôtre;
Vous pleurez mon Rival, ah! que j’en ſuis jaloux!	Vous pleurez mon Rival, ah! que j’en suis jaloux!
Helas! qu’a-t-il a craindre? il eſt aimé de vous,	Hélas! qu’a-t-il à craindre? il est aimé de vous,
Et quoy que ma fureur de la mort le menace,	Et quoi que ma fureur de la mort le menace,
Madame, en ce moment que ne ſuis-je en ſa place?	Madame, en ce moment que ne suis-je en sa place?
Que n’ay-je ſes périls & ſon ſort aujourd’huy?	Que n’ai-je ses périls et son sort aujourd’hui?
Hay de vous, je ſuis plus à plaindre que luy,	Haï de vous, je suis plus à plaindre que lui,
Vous l’allez voir, Madame.	Vous l’allez voir, Madame.
AH! funeſte entreveuë!	AH! funeste entrevue!
Je le verray, Cleone, & ce penſer me tuë.	Je le verrai, Cléone, et ce penser me tue.
Quoy donc? ma propre bouche en ce triſte moment	Quoi donc? ma propre bouche en ce triste moment
Va prononcer ma mort pour ſauver mon Amant,	Va prononcer ma mort pour sauver mon Amant,
Ma flame va parler pour éteindre la ſienne,	Ma flamme va parler pour éteindre la sienne,
Et ma bouche.... il en faut une autre que la mienne,	Et ma bouche… il en faut une autre que la mienne,
Et je vais le prier aux deſpens de ſes jours	Et je vais le prier aux dépens de ses jours
De haïr ma Rivale, & de m’aimer toûjours.	De haïr ma Rivale, et de m’aimer toujours.
Mais Dieux! s’il ne l'épouſe, il va ceſſer de vivre;	Mais Dieux! s’il ne l’épouse, il va cesser de vivre;
Helas! s’il eſtoit mort, je n’aurois qu’à le ſuivre;	Hélas! s’il était mort, je n’aurais qu’à le suivre;
Tantoſt malgré Roxane & mes ſens éperdus,	Tantôt, malgré Roxane et mes sens éperdus,
Il a veu mes ſoûpirs qu’il a trop entendus,	Il a vu mes soupirs qu’il a trop entendus,
Il connoît que je l’aime, & malgré ma contrainte	Il connaît que je l’aime, et malgré ma contrainte
Il a trop penetré l’artifice & la feinte,	Il a trop pénétré l’artifice et la feinte,
Mais je vais maintenant luy parler ſans témoins;	Mais je vais maintenant lui parler sans témoins;
Quand il verra mes pleurs, m’en aimera-t-il moins?	Quand il verra mes pleurs, m’en aimera-t-il moins?
Je connois trop ſon cœur, & le mien en friſſonne,	Je connais trop son cœur, et le mien en frissonne,
Il me ſera fidelle, & périra, Cleone;	Il me sera fidèle, et périra, Cléone;
Je me flate peut-eſtre, il ne périra pas,	Je me flatte peut-être, il ne périra pas,
Roxane l’a ſauvé, Roxane a des apas,	Roxane l’a sauvé, Roxane a des appâts,
Et quand je luy diray de n’eſtre plus fidelle,	Et quand je lui dirai de n’être plus fidèle,
S’il m’alloit obeïr & ſoûpirer pour elle?	S’il m’allait obéir et soupirer pour elle?
Ciel! que vay-je luy dire? ah Dieux! il doit venir,	Ciel! que vais-je lui dire? ah Dieux! il doit venir,
Quel funeſte ſujet de nous entretenir?	Quel funeste sujet de nous entretenir?
On vient, Cleone, on ouvre, on entre, & c'eſt luy-meſme.	On vient, Cléone, on ouvre, on entre, et c’est lui-même.
MAdame, quel plaiſir de voir ce que l’on aime!	MAdame, quel plaisir de voir ce que l’on aime!
Je n’oſois l’eſperer, mais puis qu’il m’eſt permis,	Je n’osais l’espérer, mais puisqu’il m’est permis,
Je veux pardonner tout à nos fiers Ennemis;	Je veux pardonner tout à nos fiers Ennemis;
Dans un moment ſi doux partagez-vous ma joye,	Dans un moment si doux partagez-vous ma joie,
Roxane & Perdiccas ſouffrent que je vous voye,	Roxane et Perdiccas souffrent que je vous vois,
Quel Dieu les a fléchis? ma Princeſſe & vos pleurs	Quel Dieu les a fléchis? ma Princesse et vos pleurs
Auroient-ils attendry ces barbares Vainqueurs?	Auraient-ils attendri ces barbares Vainqueurs?
Nous pouvons à préſent nous parler ſans contrainte,	Nous pouvons à présent nous parler sans contrainte,
Et que n’ay-je tantoſt démeſlé voſtre crainte?	Et que n’ai-je tantôt démêlé votre crainte?
Vous m’auriez épargné de mortels déplaiſirs,	Vous m’auriez épargné de mortels déplaisirs,
Si j’avois reconnu vos pleurs & vos ſoûpirs;	Si j’avais reconnu vos pleurs et vos soupirs;
Roxane eſtoit préſente, & redoutant ſa rage,	Roxane était présente, et redoutant sa rage,
Il falloit me tenir ce funeſte langage;	Il fallait me tenir ce funeste langage;
Pouvons-nous pas loin d’elle oublier nos douleurs?	Pouvons-nous pas loin d’elle oublier nos douleurs?
Mais, Madame, je vois vos yeux baignez de pleurs,	Mais, Madame, je vois vos yeux baignés de pleurs,
On diroit à vous voir que mon abord vous gêne,	On dirait à vous voir que mon abord vous gêne,
Il ſemble que ma joye augmente voſtre peine,	Il semble que ma joie augmente votre peine,
Parlez.	Parlez.
Il faut, Seigneur....	Il faut, Seigneur…
Quoy?	Quoi?
Cruel ſouvenir:	Cruel souvenir:
Il faut....	Il faut…
Que faut-il donc?	Que faut-il donc?
Me quitter, ou périr.	Me quitter, ou périr.
Qui moy, Madame, on veut que je vous abandonne?	Qui moi, Madame, on veut que je vous abandonne?
Perdiccas vous menace, & Roxane l’ordonne,	Perdiccas vous menace, et Roxane l’ordonne,
Tout le veut, elle eſt belle, & peut-eſtre, Seigneur,	Tout le veut, elle est belle, et peut-être, Seigneur,
Vous le voudrez bientoſt aux deſpens de mon cœur.	Vous le voudrez bientôt aux dépens de mon cœur.
Quel étrange diſcours! & depuis quand, Madame,	Quel étrange discours! et depuis quand, Madame,
Voulez-vous de Roxane autoriſer la flame?	Voulez-vous de Roxane autoriser la flamme?
Pouriez-vous luy ceder mes ſoûpirs & ma foy?	Pourriez-vous lui céder mes soupirs et ma foi?
Quoy? parlez-vous pour elle, ou parlez vous à moy?	Quoi? parlez-vous pour elle, ou parlez-vous à moi?
Roxane veut en vain que je vous abandonne,	Roxane veut en vain que je vous abandonne,
Mais Perdiccas le veut, & c’eſt luy qui l’ordonne,	Mais Perdiccas le veut, et c’est lui qui l’ordonne,
Il vous aime, Madame, & peut-eſtre aujourd’huy	Il vous aime, Madame, et peut-être aujourd’hui
Voſtre cœur agit moins pour elle que pour luy.	Votre cœur agit moins pour elle que pour lui.
Et depuis quand, Seigneur, en voyant mes allarmes,	Et depuis quand, Seigneur, en voyant mes alarmes,
Expliquez-vous ſi mal le langage des larmes?	Expliquez-vous si mal le langage des larmes?
Ne l'entendez-vous plus, & mes ſoûpirs, helas!	Ne l’entendez-vous plus, et mes soupirs, hélas!
Ingrat, vous diſent-ils que j’aime Perdiccas?	Ingrat, vous disent-ils que j’aime Perdiccas?
Eh! pardonnez, Madame, un peu de jalouſie,	Eh! pardonnez, Madame, un peu de jalousie,
Oubliez Perdiccas autant que je l'oublie;	Oubliez Perdiccas autant que je l’oublie;
Nos cruels Ennemis en de ſi chers momens	Nos cruels Ennemis en de si chers moments
Doivent-ils partager nos tendres ſentimens?	Doivent-ils partager nos tendres sentiments?
Je vous vois, il ſuffit, & mon ame contente	Je vous vois, il suffit, et mon âme contente
Dédaigne de ſonger que Roxane eſt Amante.	Dédaigne de songer que Roxane est Amante.
Ah! quãd de Perdiccas mon cœur craint le couroux,	Ah! quand de Perdiccas mon cœur craint le courroux,
Je penſe moins à luy que je ne penſe à vous;	Je pense moins à lui que je ne pense à vous;
Aprenez les horreurs de l’effroy qui me tuë,	Apprenez les horreurs de l’effroi qui me tue,
Sçavez-vous les raiſons d’une telle entreveuë?	Savez-vous les raisons d’une telle entrevue?
Nous nous voyõs, Seigneur, on nous le ſouffre, mais	Nous nous voyons, Seigneur, on nous le souffre, mais
C’eſtpour mieux nous réſoudre à ne nous voir jamais.	C’est pour mieux nous résoudre à ne nous voir jamais.
Dans une heure, Seigneur, Perdiccas vous cõdamne	Dans une heure, Seigneur, Perdiccas vous condamne
A choiſir ou la mort, ou l’hymen de Roxane;	À choisir ou la mort, ou l’hymen de Roxane;
Malgré moy, faites-vous un genéreux effort,	Malgré moi, faites-vous un généreux effort,
Et choiſiſſez plutoſt Roxane que la mort.	Et choisissez plutôt Roxane que la mort.
Moy, Madame?	Moi, Madame?
Oüy, vous. Songez à voſtre vie,	Oui, vous. Songez à vôtre vie,
Roxane vous rendra le maiſtre de l’Aſie,	Roxane vous rendra le maître de l’Asie,
Oubliez-moy, Seigneur, laiſſez-moy dans les fers,	Oubliez-moi, Seigneur, laissez-moi dans les fers,
Un Héros tel que vous ſe doit à l’Univers,	Un Héros tel que vous se doit à l’Univers,
Et ſi vous périſſiez par une mort fi prompte,	Et si vous périssiez par une mort si prompte,
L’Univers, de vos jours me demanderoit conte.	L’Univers, de vos jours me demanderait compte.
Ciel! que m’oſez-vous dire? Helas! ſi je vous pers,	Ciel! que m’osez-vous dire? Hélas! si je vous perds,
Madame, & que m’importe à moy de l’Univers?	Madame, et que m’importe à moi de l’Univers?
Dois-je vivre un moment, ſi vous m’eſtes ravie?	Dois-je vivre un moment, si vous m’êtes ravie?
Je cede à Perdiccas & la Perſe & l'Aſie;	Je cède à Perdiccas et la Perse et l’Asie;
Le Trône eſt-il l’objet de mes vœux les plus doux,	Le Trône est-il l’objet de mes vœux les plus doux,
Et ſoûpiray-je, enfin, pour l’Empire, ou pour vous?	Et soupirai-je, enfin, pour l’Empire, ou pour vous?
Helas! ſans vous, mon cœur dans une paix profonde	Hélas! sans vous, mon cœur dans une paix profonde
Verroit tranquilement la conqueſte du monde,	Verrait tranquillement la conquête du monde,
Je l’abandonne à qui peut en eſtre vainqueur,	Je l’abandonne à qui peut en être vainqueur,
Mais je diſputeray celle de voſtre cœur.	Mais je disputerai celle de votre cœur.
Et ſongez-vous, Seigneur, que la triſte conqueſte	Et songez-vous, Seigneur, que la triste conquête
D’un cœur comme le mien vous peut coûter la teſte?	D’un cœur comme le mien vous peut coûter la tête?
Ne vous ſouvient-il plus de ce jour douloureux	Ne vous souvient-il plus de ce jour douloureux
Où les feux d’Aléxandre éteignirent nos feux,	Où les feux d’Alexandre éteignirent nos feux,
Quand vous-meſme chargé de ſon funeſte homage,	Quand vous-même chargé de son funeste hommage,
Vous parûtes, la mort peinte ſur le viſage,	Vous parûtes, la mort peinte sur le visage,
Et fiſtes pour ma gloire un genéreux effort?	Et fîtes pour ma gloire un généreux effort?
Mais helas! aujourd’huy que je crains voſtre mort,	Mais hélas! aujourd’hui que je crains votre mort,
Que je crains Perdiccas & Roxane en furie,	Que je crains Perdiccas et Roxane en furie,
J’en veux faire un pareil pour ſauver voſtre vie;	J’en veux faire un pareil pour sauver votre vie;
L’amour fait voſtre crime, on preſſe, on vous attend,	L’amour fait votre crime, on presse, on vous attend,
Si vous ne m’aimez plus, vous ſerez innocent,	Si vous ne m’aimez plus, vous serez innocent,
C’eſt ce cruel amour, Seigneur, qui vous accable,	C’est ce cruel amour, Seigneur, qui vous accable,
Etoufez-le.... Mais non, ſoyez toûjours coupable;	Étouffez-le… Mais non, soyez toujours coupable;
Que dis-je? ce n’eſt plus Roxane & Perdiccas,	Que dis-je? ce n’est plus Roxane et Perdiccas,
C’eſt moy, c’eſt Statira qui vous mene au trépas;	C’est moi, c’est Statira qui vous mène au trépas;
Vous verrois-je périr? non, ſoyez infidelle,	Vous verrais-je périr? non, soyez infidèle,
Allez, ſortez plutoſt, & ſoûpirez pour elle,	Allez, sortez plutôt, et soupirez pour elle,
Je ne puis demeurer apres un tel effort,	Je ne puis demeurer après un tel effort,
Chaque inſtant pres de vous va haſter voſtre mort,	Chaque instant près de vous va hâter votre mort,
Et mon perfide cœur qui ſe plaint, qui ſoúpire,	Et mon perfide cœur qui se plaint, qui soupire,
Si je vous vois encor, ſçaura trop m’en dédire.	Si je vous vois encore, saura trop m’en dédire.
Quoy? vous m’abandonnez en cette extrémité,	Quoi? vous m’abandonnez en cette extrémité,
Et de grace, Madame, un peu de fermeté?	Et de grâce, Madame, un peu de fermeté?
Je mépriſe Roxane, & ma tendreſſe extréme	Je méprise Roxane, et ma tendresse extrême
Fait que je hais Roxane autant que je vous aime,	Fait que je hais Roxane autant que je vous aime,
Je déteſte Roxane, & je veux....	Je déteste Roxane, et je veux…
Achevez,	Achevez,
Et voyez de plus pres l'Objet que vous bravez;	Et voyez de plus près l’Objet que vous bravez;
J’ay trop bien entendu ce qui peut vous confondre,	J’ai trop bien entendu ce qui peut vous confondre,
Ingrat, dans un moment je vais vous y répondre;	Ingrat, dans un moment je vais vous y répondre;
Qu'on redouble ma Garde, & ſur tout, Peuceſtas,	Qu’on redouble ma Garde, et surtout, Peucestas,
Qu'on ferme de ces lieux l’entrée à Perdiccas.	Qu’on ferme de ces lieux l’entrée à Perdiccas.
Madame, quel deſſein?...	Madame, quel dessein?…
Ma vangeance & ma honte,	Ma vengeance et ma honte,
De mes juſtes deſſeins pouront vous rendre conte.	De mes justes desseins pourront vous rendre compte.
Grâce aux Dieux! je ſuis libre, & vais tranquilement	Grâce aux Dieux! je suis libre, et vais tranquillement
Immoler ma Rivale aux yeux de ſon Amant.	Immoler ma Rivale aux yeux de son Amant.
Je mépriſe Roxane, & ma tendreſſe extréme	Je méprise Roxane, et ma tendresse extrême
Fait que je hais Roxane autant que je vous aime;	Fait que je hais Roxane autant que je vous aime;
Ce diſcours vous charmoit, Madame, & ſes ſoúpirs	Ce discours vous charmait, Madame, et ses soupirs
Aux deſpens de Roxane ont flaté vos deſirs;	Aux dépens de Roxane ont flatté vos désirs;
Loin de moy, devant vous, c’eſt donc moy qu’on déteſte?	Loin de moi, devant vous, c’est donc moi qu’on déteste?
Mais vous m’allez payer un plaiſir ſi funeſte.	Mais vous m’allez payer un plaisir si funeste.
Madame, au nom des Dieux, écoutez....	Madame, au nom des Dieux, écoutez…
Non, Seigneur,	Non, Seigneur,
Laiſſez, laiſſez agir librement ſa fureur;	Laissez, laissez agir librement sa fureur;
Depuis un ſi longtemps, de mon ſong alterée,	Depuis un si longtemps, de mon sang altérée,
A toutes ſes fureurs mon ame eſt préparée.	À toutes ses fureurs mon âme est préparée.
Fille de Cohortan, acheve tes deſſeins,	Fille de Cohortan, achève tes desseins,
Dans le ſang de tes Roys oſes tremper tes mains,	Dans le sang de tes Rois ose tremper tes mains,
Frape.	Frappe.
Dans un moment vous ſerez obeïe,	Dans un moment vous serez obéie,
Aprochez-vous.	Approchez-vous.
Ah Ciel! que je crains pour ſa vie!	Ah Ciel! que je crains pour sa vie!
Calmez voſtre couroux, Madame, au nom des Dieux;	Calmez votre courroux, Madame, au nom des Dieux;
Qu'ordõnez vous helas! quel trouble dans vos yeux!	Qu’ordonnez-vous hélas! quel trouble dans vos yeux!
Madame, c’eſt ſur moy, ſur ma coupable teſte,	Madame, c’est sur moi, sur ma coupable tête,
Que doit icy tomber l’éclat de la tempeſte,	Que doit ici tomber l’éclat de la tempête,
Mon amour fait ſon crime, il le faut expier,	Mon amour fait son crime, il le faut expier,
Et mon ſang répandu peut la juſtifier.	Et mon sang répandu peut la justifier.
Oüy, Barbaré, il eſt vray; ton amour fait ton crime,	Oui, Barbare, il est vrai; ton amour fait ton crime,
Cependant ma Rivale en ſera la Victime,	Cependant ma Rivale en sera la Victime,
On me déteſte, on l’aime, & l’on m'oſe outrager,	On me déteste, on l’aime, et l’on m’ose outrager,
Mais enfin, grace au Ciel, j’ay ſur qui m’en vanger.	Mais enfin, grâce au Ciel, j’ai sur qui m’en venger.
Pour goúter la douceur à ma vangeance offerte,	Pour goûter la douceur à ma vengeance offerte,
Préparons à tes yeux l'apareil de ſa perte;	Préparons à tes yeux l’appareil de sa perte;
Pour t’en faire ſentir l’amertume à longs traits,	Pour t’en faire sentir l’amertume à longs traits,
Ma fureur, à pas lents, va ſervir mes ſouhaits.	Ma fureur, à pas lents, va servir mes souhaits.
Ne croy pas cependant au tranſport qui m’entraîne,	Ne crois pas cependant au transport qui m’entraîne,
Que l’amour.... Non, Ingrat, je n’ay que de la haine,	Que l’amour… Non, Ingrat, je n’ai que de la haine;
Il faut la ſatisfaire, & Roxane le peut,	Il faut la satisfaire, et Roxane le peut,
Politique, raiſon, ſeûreté, tout le veut;	Politique, raison, sûreté, tout le veut;
Oüy, perdons Starira.... mais malgré mon envie,	Oui, perdons Statira… mais malgré mon envie,
Leonatus, un mot luy peut ſauver la vie.	Léonatus, un mot lui peut sauver la vie.
Voſtre refus dût-il me coûter le trépas,	Votre refus dût-il me coûter le trépas,
Ce mot qui m’eſt ſi cher, ne le prononcez pas.	Ce mot qui m’est si cher, ne le prononcez pas.
Je crains voſtre tendreſſe autãt que ſavangeance,	Je crains votre tendresse autant que sa vengeance,
Ce n’eſt point Statira, c’eſt moy qui vous offence;	Ce n’est point Statira, c’est moi qui vous offense;
Ah! Madame, arreſtez, & détournez ſur moy	Ah! Madame, arrêtez, et détournez sur moi
Ces regards menaçans qui me glaçent d’effroy;	Ces regards menaçants qui me glacent d’effroi;
Le Ciel nous eſt témoin que tantoſt elle-meſme,	Le Ciel nous est témoin que tantôt elle-même,
En renonçant pour vous a ma tendreſſe extréme,	En renonçant pour vous à ma tendresse extrême,
Elle a voulu.... mais quoy, mon amour m’a trahy.	Elle a voulu… mais quoi, mon amour m’a trahi.
Et pourquoy voſtre cœur n’a-t-il pas obey?	Et pourquoi votre cœur n’a-t-il pas obéi?
Je ne dis plus qu’un mot, & veux eſtre obeïe;	Je ne dis plus qu’un mot, et veux être obéie;
Tu ſçais bien qu’un coup d’œil luy peut coûter la vie,	Tu sais bien qu’un coup d’œil lui peut coûter la vie,
Veux-tu la voir périr, veux-tu la conſerver?	Veux-tu la voir périr, veux-tu la conserver?
Que ne feray-je point helas! pour la ſauver?	Que ne ferais-je point, hélas! pour la sauver?
Qu’on cherche Perdiccas, il faut que toute à l’heure	Qu’on cherche Perdiccas, il faut que tout à l’heure
Ton Rival, à tes yeux, l'épouſe, ou qu’elle meure.	Ton Rival, à tes yeux, l’épouse, ou qu’elle meure.
Epouſer Perdiccas?	Épouser Perdiccas?
Pour calmer ſon couroux,	Pour calmer son courroux,
Oubliez-moy, Madame, & ne ſongez qu’à vous,	Oubliez-moi, Madame, et ne songez qu’à vous,
Donnez à Perdiccas....	Donnez à Perdiccas…
Voſtre amour m’y condamne,	Votre amour m'y condamne,
Et vous ne voulez pas vous donner à Roxane?	Et vous ne voulez pas vous donner à Roxane?
Ils ſont également ardens à m’offencer,	Ils sont également ardents à m’offenser,
Ah perdons-les tous deux, mais par qui commencer?	Ah perdons-les tous deux, mais par qui commencer?
Oüy, je vais....	Oui, je vais…
Ah! Madame, il faut prendre ma vie,	Ah! Madame, il faut prendre ma vie,
Avant que de remplir cette funeſte envie;	Avant que de remplir cette funeste envie;
Tout deſarmé ſans-doute, & tout ſeul que je ſuis,	Tout désarmé sans-doute, et tout seul que je suis,
Mon deſeſpoir poura bien plus que je ne puis.	Mon désespoir pourra bien plus que je ne puis.
VEnez, venez, Seigneur, ſecourir la Princeſſe.	VEnez, venez, Seigneur, secourir la Princesse.
Madame, vous ſçavez juſqu’où va ma tendreſſe,	Madame, vous savez jusqu’où va ma tendresse,
Retenez....	Retenez…
Perdiccas, ton cœur va te trahir,	Perdiccas, ton cœur va te trahir,
Je ne ſçais plus aimer, je ne ſçais que haïr;	Je ne sais plus aimer, je ne sais que haïr;
Pour éteindre une ardeur à nos deſſeins fatale,	Pour éteindre une ardeur à nos desseins fatale,
Je te rends ton Rival, donne-moy ma Rivale.	Je te rends ton Rival, donne-moi ma Rivale.
Si voſtre cœur, Madame, en ce funeſte jour	Si votre cœur, Madame, en ce funeste jour
A de la haine, helas! le mien a de l’amour,	A de la haine, hélas! Le mien a de l’amour,
Juſqu’au dernier ſoûpir je défendray ſa vie.	Jusqu’au dernier soupir je défendrai sa vie.
Vous eſtes genéreux, & je vous la confie,	Vous êtes généreux, et je vous la confie,
C’eſt aſſez qu’un Rival luy donne du ſecours.	C’est assez qu’un rival lui donne du secours.
Tout hay que je ſuis, j'auray ſoin de ſes jours;	Tout haï que je suis, j’aurai soin de ses jours;
Mais quand vous ſerez libre, en lieu pour vous défendre,	Mais quand vous serez libre, en lieu pour vous défendre,
J’iray la diſputer en Rival d’Aléxandre.	J’irai la disputer en Rival d’Alexandre.
Allons, Madame.	Allons, Madame.
Helas!	Hélas!
Je ne crains plus ſa mort,	Je ne crains plus sa mort,
Vous pouvez maintenant ordonner de mon ſort,	Vous pouvez maintenant ordonner de mon sort,
ſe l'attendray, Madame.	Je l’attendrai, Madame.
AH! quelle vive atteinte!	AH! quelle vive atteinte!
Je puis à ton amour redonner de la crainte,	Je puis à ton amour redonner de la crainte,
J’ay perdu le moment ſi propre à me vanger,	J’ai perdu le moment si propre à me venger,
Rapellons Caſſander. L’eſpoir peut l’engager;	Rappelons Cassandre. L’espoir peut l’engager;
Qu'importe? ſon amour poura ſervir ma haine;	Qu’importe? son amour pourra servir ma haine;
Haſtons-nous, attaquons Perdiccas & la Reyne,	Hâtons-nous, attaquons Perdiccas et la Reine,
A qui n’a point d’eſpoir, tout le reſte eſt permis;	À qui n’a point d’espoir, tout le reste est permis;
Périſſons, mais du moins perdons nos Ennemis.	Périssons, mais du moins perdons nos Ennemis.
JE triomphe, Heſione, & n’ay plus de tendreſſe,	JE triomphe, Hésione, et n’ai plus de tendresse,
De ce Palais, enfin, Roxane eſt la maitreſſe,	De ce Palais, enfin, Roxane est la maîtresse,
Je dois ce grand effort aux ſoins de Peuceſtas,	Je dois ce grand effort aux soins de Peucestas,
Et Statira n’eſt plus aux mains de Perdiccas;	Et Statira n’est plus aux mains de Perdiccas;
Graces à Caſſander, elle eſt en ma puiſſance,	Grâce à Cassandre, elle est en ma puissance,
Et j’ay dans ſon amour une ſeûre défenſe;	Et j’ai dans son amour une sûre défense;
Mais il faut prendre un temps ſi propre à nous vãnger,	Mais il faut prendre un temps si propre à nous venger,
Il faut punir l’Ingrat qui nous oſe outrager.	Il faut punir l’Ingrat qui nous ose outrager.
J’ay connu, j’ay trop veu ſa tendreſſe fatale;	J’ai connu, j’ai trop vu sa tendresse fatale;
Occupé tout entier des feux de ma Rivale,	Occupé tout entier des feux de ma Rivale,
Je luy faiſois en pleurs l'offre de mon apuy,	Je lui faisais en pleurs l’offre de mon appui,
A peine a-t-il ſongé que je parlois à luy;	À peine a-t-il songé que je parlais à lui;
Mon trouble, en vain mes yeux luy marquoient ma tendreſſe,	Mon trouble, en vain mes yeux lui marquaient ma tendresse,
Pour réponſe, il m’a dit d’épargner ſa Princeſſe,	Pour réponse, il m’a dit d’épargner sa Princesse;
J’avois beau par mes feux animer mon diſcours,	J’avais beau par mes feux animer mon discours,
L’Ingrat, par ſes ſoûpirs, m’interrompoit toûjours;	L’Ingrat, par ses soupirs, m’interrompait toujours;
Mais quoy? ſur Starira je vais me ſatisfaire,	Mais quoi? sur Statira je vais me satisfaire,
Je le puis, je le dois, je ſçay ce qu’il faut faire,	Je le puis, je le dois, je sais ce qu’il faut faire,
Je dois ce ſacrifice aux ſoins de ma grandeur,	Je dois ce sacrifice aux soins de ma grandeur,
L’amour n’a plus de part aux trãſports de mon cœur,	L’amour n’a plus de part aux transports de mon cœur,
La jalouſie enfin n’eſt plus ce qui m’anime,	La jalousie enfin n’est plus ce qui m’anime,
A mon ambition je dois cette victime,	À mon ambition je dois cette victime,
Et lors que je l’immole en ce funeſte jour,	Et lors que je l’immole en ce funeste jour,
C’eſt au Trône, à mon Fils, & non pas à l’Amour.	C’est au trône, à mon fils, et non pas à l’Amour.
Que vous connoiſſez peu l’ardeur qui vous entraîne!	Que vous connaissez peu l’ardeur qui vous entraîne!
Vous croyez vous livrer tout entiere à la haine;	Vous croyez vous livrer tout entière à la haine;
Ah! que vous vous trompez, Madame, à voſtre tour!	Ah! que vous vous trompez, Madame, à votre tour!
Quand on a tant de haine, on n’eſt pas ſans amour.	Quand on a tant de haine, on n’est pas sans amour.
Moy? j’aurois de l’amour, & tu pourois le croire?	Moi? j’aurais de l’amour, et tu pourrais le croire?
Mon cœur pouroit trahir Aléxandre & ma gloire?	Mon cœur pourrait trahir Alexandre et ma gloire?
Pardonne, grand Héros, ſi pour Leonatus	Pardonne, grand Héros, si pour Léonatus
J'ay ſoûpiré; J’ay crû qu’il avoit tes vertus;	J’ai soupiré; J’ai crû qu’il avait tes vertus;
J’ay crû que quelque jour pour Roxane ſenſible,	J’ai crû que quelque jour pour Roxane sensible,
Son cœur comme le tien n’eſtoit pas invincible;	Son cœur comme le tien n’était pas invincible;
Mais Dieux! il porte ailleurs ſes ſoûpirs & ſa foy,	Mais Dieux! il porte ailleurs ses soupirs et sa foi,
Et ne ſent pas l’ardeur que tu ſentis pour moy.	Et ne sent pas l’ardeur que tu sentis pour moi.
Ah! pour vanger ma gloire il faut tout entreprendre,	Ah! pour venger ma gloire il faut tout entreprendre,
Il faut que tout regrete & tout pleure Aléxandre,	Il faut que tout regrette et tout pleure Alexandre,
Je l’ay trahy. Je veux reparer mon forfait,	Je l’ai trahi. Je veux réparer mon forfait,
Et dans ce jour fatal faire plus qu’il n’a fait.	Et dans ce jour fatal faire plus qu’il n’a fait.
Quoy? l’on veut partager ſes Veuves, ſon Empire.	Quoi? l’on veut partager ses Veuves, son Empire
Il vainquit l’Univers, & je veux le détruire?	Il vainquit l’Univers, et je veux le détruire?
Avec plaiſir j’ay veu brûler Perſopolis,	Avec plaisir j’ai vu brûler Persepolis,
Donnons le meſme ſort à l’orgueil de Memphis,	Donnons le même sort à l’orgueil de Memphis,
Rempliſſons tout d’horreur, & que toute l’Aſie	Remplissons tout d’horreur, et que toute l’Asie
Aprenne en frémiſſant que Roxane eſt trahie.	Apprenne en frémissant que Roxane est trahie.
MAdame, Perdiccas par de puiſſans efforts,	MAdame, Perdiccas par de puissants efforts,
Déja de ce Palais a gagné les Dehors.	Déjà de ce Palais a gagné les Dehors.
Sauvez Leonatus, & contre ſa furie	Sauvez Léonatus, et contre sa furie
Allez défendre encore une ſi chere vie,	Allez défendre encore une si chère vie,
On me croit immolée, & le fier Perdiccas	On me croit immolée, et le fier Perdiccas
Sur ce que vous aimez vangera mon trépas;	Sur ce que vous aimez vengera mon trépas;
Envoyez du ſecours, enfin le péril preſſe,	Envoyez du secours, enfin le péril presse,
Malgré voſtre fureur je voy voſtre tendreſſe;	Malgré votre fureur je vois votre tendresse;
Conſervez ce Héros qui vous a ſçeu charmer,	Conservez ce Héros qui vous a su charmer,
S’il ne vous aime pas, il poura vous aimer.	S’il ne vous aime pas, il pourra vous aimer.
Madame, allez... mais quoy? vous eſtes infléxible,	Madame, allez… mais quoi? Vous êtes inflexible,
Helas! à ſes périls eſtes-vous inſenſible?	Hélas! à ses périls êtes-vous insensible?
Vous détournez les yeux, & ne répondez rien.	Vous détournez les yeux, et ne répondez rien.
C’eſt voſtre Amant, Madame, & ce n’eſt pas le mien,	C’est votre amant, Madame, et ce n’est pas le mien,
Qu'il périſſe	Qu’il périsse.
Quoy donc? vous ſouffrez qu’il périſſe?	Quoi donc? vous ſouffrez qu’il périſſe?
A Roxane irritée il faut ce ſacriſice;	À Roxane irritée il faut ce sacrifice;
Quand j’ay ſauvé l’Ingrat, il fait un autre choix,	Quand j’ai sauvé l’Ingrat, il fait un autre choix,
J’en ferois un Ingrat une ſeconde fois.	J’en ferais un Ingrat une seconde fois.
Madame, je répons de ſa reconnoiſſance.	Madame, je réponds de sa reconnaissance.
Et qui me répondra de ſon obeïſſance?	Et qui me répondra de son obéissance?
Pouriez-vous vous réſoudre à ne le voir jamais?	Pourriez-vous vous résoudre à ne le voir jamais?
Où poura-t-il tenir contre tant de bienfaits?	Où pourra-t-il tenir contre tant de bienfaits?
Madame, le temps preſſe, & Perdiccas peut-eſtre,	Madame, le temps presse, et Perdiccas peut-être,
De luy, de ce Palais, va ſe rendre le maiſtre:	De lui, de ce Palais, va se rendre le maître:
Helas! qu’eſt devenuë une ſi belle ardeur?	Hélas! qu’est devenue une si belle ardeur?
Pour le prix de ſes jours j’abandonne ſon cœur.	Pour prix de ses jours j’abandonne son cœur.
Madame, allez....	Madame, allez…
En vain le voſtre l’abandonne,	En vain le vôtre l'abandonne,
Vous ne pouvez donner ce cœur, s’il ne ſe donne;	Vous ne pouvez donner ce cœur, s’il ne se donne;
Et ſi j’en crois encor un mouvement jaloux,	Et si j’en crois encore un mouvement jaloux,
Pouroit-il eſtre à moy, quand il eſt tout à vous?	Pourrait-il être à moi, quand il est tout à vous?
MAdame, il faut quitter les Murs de Babylone,	MAdame, il faut quitter les Murs de Babylone,
Et ſortir d’un Palais que le Peuple environne;	Et sortir d’un Palais que le Peuple environne;
Perdiccas irrité, l’anime contre vous.	Perdiccas irrité, l’anime contre vous.
Mais j’ay tous mes Amis preſts à périr pour vous;	Mais j’ai tous mes Amis prêts à périr pour vous;
Antipater aproche, allons joindre une Armée	Antipater approche, allons joindre une Armée
Qui ſera par vos yeux & mes feux animée,	Qui sera par vos yeux et mes feux animée,
Et là pour ſoûtenir l’honneur de vos appas,	Et là pour soutenir l’honneur de vos appâts,
Je puis avec mon cœur offrir cent mille bras;	Je puis avec mon cœur offrir cent mille bras;
Au moindre ordre de vous, le panchãt qui m’entraîne,	Au moindre ordre de vous, le penchant qui m’entraîne,
M’a fait courir, voler, pour ſervir voſtre haine.	M’a fait courir, voler, pour servir votre haine.
Ne pourez-vous jamais par un heureux retour,	Ne pourrez-vous jamais par un heureux retour,
Oubliant voſtre haine, écouter mon amour?	Oubliant votre haine, écouter mon amour?
Seigneur, je dois beaucoup à ce zele ſincere	Seigneur, je dois beaucoup à ce zèle sincère
Qui m’offre le ſecours de vous, de voſtre Pere.	Qui m’offre le secours de vous, de votre Père.
Mais que fait Perdiccas?	Mais que fait Perdiccas?
Il vient de vous vanger	Il vient de vous venger
De l’Ingrat dont l’amour oſoit vous outrager.	De l’Ingrat dont l’amour osait vous outrager.
Helas!	Hélas!
Que dites-vous?	Que dites-vous?
Oubliez-le, Madame,	Oubliez-le, Madame,
Cet Ingrat, dont l’orgueil mépriſoit voſtre flame,	Cet Ingrat, dont l’orgueil méprisait votre flamme,
Et croyez que les Dieux ont fouffert ſon trépas,	Et croyez que les Dieux ont souffert son trépas,
Puis qu’il a pû vous voir, & ne vous aimer pas.	Puisqu’il a pu vous voir, et ne vous aimer pas.
C’eſt aſſez, & dans peu je m’apreſte à vous ſuivre,	C’est assez, et dans peu je m’apprête à vous suivre,
Préparez tout.	Préparez tout.
J’y cours. Si pour vous i'oſe vivre,	J'y cours. Si pour vous j'ose vivre,
Je vais vous préparer un deſtin glorieux,	Je vais vous préparer un destin glorieux,
Ou bien j’auray l’honneur de mourir à vos yeux.	Ou bien j’aurai l’honneur de mourir à vos yeux.
AH! Madame, je ſens qu’en de telles allarmes	Ah! Madame, je sens qu’en de telles alarmes
Malgré moy, comme à vous, il m’échape des larmes;	Malgré moi, comme à vous, il m’échappe des larmes;
Helas! il eſt donc mort?	Hélas! Il est donc mort?
Quoy, ſans le ſecourir,	Quoi, sans le secourir,
Vous le pleurez, Cruelle, & le laiſſez périr?	Vous le pleurez, Cruelle, et le laissez périr?
Ah! je ne ſens que trop le feu qui me devore,	Ah! je ne sens que trop le feu qui me dévore,
Je croyois le haïr, & je l’aimois encore;	Je croyais le haïr, et je l’aimais encore;
Mais ce n'eſt pas aſſez, en de ſi grands malheurs,	Mais ce n’est pas assez, en de si grands malheurs,
Il faut verſer du ſang, c’eſt trop peu que des pleurs.	Il faut verser du sang, c’est trop peu que des pleurs.
Madame, il vous aimoit, n’oſerez-vous le ſuivre?	Madame, il vous aimait, n’oserez-vous le suivre?
Moy, j’en eſtois haïe, & ne puis luy ſurvivre;	Moi, j’en étais haïe, et ne puis lui survivre;
Oüy. J’ateſte les Dieux, que par un noble effort	Oui. J’atteste les Dieux, que par un noble effort
Dans peu je me rendray maiſtreſſe de mon ſort.	Dans peu je me rendrai maîtresse de mon sort.
Mais quoy? de Perdiccas ſerez vous la victime,	Mais quoi? de Perdiccas serez vous la victime,
L’objet de ſon amour, & le fruit de ſon crime,	L’objet de son amour, et le fruit de son crime,
Et pourez-vous paſſer dans ce cruel moment	Et pourrez vous passer dans ce cruel moment
En des Bras degoutans du ſang de voſtre Amant?	En des bras dégoûtants du sang de votre Amant?
Vangeons Leonatus ſur vous & ſur moy-meſme,	Vengeons Léonatus sur vous et sur moi-même,
Il faut que tout périſſe en perdant ce que j’aime.	Il faut que tout périsse en perdant ce que j’aime.
Madame, en cet inſtant, voyons qui de nous deux	Madame, en cet instant, voyons qui de nous deux
Oſera le vanger, & qui l’aime le mieux.	Osera le venger, et qui l’aime le mieux.
N’en doutez point, Madame, en cet inſtant funeſte	N’en doutez point, Madame, en cet instant funeste
La mort eſt le ſeul bien, ou l’eſpoir qui me reſte;	La mort est le seul bien, ou l’espoir qui me reste;
A mes ſens éperdus eſt-il rien de plus doux?	À mes sens éperdus est-il rien de plus doux?
C’eſt l’unique faveur que j’atendois de vous;	C’est l’unique faveur que j’attendais de vous;
Mais ſans avoir beſoin de vous pour l'entreprendre,	Mais sans avoir besoin de vous pour l’entreprendre,
Je feray mon deſtin en Femme d’Aiéxandre.	Je ferai mon destin en femme d’Alexandre.
J’entre. Dans un moment je reviens pres de vous,	J’entre. Dans un moment je reviens près de vous,
Et vous allez joüir d’un ſpéctacle ſi doux.	Et vous allez jouir d’un spectacle si doux.
QUe vois-je? Juſtes Dieux! où va-t-elle, Heſione?	QUe vois-je? Justes Dieux! Où va-t-elle, Hésione?
Son grand cœur me ſurprẽd, ſa fermeté m’étonne;	Son grand cœur me surprend, sa fermeté m’étonne;
Tandis que je la vois courir ſans s’étonner	Tandis que je la vois courir sans s’étonner
Au devant du trépas que je veux luy donner,	Au devant du trépas que je veux lui donner,
Elle ne peut ſurvivre au Héros qu’elle adore.	Elle ne peut survivre au Héros qu’elle adore.
Quoy? je l’aimois plus qu’elle, & je reſpire encore?	Quoi? je l’aimais plus qu’elle, et je respire encore?
Elle eſt venuë helas! dans ce triſte moment	Elle est venue hélas! dans ce triste moment
Me demander en pleurs les jours de ſon Amant.	Me demander en pleurs les jours de son Amant.
Barbare que je ſuis! ma noire jalouſie	Barbare que je suis! ma noire jalousie
A cet Amant ſi cher laiſſe perdre la vie?	À cet amant si cher laisse perdre la vie?
Oüy, mon amour devoit encor le conſerver,	Oui, mon amour devait encore le conserver,
Et dût-il eſtre ingrat, je devois le ſauver.	Et dût-il être ingrat, je devais le sauver.
Que dis-je? ma pitié m’auroit eſté fatale,	Que dis-je? ma pitié m’aurait été fatale,
Je l’aurois conſervé, pour qui? pour ma Rivale.	Je l’aurais conservé, pour qui? pour ma Rivale.
N’importe? Je devois.... Ah regrets ſuperflus!	N’importe? je devais… Ah regrets superflus!
ſe l’aurois veu du moins, & ne le verray plus.	Je l’aurais vu du moins, et ne le verrai plus.
Je ne le verray plus? & j'oſe luy ſurvivre?	Je ne le verrai plus! et j’ose lui survivre?
Ma Rivale m’aprend le chemin qu’il faut ſuivre;	Ma rivale m’apprend le chemin qu’il faut suivre;
Pleine de ſon amour, ſon cœur tranquilement	Pleine de son amour, son cœur tranquillement
Sçait meſurer ſa vie aux jours de ſon Amant.	Sait mesurer sa vie aux jours de son Amant.
Madame, elle revient.	Madame, elle revient.
O Serez-vous me ſuivre?	Ô serez-vous me suivre?
Quand on perd ce qu’on aime, il faut ceſſer de vivre,	Quand on perd ce qu’on aime, il faut cesser de vivre,
Je ſuis, graces aux Dieux, maiſtreſſe de mon ſort,	Je suis, grâces aux Dieux, maîtresse de mon sort,
Imitez-moy.	Imitez-moi.
Madame, un ſi cruel effort.	Madame, un si cruel effort.
M’étonne, me ſurprend, redouble mes allarmes;	M’étonne, me surprend, redouble mes alarmes;
Je vous vois, je frémis, & je verſe des larmes,	Je vous vois, je frémis, et je verse des larmes,
Je ſens mon ame en proye à toutes les horreurs,	Je sens mon âme en proie à toutes les horreurs,
Et voſtre amour enfin ſurpaſſe mes fureurs;	Et votre amour enfin surpasse mes fureurs;
Mais ce n’eſt pas aſſez que ma vie & la voſtre,	Mais ce n’est pas assez que ma vie et la vôtre,
Pour vanger voſtre Amant il nous en faut une autre;	Pour venger votre amant il nous en faut une autre;
Repoſez-vous ſur moy du ſoin de mon trépas,	Reposez-vous sur moi du soin de mon trépas,
Mais j’y veux, s’il ſe peut, entraîner Perdiccas;	Mais j’y veux, s’il se peut, entraîner Perdiccas;
Et ma douleur qui veut que ma main ſe retienne,	Et ma douleur, qui veut que ma main se retienne,
Ne retarde ma mort que pour haſter la ſienne.	Ne retarde ma mort que pour hâter la sienne.
Oüy, contre Perdiccas j’armeray Caſſander,	Oui, contre Perdiccas j’armerai Cassandre,
Et je vais avec luy rejoindre Antipater.	Et je vais avec lui rejoindre Antipater.
Je veux eſtre aujourd’huy le flambeau de la Guerre,	Je veux être aujourd’hui le flambeau de la Guerre,
Le Ciel va par mes mains conduire le Tonnerre,	Le Ciel va par mes mains conduire le Tonnerre,
Diviſer tous nos Chefs par leurs prétentions,	Diviser tous nos Chefs par leurs prétentions,
Et redoubler le feu de leurs diviſions,	Et redoubler le feu de leurs divisions,
Les enveloper tous, détruire l’un par l’autre,	Les envelopper tous, détruire l’un par l’autre,
Pour vanger voſtre Amant, mon Epoux, & le voſtre,	Pour venger votre amant, mon époux, et le vôtre,
Et donnant un champ libre a ma juſte fureur,	Et donnant un champ libre à ma juste fureur,
Faire de l’Univers un Théatre d’horreur.	Faire de l’Univers un Théâtre d’horreur.
Vous n’aurez pas encor bien du temps à m'attendre,	Vous n’aurez pas encore bien du temps à m’attendre;
Je vous ſuivray, Madame, en Femme d’Aléxandre,	Je vous suivrai, Madame, en Femme d’Alexandre,
Et ſi mon triſte amour a ſçeu vous outrager,	Et si mon triste amour a su vous outrager,
Voila, voila le Bras qui ſçaura vous vanger,	Voilà, voilà le Bras qui saura vous venger,
Je vous ſuivray de pres, Madame.	Je vous suivrai de près, Madame.
ELle eſt partie.	Elle est partie.
Madame, au nom des Dieux, ſongez à voſtre vie,	Madame, au nom des Dieux, songez à votre vie,
Il en eſt encor temps, & par un prompt ſecours	Il en est encore temps, et par un prompt secours
On peut....	On peut…
Laiſſes finir mes déplorables jours,	Laissez finir mes déplorables jours,
Je ſens qu’à ces malheurs le Ciel m’a condamnée,	Je sens qu’à ces malheurs le Ciel m’a condamnée,
Et tu voudrois en vain tromper ma deſtinée,	Et tu voudrais en vain tromper ma destinée,
Pouvois-je faire mieux? Alexandre n’eſt plus,	Pouvais-je faire mieux? Alexandre n’est plus,
J’oſe encor apres luy pleurer Leonatus,	J’ose encore après lui pleurer Léonatus,
Et puis que j’ay perdu dans ce moment funeſte	Et puisque j’ai perdu dans ce moment funeste
Un Epoux, un Amant, que m’importe du reſte?	Un époux, un Amant, que m’importe le reste?
Peut-eſtre cet Amant a-t-il un ſort plus doux,	Peut-être cet Amant a-t-il un sort plus doux,
Peut-eſtre que....	Peut-être que…
Non, non, Perdiccas eſt jaloux,	Non, non, Perdiccas est jaloux,
Le Cruel a couru ſans-doute à ſa défaite,	Le Cruel a couru sans doute à sa défaite,
Mais s’il vivoit encor, je mourrois ſatisfaite,	Mais s’il vivait encore, je mourrais satisfaite,
Je le verrois du moins, Cleone, & plût aux Dieux	Je le verrais du moins, Cléone, et plût aux Dieux
Que ce fidelle Amant vint me fermer les yeux.	Que ce fidèle amant vint me fermer les yeux.
Mais veux-tu, n’ayant plus cette douce eſpérance,	Mais veux-tu, n’ayant plus cette douce espérance,
Que du fier Perdiccas je ſois la récompenſe,	Que du fier Perdiccas je sois la récompense,
Que je ſois dans les fers de ceux dont autrefois	Que je sois dans les fers de ceux dont autrefois
Nous avons dédaigné de devenir les Roys?	Nous avons dédaigné de devenir les Rois?
Aux malheurs attachez à ma triſte Famille,	Aux malheurs attachés à ma triste Famille,
Tu dois de Darius reconnoiſtre la Fille;	Tu dois de Darius reconnaître la Fille;
Mais, grace au Ciel, je ſens la mort qui pas à pas	Mais, grâce au Ciel, je sens la mort qui pas à pas
S’avance lentement, & ne m’étonne pas,	S’avance lentement, et ne m’étonne pas,
De mes derniers momens je feray le partage,	De mes derniers moments je ferai le partage,
Aléxandre & mon Pere ont mon dernier homage,	Alexandre et mon père ont mon dernier hommage,
Et ſi j’oſe à ta foy confier mes deſirs,	Et si j’ose à ta foi confier mes désirs,
Leonatus, Cleone, à mes derniers ſoûpirs.	Léonatus, Cléone, à mes derniers soupirs.
CIel! je le vois, Madame, & contre voſtre attente.	CIel! je le vois, Madame, et contre votre attente.
Il eſt vivant, Cleone, & je mourray contente.	Il est vivant, Cléone, et je mourrai contente.
Sur tout, cache tes pleurs; helas! ſon triſte cœur	Surtout, cache tes pleurs; hélas! son triste cœur
Ne ſera que trop toſt inſtruit de ſon malheur.	Ne sera que trop tôt instruit de son malheur.
Madame, mon amour trembloit pour voſtre vie,	Madame, mon amour tremblait pour votre vie,
Mais enfin, je vous vois, & Roxane eſt partie;	Mais enfin, je vous vois, et Roxane est partie;
Caſſander, pour tromper Roxane & Perdiccas,	Cassandre, pour tromper Roxane et Perdiccas,
Luy meſme a fait ſemer le bruit de mon trépas,	Lui-même a fait semer le bruit de mon trépas,
Sa feinte a réüſſy; vous n’avez rien a craindre,	Sa feinte a réussi; vous n’avez rien à craindre,
Ils ſont hors de ces Murs, & ſans plus nous cõtraindre,	Ils sont hors de ces Murs, et sans plus nous contraindre,
Rendons graces aux Dieux d’avoir ſauvé des jours	Rendons grâces aux Dieux d’avoir sauvé des jours
Dont la perte des miens auroit borné le cours;	Dont la perte des miens aurait borné le cours;
Mon cœur de Perdiccas ne craint plus la furie,	Mon cœur de Perdiccas ne craint plus la furie,
Il poura, s’il le veut, attenter ſur ma vie,	Il pourra, s’il le veut, attenter sur ma vie,
La voſtre en ſeûreté....	La vôtre en sûreté…
Mes veux ſont exaucez,	Mes vœux sont exaucés,
Je vous vois, vous vivez, Seigneur, & c’eſt aſſez.	Je vous vois, vous vivez, Seigneur, et c’est assez.
Ah, Madame, ſongez à bannir vos allarmes;	Ah, Madame, songez à bannir vos alarmes;
Mais juſtes Dieux! pourquoy Cleone toute en larmes?	Mais, justes Dieux! pourquoi Cléone toute en larmes?
Ah! Seigneur....	Ah! Seigneur…
Je croiray tous mes malheurs finis,	Je croirai tous mes malheurs finis,
Lors que vous n’aurez plus à craindre d’Ennemis.	Lorsque vous n’aurez plus à craindre d’Ennemis.
Madame, quel diſcours....	Madame, quel discours…
J’ay quelque inquiétude	J'ai quelque inquiétude
Qui demande, Seigneur, un peu de ſolitude.	Qui demande, Seigneur, un peu de solitude.
Craignez de Perdiccas quelque nouvel effort,	Craignez de Perdiccas quelque nouvel effort,
Vous vivez, & je ſuis contente de mon ſort.	Vous vivez, et je suis contente de mon sort.
Je ne puis avec vous demeurer davantage,	Je ne puis avec vous demeurer davantage,
Mes yeux appeſantis ſe couvrent d’un nuage,	Mes yeux appesantis se couvrent d’un nuage,
J’entre, vous aprendrez le reſte en peu de temps;	J’entre, vous apprendrez le reste en peu de temps;
Mais ne me ſuivez pas, & je vous le défens.	Mais ne me suivez pas, et je vous le défends.
Adieu, Seigneur.	Adieu, Seigneur.
QUoy dõc? que me fait-elle entendre,	QUoi donc? que me fait-elle entendre,
Et quel eſt ce secret que je ne puis comprendre?	Et quel est ce secret que je ne puis comprendre?
Elle craint pour ma vie, & par un doux tranſport,	Elle craint pour ma vie, et par un doux transport,
M’oſe aſſurer qu’elle eſt contente de ſon ſort.	M’ose assurer qu’elle est contente de son sort.
De quel ſort, juſte Ciel! peut elle eſtre contente?	De quel sort, juste Ciel! peut-elle être contente?
Elle me croyoit mort, & contre ſon attente,	Elle me croyait mort, et contre son attente,
Elle me voit encor à ſes pieds... Mais, grands Dieux!	Elle me voit encore à ses pieds… Mais, grands Dieux!
Quel deſordre, quel trouble ay-je veu dans ſes yeux?	Quel désordre, quel trouble ai-je vu dans ses yeux?
Quel afreux changement marquoit ſur ſon viſage....	Quel affreux changement marquait sur son visage…
Je commence à percer ce funeſte nuage,	Je commence à percer ce funeste nuage,
Et ſes yeux, & ſon teint, & ſa ſombre pâleur,	Et ses yeux, et son teint, et sa sombre pâleur,
Tout ſemble ſur ſon front écrire mon malheur.	Tout semble sur son front écrire mon malheur.
Roxane, quoy Roxane, auroit elle.... Je tremble,	Roxane, quoi Roxane, aurait-elle… Je tremble,
J’entrevoy les malheurs que mon deſtin aſſemble.	J’entrevois les malheurs que mon destin assemble.
Allons, ſortons, il faut.... Mais quand je veux ſortir,	Allons, sortons, il faut… Mais quand je veux sortir,
Un long frémiſſement dont je me ſens ſaiſir,	Un long frémissement dont je me sens saisir,
Dans mes eſprits glacez venant à ſe répandre,	Dans mes esprits glacés venant à se répandre,
M'arreſte, & me dit trop ce que je n'oſe aprendre.	M’arrête, et me dit trop ce que je n’ose apprendre.
REmply de deſeſpoir, de fureur, & d’amour,	REmpli de désespoir, de fureur, et d’amour,
Seigneur, je vous cherchois pour vous ravir le jour,	Seigneur, je vous cherchais pour vous ravir le jour,
Et je me vois chargé du ſoin de voſtre vie.	Et je me vois chargé du soin de votre vie.
Quoy, Seigneur?	Quoi, Seigneur?
La pitié ſuccede à ma furie,	La pitié succède à ma furie,
J'en ay pour vous ſans-doute, & par un juſte effroy	J’en ai pour vous sans doute, et par un juste effroi
Dans un momẽt peut-eſtre en aurez vous pour moy.	Dans un moment peut-être en aurez-vous pour moi.
Ciel! je tremble.	Ciel! je tremble.
Incertain du ſort de la Princeſſe,	Incertain du sort de la Princesse,
Je la cherchois remply de crainte & de tendreſſe;	Je la cherchais rempli de crainte et de tendresse;
Je l’ay trouvée. Ah Dieux! elle eſtoit dans les bras	Je l’ai trouvée. Ah Dieu! elle était dans les bras
De Cleone. J’ay veu.... quel changement helas!	De Cléone. J’ai vu… quel changement, hélas!
Ses beaux yeux preſque éteints ſous leurfoible paupiere,	Ses beaux yeux presque éteints sous leur faible paupière,
A peine joüiſſoient d’un reſte de lumiere.	À peine jouissaient d’un reste de lumière.
Elle m’a reconnu, quand par un juſte effort	Elle m’a reconnu, quand par un juste effort
Le ſoin de voſtre vie a retardé ſa mort,	Le soin de votre vie a retardé sa mort,
Et par quelques ſoûpirs a d’une voix tremblante	Et par quelques soupirs a d’une voix tremblante
Tiré ces derniers mots de ſa bouche mourante.	Tiré ces derniers mots de sa bouche mourante.
Je meurs, a-t-elle dit, vos ſoins ſont ſuperflus;	Je meurs, a-t-elle dit, vos soins sont superflus;
Seigneur, ſi vous m’aimez, ſauvez Leonatus,	Seigneur, si vous m’aimez, sauvez Léonatus,
Empeſchez.... A ces mots... mes ſoûpirs & ma rage,	Empêchez… À ces mots… Mes soupirs et ma rage,
Mon deſeſpoir....	Mon désespoir…
Ah Dieux! quel funeſte langage?	Ah Dieux! quel funeste langage?
Quoy, Statira n’eſt plus!	Quoi, Statira n’est plus!
Par un poiſon fatal	Par un poison fatal
Vous n’avez plus d’Amante.	Vous n’avez plus d’Amante.
Et vous plus de Rival.	Et vous plus de Rival.
Je veux périr, il faut que la mort nous aſſemble.	Je veux périr, il faut que la mort nous assemble.
Oüy, Seigneur, périſſons, mais périſſons enſemble,	Oui, Seigneur, périssons, mais périssons ensemble,
Je viens pour la vanger, & mourir avec vous,	Je viens pour la venger, et mourir avec vous,
Mais perdons Caſſander & Roxane avec nous.	Mais perdons Cassandre et Roxane avec nous.
