ARRESTONS un moment. La pompe de ces Lieux,	ARRÊTONS un moment. La pompe de ces lieux,
Je le voy bien, Arſace, eſt nouvelle à tes yeux.	Je le vois bien, Arsace, est nouvelle à tes yeux.
Souvent ce Cabinet ſuperbe & ſolitaire,	Souvent ce Cabinet superbe et solitaire,
Des ſecrets de Titus eſt le dépoſitaire.	Des secrets de Titus est le dépositaire.
C’eſt icy quelquefois qu’il ſe cache à ſa Cour,	C’est ici quelquefois qu’il se cache à sa Cour,
Lors qu’il vient à la Reyne expliquer ſon amour.	Lorsqu’il vient à la Reine expliquer son amour.
De ſon Apartement cette porte eſt prochaine,	De son Appartement cette porte est prochaine,
Et cette autre conduit dans celuy de la Reyne,	Et cette autre conduit dans celui de la Reine,
Va chez elle. Dy-luy qu’importun à regret,	Va chez elle. Dis-lui qu’importun à regret,
J’oſe luy demander un entretien ſecret.	J’ose lui demander un entretien secret.
Vous, Seigneur, importun? Vous, cet Amy fidelle:	Vous, Seigneur, importun? Vous cet Ami fidèle:
Qu'un ſoin ſi genereux intereſſe pour elle?	Qu’un soin si généreux intéresse pour elle?
Vous, cet Antiochus, ſon Amant autrefois;	Vous, cet Antiochus, son Amant autrefois;
Vous, que l’Orient conte entre ſes plus grands Rois?	Vous, que l’Orient compte entre ses plus grands Rois?
Quoy déja de Titus l'Epouſe en eſperance,	Quoi déjà de Titus l'Épouse en espérance,
Ce rang entre elle & vous met-il tant de diſtance.	Ce rang entre elle et vous met-il tant de distance.
Va, dis-je, & ſans vouloir te charger d’autres ſoins;	Va, dis-je, et sans vouloir te charger d’autres soins;
Voy ſi je puis bientoſt luy parler ſans témoins.	Vois si je puis bientôt lui parler sans témoins.
HE' bien, Antiochus, es-tu toujours le meſme?	HÉ bien, Antiochus, es-tu toujours le même?
Pourray-je ſans trembler luy dire, Je vous aime?	Pourrai je sans trembler lui dire, je vous aime?
Mais quoy? Déjà je tremble, & mon cœur agité	Mais quoi? Déjà je tremble, et mon cœur agité
Craint autant ce moment que je l’ay ſouhaité.	Craint autant ce moment que je l’ai souhaité.
Berenice autrefois m’oſta toute eſperance.	Bérénice autrefois m’ôta toute espérance.
Elle m'impoſa meſme un eternel ſilence.	Elle m’imposa même un éternel silence.
Je me ſuis tû cinq ans. Et juſques à ce jour	Je me suis tu cinq ans. Et jusques à ce jour
D'un voile d'amitié j'ay couvert mon amour.	D’un voile d’amitié j’ai couvert mon amour.
Dois-je croire qu’au rang, ou Titus la deſtine,	Dois-je croire qu’au rang, où Titus la destine,
Elle m’écoute mieux que dans la Paleſtine?	Elle m’écoute mieux que dans la Palestine?
Il l'épouſe. Ay-je donc attendu ce moment	Il l’épouse. Ai-je donc attendu ce moment
Pour me venir encor declarer ſon Amant?	Pour me venir encor déclarer son Amant?
Ah! puis qu’il faut partir, partons ſans luy déplaire.	Ah! Puisqu’il faut partir, partons sans lui déplaire.
Je me ſuis tu long-temps, je puis encore me taire.	Je me suis tu longtemps, je puis encore me taire.
Retirons nous, ſortons, & ſans nous découvrir,	Retirons-nous, sortons, et sans nous découvrir,
Allons loin de ſes yeux l’oublier, ou mourir.	Allons loin de ses yeux l’oublier, ou mourir.
Hé quoy? ſouffrir toûjours un tourment qu'elle ignore?	Hé quoi? souffrir toujours un tourment qu’elle ignore?
Toûjours verſer des pleurs qu'il faut que je devore?	Toujours verser des pleurs qu’il faut que je dévore?
Quoy meſme en la perdant redouter ſon courroux?	Quoi même en la perdant redouter son courroux?
Belle Reyne; & pourquoy vous offenſeriez-vous?	Belle Reine; et pourquoi vous offenseriez-vous?
Viens-je vous demander que vous quittiez l’Empire,	Viens-je vous demander que vous quittiez l’Empire,
Que vous m’aimiez? Helas! je ne viens que vous dire,	Que vous m’aimiez? Hélas! je ne viens que vous dire,
Qu’apres m’eſtre longtemps flatté que mon Rival	Qu’après m’être longtemps flatté que mon Rival
Trouveroit à ſes vœux quelque obſtacle fatal;	Trouverait à ses vœux quelque obstacle fatal;
Aujourd’huy qu’il peut tout, que voſtre hymen s'avance,	Aujourd’hui qu’il peut tout, que votre hymen s’avance,
Exemple infortuné d'une longue conſtance,	Exemple infortuné d’une longue constance,
Apres cinq ans d’amour, & d'eſpoir ſuperflus,	Après cinq ans d’amour, et d’espoir superflus,
Je pars, fidelle encor quand je n’eſpere plus.	Je pars, fidèle encor quand je n’espère plus.
Au lieu de s'offenſer, elle pourra me plaindre,	Au lieu de s’offenser, elle pourra me plaindre.
Quoy qu’il en ſoit, parlõs, c’eſt aſſez nous contraindre,	Quoi qu’il en soit, parlons, c’est assez nous contraindre,
Et que peut craindre, helas! un Amant fans eſpoir	Et que peut craindre, hélas! un Amant sans espoir
Qui peut bien ſe reſoudre à ne la jamais voir?	Qui peut bien se résoudre à ne la jamais voir?
ARſace, entrerons-nous?	ARsace, entrerons-nous?
Seigneur, j’ay vû la Reyne.	Seigneur, j'ai vu la Reine.
Mais pour me faire voir, je n’ay percé qu'à peine	Mais pour me faire voir, je n’ai percé qu’à peine
Les flots toûjours nouveaux d’un Peuple adorateur	Les flots toujours nouveaux d’un Peuple adorateur
Qu’attire ſur ſes pas ſa prochaine grandeur.	Qu’attire sur ses pas sa prochaine grandeur.
Titus apres huit jours d’une retraites auſtere	Titus après huit jours d’une retraite austère
Ceſſe enfin de pleurer Veſpaſien ſon pere.	Cesse enfin de pleurer Vespasien son père.
Cet Amant ſe redonne aux ſoins de ſon amour.	Cet Amant se redonne aux soins de son amour.
Et ſi j'en croy, Seigneur, l'entretien de la Cour,	Et si j’en crois, Seigneur, l’entretien de la Cour,
Peut-eſtre avant la nuit l’heureuſe Berenice	Peut-être avant la nuit l’heureuse Bérénice
Change le nom de Reyne au nom d’Imperatrice.	Change le nom de Reine au nom d’Impératrice.
Helas!	Hélas!
Quoy? ce diſcours pourroit-il vous troubler?	Quoi? ce discours pourrait-il vous troubler?
Ainſi donc ſans témoins je ne luy puis parler?	Ainsi donc sans témoins je ne lui puis parler?
Vous la verrez, Seigneur. Berenice eſt inſtruite	Vous la verrez, Seigneur. Bérénice est instruite
Que vous voulez icy la voir ſeule, & ſans ſuite.	Que vous voulez ici la voir seule, et sans suite.
La Reyne d’un regard a daigné m'avertir	La Reine d’un regard a daigné m’avertir
Qu'à à voſtre empreſſement elle alloit conſentir.	Qu’à votre empressement elle allait consentir.
Et ſans doute elle attend le moment favorable	Et sans doute elle attend le moment favorable
De diſparoiſtre aux yeux d'une Cour qui l'accable.	De disparaître aux yeux d’une Cour qui l’accable.
Il ſuffit. Cependant n'as-tu rien négligé	Il suffit. Cependant n’as-tu rien négligé
Des ordres importans dont je t'avois chargé?	Des ordres importants dont je t’avais chargé?
Seigneur, vous connoiſſez ma promte obeïſſance.	Seigneur, vous connaissez ma prompte obéissance.
Des Vaiſſeaux dans Oſtie armez en diligence,	Des Vaisseaux dans Ostie armés en diligence,
Preſts à quitter le port de momens en momens,	Prêts à quitter le port de moments en moments,
N’attendent pour partir que vos commandemens.	N’attendent pour partir que vos commandements.
Mais qui renvoyez-vous dans voſtre Comagene?	Mais qui renvoyez-vous dans votre Comagène?
Arſace, il faut partir quand j'auray veû la Reyne.	Arsace, il faut partir quand j’aurai vu la Reine.
Qui doit partir?	Qui doit partir?
Moy.	Moi.
Vous?	Vous?
En ſortant du Palais,	En sortant du Palais,
Je ſors de Rome, Arſace, & j’en ſors pour jamais.	Je sors de Rome, Arsace, et j’en sors pour jamais.
Je ſuis ſurpris ſans doute, & c’eſt avec juſtice.	Je suis surpris sans doute, et c’est avec justice.
Quoy depuis ſi long-temps la Reyne Berenice	Quoi depuis si longtemps la Reine Bérénice
Vous arrache, Seigneur, du ſein de vos Eſtats,	Vous arrache, Seigneur, du sein de vos États,
Depuis trois ans dans Rome elle arreſte vos pas;	Depuis trois ans dans Rome elle arrête vos pas;
Et lors que cette Reyne aſſurant ſa conqueſte	Et lorsque cette Reine assurant sa conquête
Vous attend pour témoin de cette illuſtre Feſte,	Vous attend pour témoin de cette illustre Fête,
Quand l'amoureux Titus, devenant ſon Epoux,	Quand l’amoureux Titus devenant son Époux,
Luy prépare un éclat qui rejallit ſur vous....	Lui prépare un éclat qui rejaillit sur vous…
Arſace, laiſſe-la joüir de ſa fortune,	Arsace, laisse-la jouir de sa fortune,
Et quitte un entretien dont le cours m’importune.	Et quitte un entretien dont le cours m’importune.
Je vous entens, Seigneur. Ces meſmes dignitez	Je vous entends, Seigneur. Ces mêmes dignités
Ont rendu Berenice ingrate à vos bontez.	Ont rendu Bérénice ingrate à vos bontés.
L’inimitié ſuccede à l’amitié trahie.	L’inimitié succède à l’amitié trahie.
Non, Arſace, jamais je ne l'ay moins haïe.	Non, Arsace, jamais je ne l’ai moins haïe.
Quoy donc? De ſa grandeur déja trop prévenu,	Quoi donc? De sa grandeur déjà trop prévenu,
Le nouvel Empereur vous a-t-il méconnu?	Le nouvel Empereur vous a-t-il méconnu?
Quelque preſſentiment de ſon indifference	Quelque pressentiment de son indifférence
Vous fait-il loin de Rome éviter ſa preſence?	Vous fait-il loin de Rome éviter sa présence?
Titus n’a point pour moy paru ſe démentir,	Titus n’a point pour moi paru se démentir,
J’aurois tort de me plaindre.	J’aurais tort de me plaindre.
Et pourquoy donc partir?	Et pourquoi donc partir?
Quel caprice vous rend ennemy de vous-meſme?	Quel caprice vous rend ennemi de vous-même?
Le Ciel met ſur le Trône un Prince qui vous aime,	Le Ciel met sur le Trône un Prince qui vous aime,
Un Prince qui jadis témoin de vos combats	Un Prince qui jadis témoin de vos combats
Vous vit chercher la gloire & la mort ſur ſes pas,	Vous vit chercher la gloire et la mort sur ses pas,
Et de qui la valeur par vos ſoins ſecondée	Et de qui la valeur par vos soins secondée
Mit enfin ſous le joug la rebelle Judée.	Mit enfin sous le joug la rebelle Judée.
Il ſe ſouvient du jour illuſtre & douloureux	Il se souvient du jour illustre et douloureux
Qui décida du ſort d'un long ſiege douteux:	Qui décida du sort d’un long siège douteux:
Sur leur triple rempart les Ennemis tranquiles	Sur leur triple rempart les Ennemis tranquilles
Contemploient ſans peril nos aſſauts inutiles,	Contemplaient sans péril nos assauts inutiles,
Le Bellier impuiſſant les menaçoit en vain.	Le Bélier impuissant les menaçait en vain.
Vous ſeul, Seigneur, vous ſeul, une échelle à la main,	Vous seul, Seigneur, vous seul, une échelle à la main,
Vous portaſtes la mort juſques ſur leurs murailles.	Vous portâtes la mort jusque sur leurs murailles.
Ce jour preſque éclaira vos propres funerailles,	Ce jour presque éclaira vos propres funérailles,
Titus vous embraſſa mourant entre mes bras,	Titus vous embrassa mourant entre mes bras,
Et tout le camp vainqueur pleura voſtre trépas.	Et tout le camp vainqueur pleura votre trépas.
Voicy le temps, Seigneur, où vous devez attendre	Voici le temps, Seigneur, où vous devez attendre
Le fruit de tant de ſang qu’ils vous ont veû répandre.	Le fruit de tant de sang qu’ils vous ont vu répandre.
Si preſſé du deſir de revoir vos Eſtats	Si pressé du désir de revoir vos États
Vous vous laſſez de vivre, où vous ne regnez pas;	Vous vous lassez de vivre où vous ne régnez pas;
Faut-il que ſans honneur l’Euphrate vous revoye?	Faut-il que sans honneur l’Euphrate vous revoie?
Attendez pour partir que Céſar vous renvoye	Attendez pour partir que César vous renvoie
Triomphant, & chargé des titres ſouverains	Triomphant, et chargé des titres souverains
Qu'ajouſte encore aux Rois l’amitié des Romains.	Qu’ajoute encore aux Rois l’amitié des Romains.
Rien ne peut-il, Seigneur, changer voſtre entreprise?	Rien ne peut-il, Seigneur, changer votre entreprise?
Vous ne répondez point.	Vous ne répondez point.
Que veux-tu que je diſe?	Que veux-tu que je dise?
J'attens de Berenice un moment d’entretien.	J’attends de Bérénice un moment d’entretien.
Hé bien, Seigneur?	Hé bien, Seigneur?
Son ſort decidera du mien,	Son sort décidera du mien,
Comment?	Comment?
Sur ſon hymen j’attens qu’elle s’explique.	Sur son hymen j'attends qu'elle s'explique.
Si ſa bouche s’accorde avec la voix publique,	Si sa bouche s’accorde avec la voix publique,
S’il eſt vray qu'on l’éleve au trône des Céſars,	S’il est vrai qu’on l’élève au trône des Césars,
Si Titus a parlé, s’il l’épouſe, je pars.	Si Titus a parlé, s’il l’épouse, je pars.
Mais qui rend à vos yeux cet hymen ſi funeſte?	Mais qui rend à vos yeux cet hymen si funeste?
Quand nous ſerons partis, je te diray le reſte.	Quand nous serons partis, je te dirai le reste.
Dans quel trouble, Seigneur, jettez-vous mon eſprit!	Dans quel trouble, Seigneur, jetez-vous mon esprit!
La Reyne vient. Adieu, fai tout ce que j'ay dit.	La Reine vient. Adieu, fais tout ce que j’ai dit.
ENfin je me dérobe à la joye importune	Enfin je me dérobe à la joie importune
De tant d’Amis nouveaux, que me fait la Fortune	De tant d’Amis nouveaux, que me fait la Fortune.
Je fuis de leurs reſpects l’inutile longueur,	Je fuis de leurs respects l’inutile longueur,
Pour chercher un Amy, qui me parle du cœur.	Pour chercher un Ami, qui me parle du cœur.
Il ne faut point mentir, ma juſte impatience	Il ne faut point mentir, ma juste impatience
Vous accuſoit déja de quelque negligence.	Vous accusait déjà de quelque négligence.
Quoy cet Antiochus, diſois-je, dont les ſoins	Quoi cet Antiochus, disais-je, dont les soins
Ont eû tout l’Orient & Rome pour témoins,	Ont eu tout l’Orient et Rome pour témoins,
Luy que j’ay veû toujours conſtant dans mes traverſes	Lui que j’ai vu toujours constant dans mes traverses
Suivre d’un pas égal mes fortunes diverſes;	Suivre d’un pas égal mes fortunes diverses;
Aujourd’huy que le Ciel ſemble me preſager	Aujourd’hui que le Ciel semble me présager
Un honneur, qu'avec vous je prétens partager,	Un honneur, qu’avec vous je prétends partager,
Ce meſme Antiochus ſe cachant à ma veuë,	Ce même Antiochus se cachant à ma vue,
Me laiſſe à la mercy d’une foule inconnuë?	Me laisse à la merci d’une foule inconnue?
Il eſt donc vray, Madame? Et ſelon ce diſcours	Il est donc vrai, Madame? Et selon ce discours
L’hymen va ſucceder à vos longues amours?	L’hymen va succéder à vos longues amours?
Seigneur, je vous veux bien confier mes allarmes.	Seigneur, je vous veux bien confier mes alarmes.
Ces jours ont veû mes yeux baignez de quelques larmes.	Ces jours ont vu mes yeux baignés de quelques larmes.
Ce long deüil que Titus impoſoit à ſa Cour,	Ce long deuil que Titus imposait à sa Cour,
Avoit meſme en ſecret ſuſpendu ſon amour.	Avait même en secret suspendu son amour.
Il n’avoit plus pour moy cette ardeur aſſiduë	Il n’avait plus pour moi cette ardeur assidue
Lors qu’il paſſoit les jours, attaché ſur ma veuë.	Lorsqu’il passait les jours, attaché sur ma vue.
Müet, chargé de ſoins, & les larmes aux yeux,	Muet, chargé de soins, et les larmes aux yeux,
Il ne me laiſſoit plus que de triſtes Adieux.	Il ne me laissait plus que de tristes Adieux.
Jugez de ma douleur, moy dont l'ardeur extréme,	Jugez de ma douleur, moi dont l’ardeur extrême,
Je vous l'ay dit cent fois, n’aime en luy que luy-même,	Je vous l’ai dit cent fois, n’aime en lui que lui-même,
Moy qui loin des grandeurs, dont il eſt reveſtu,	Moi qui loin des grandeurs, dont il est revêtu,
Aurois choiſi ſon cœur, & cherché ſa vertu.	Aurais choisi son cœur, et cherché sa vertu.
Il a repris pour vous ſa tendreſſe premiere?	Il a repris pour vous sa tendresse première?
Vous fuſtes ſpectateur de cette nuit derniere,	Vous fûtes spectateur de cette nuit dernière,
Lors que, pour ſeconder les ſoins religieux,	Lorsque, pour seconder ses soins religieux,
Le Sénat a placé ſon Pere entre les Dieux.	Le Sénat a placé son Père entre les Dieux.
De ce juſte devoir ſa pieté contente	De ce juste devoir sa piété contente
A fait place, Seigneur, au ſoin de ſon Amante.	A fait place, Seigneur, au soin de son Amante.
Et meſme en ce moment, ſans qu’il m’en ait parlé,	Et même en ce moment, sans qu’il m’en ait parlé,
Il eſt dans le Senat par ſon ordre aſſemblé.	Il est dans le Sénat par son ordre assemblé.
Là de la Paleſtine il étend la frontiere,	Là de la Palestine il étend la frontière,
Il y joint l’Arabie, & la Syrie entiere.	Il y joint l’Arabie, et la Syrie entière.
Et ſi de ſes Amis j’en dois croire la voix,	Et si de ses Amis j’en dois croire la voix,
Si j’en crois ſes ſermons redoublez mille fois,	Si j’en crois ses serments redoublés mille fois,
Il va ſur tant d'Eſtats couronner Berenice,	Il va sur tant d’États couronner Bérénice,
Pour joindre à plus de noms le nom d’Imperatrice,	Pour joindre à plus de noms le nom d’Impératrice,
Il m'en viendra luy-meſme aſſurer en ce lieu.	Il m’en viendra lui-même assurer en ce lieu.
Et je viens donc vous dire un éternel adieu.	Et je viens donc vous dire un éternel adieu.
Que dites-vous! Ah Ciel! Quel adieu? Quel langage?	Que dites-vous! Ah Ciel! Quel adieu? Quel langage?
Prince, vous vous troublez, & changez de viſage?	Prince, vous vous troublez, et changez de visage?
Madame, il faut partir.	Madame, il faut partir.
Quoy? ne puis-je ſçavoir	Quoi? ne puis-je savoir
Quel ſujet....	Quel sujet…
Il falloit partir ſans la revoir.	Il fallait partir sans la revoir.
Que craignez-vous? Parlez, c'eſt trop long-temps ſe taire.	Que craignez-vous? Parlez, c’est trop longtemps se taire.
Seigneur, de ce départ quel eſt donc le myſtere?	Seigneur, de ce départ quel est donc le mystère?
Au moins, ſouvenez-vous que je cede à vos lois,	Au moins, souvenez-vous que je cède à vos lois,
Et que vous m’écoutez pour la derniere fois.	Et que vous m’écoutez pour la dernière fois.
Si dans ce haut degré de gloire & de puiſſance,	Si dans ce haut degré de gloire et de puissance,
Il vous ſouvient des lieux où vous priſtes naiſſance,	Il vous souvient des lieux où vous prîtes naissance,
Madame, il vous ſouvient que mon cœur en ces lieux	Madame, il vous souvient que mon cœur en ces lieux
Receût le premier trait qui partit de vos yeux.	Reçut le premier trait qui partit de vos yeux.
J’aimay, j'obtins l'aveu d'Agrippa voſtre Frere.	J’aimai, j’obtins l’aveu d’Agrippa votre Frère.
Il vous parla pour moy. Peut-eſtre ſans colere	Il vous parla pour moi. Peut-être sans colère
Alliez-vous de mon cœur recevoir le tribut,	Alliez-vous de mon cœur recevoir le tribut,
Titus, pour mon malheur, vint, vous vit, & vous plût.	Titus, pour mon malheur, vint, vous vit, et vous plut.
Il parut devant vous dans tout l’éclat d'un Homme	Il parut devant vous dans tout l’éclat d’un Homme
Qui porte entre ſes mains la vengeance de Rome.	Qui porte entre ses mains la vengeance de Rome.
La Judée en pâlit. La triſte Antiochus	La Judée en pâlit. Le triste Antiochus
Se conta le premier au nombre des vaincus.	Se compta le premier au nombre des vaincus.
Bientoſt de mon malheur interprete ſevere,	Bientôt de mon malheur interprète sévère,
Voſtre bouche à la mienne ordonna de ſe taire.	Votre bouche à la mienne ordonna de se taire.
Je diſputay longtemps, je fis parler mes yeux.	Je disputai longtemps, je fis parler mes yeux.
Mes pleurs & mes ſoûpirs vous ſuivoient en tous lieux.	Mes pleurs et mes soupirs vous suivaient en tous lieux.
Enfin voſtre rigueur emporta la balance,	Enfin votre rigueur emporta la balance,
Vous ſçeuſtes m'impoſer l'exil, ou le ſilence.	Vous sûtes m’imposer l’exil, ou le silence.
Il fallut le promettre, & meſme le jurer.	Il fallut le promettre, et même le jurer.
Mais, puisqu’en ce moment j'oſe me declarer,	Mais, puisqu’en ce moment j’ose me déclarer,
Lors que vous m’arrachiez cette injuſte promeſſe,	Lorsque vous m’arrachiez cette injuste promesse,
Mon cœur faiſoit ſerment de vous aimer ſans ceſſe.	Mon cœur faisait serment de vous aimer sans cesse.
Ah! Que me dites-vous?	Ah! Que me dites-vous?
Je me ſuis tû cinq ans,	Je me suis tu cinq ans,
Madame, & vais encor me taire plus longtemps.	Madame, et vais encor me taire plus longtemps.
De mon heureux Rival j'accompagnay les armes.	De mon heureux Rival j’accompagnai les armes.
J'eſperay de verſer mon ſang apres mes larmes,	J’espérai de verser mon sang après mes larmes,
Ou qu'au moins juſqu'à vous porté par mille exploits,	Ou qu’au moins jusqu’à vous porté par mille exploits,
Mon nom pourroit parler, au défaut de ma voix.	Mon nom pourrait parler, au défaut de ma voix.
Le Ciel ſembla promettre une fin à ma peine.	Le Ciel sembla promettre une fin à ma peine.
Vous pleuraſtes ma mort, helas! trop peu certaine.	Vous pleurâtes ma mort, hélas! trop peu certaine.
Inutiles périls! Quelle eſtoit mon erreur!	Inutiles périls! Quelle était mon erreur!
La valeur de Titus ſurpaſſoit ma fureur.	La valeur de Titus surpassait ma fureur.
Il faut qu’à ſa vertu mon eſtime réponde.	Il faut qu’à sa vertu mon estime réponde.
Quoy qu'attendu, Madame, à l’Empire du Monde,	Quoique attendu, Madame, à l’Empire du Monde,
Chery de l'Univers, enfin aimé de vous;	Chéri de l’Univers, enfin aimé de vous;
Il ſembloit à luy ſeul appeller tous les coups,	Il semblait à lui seul appeler tous les coups,
Tandis que ſans eſpoir, haï, laſſé de vivre,	Tandis que sans espoir, haï, lassé de vivre,
Son malheureux Rival ne ſembloit que le ſuivre.	Son malheureux Rival ne semblait que le suivre.
Je voy que voſtre cœur m’applaudit en ſecret,	Je vois que votre cœur m’applaudit en secret,
Je voy que l'on m’écoute avec moins de regret,	Je vois que l’on m’écoute avec moins de regret,
Et que trop attentive à ce recit funeſte,	Et que trop attentive à ce récit funeste,
En faveur de Titus vous pardonnez le reſte.	En faveur de Titus vous pardonnez le reste.
Enfin apres un ſiege auſſi cruel que lent,	Enfin après un siège aussi cruel que lent,
Il domta les mutins, reſte pâle & ſanglant	Il dompta les mutins, reste pâle et sanglant
Des flâmes, de la faim, des fureurs inteſtines,	Des flammes, de la faim, des fureurs intestines,
Et laiſſa leurs remparts cachez ſous leurs ruïnes.	Et laissa leurs remparts cachés sous leurs ruines.
Rome vous vit, Madame, arriver avec, luy.	Rome vous vit, Madame, arriver avec lui.
Dans l'Orient deſert quel devint mon ennuy!	Dans l’Orient désert quel devint mon ennui!
Je demeuray longtemps errant dans Céſarée,	Je demeurai longtemps errant dans Césarée,
Lieux charmans, où mon cœur vous avoit adorée.	Lieux charmants, où mon cœur vous avait adorée.
Je vous redemandois à vos triſtes Eſtats,	Je vous redemandais à vos tristes États,
Je cherchois en pleurant les traces de vos pas.	Je cherchais en pleurant les traces de vos pas.
Mais enfin ſuccombant à ma mélancolie,	Mais enfin succombant à ma mélancolie,
Mon deſeſpoir tourna mes pas vers l’Italie.	Mon désespoir tourna mes pas vers l’Italie.
Le Sort m'y reſervoit le dernier de ſes coups.	Le Sort m’y réservait le dernier de ses coups.
Titus en m’embraſſant m'amena devant vous.	Titus en m’embrassant m’amena devant vous.
Un voile d’amitié vous trompa l'un & l’autre;	Un voile d’amitié vous trompa l’un et l’autre;
Et mon amour devint le confident du voſtre.	Et mon amour devint le confident du vôtre.
Mais toujours quelque eſpoir flattoit mes déplaiſirs.	Mais toujours quelque espoir flattait mes déplaisirs.
Rome, Veſpaſien, traverſoient vos ſoûpirs.	Rome, Vespasien, traversaient vos soupirs.
Apres tant de combats Titus cedoit peut-eſtre.	Après tant de combats Titus cédait peut-être.
Veſpaſien eſt mort, & Titus eſt le Maiſtre.	Vespasien est mort, et Titus est le Maître.
Que ne fuyois-je alors! J’ay voulu quelques jours	Que ne fuyais-je alors! J’ai voulu quelques jours
De ſon nouvel empire examiner le cours.	De son nouvel empire examiner le cours.
Mon ſort eſt accomply. Voſtre gloire s’apreſte.	Mon sort est accompli. Votre gloire s’apprête.
Aſſez d'autres ſans moy, témoins de cette Feſte,	Assez d’autres sans moi, témoins de cette Fête,
A vos heureux tranſports viendront joindre les leurs.	À vos heureux transports viendront joindre les leurs.
Pour moy, qui ne pourrois y meſler que des pleurs,	Pour moi, qui ne pourrais y mêler que des pleurs,
D’un inutile amour trop conſtante victime,	D’un inutile amour trop constante victime,
Heureux dans mes malheurs, d’en avoir pû ſans crime,	Heureux dans mes malheurs, d’en avoir pu sans crime,
Conter toute l’hiſtoire aux yeux qui les ont faits,	Conter toute l’histoire aux yeux qui les ont faits,
Je pars plus amoureux que je ne fus jamais.	Je pars plus amoureux que je ne fus jamais.
Seigneur, je n'ay pas crû que dans une journée	Seigneur, je n’ai pas cru que dans une journée
Qui doit avec Céſar unir ma deſtinée,	Qui doit avec César unir ma destinée,
Il fuſt quelque Mortel qui puſt impunément	Il fût quelque Mortel qui pût impunément
Se venir à mes yeux déclarer mon Amant.	Se venir à mes yeux déclarer mon Amant.
Mais de mon Amitié mon ſilence eſt un gage,	Mais de mon Amitié mon silence est un gage,
J'oublie en ſa faveur un diſcours qui m'outrage.	J’oublie en sa faveur un discours qui m’outrage.
Je n’en ay point troublé le cours injurieux.	Je n’en ai point troublé le cours injurieux.
Je fay plus, A regret je reçoy vos adieux.	Je fais plus. À regret je reçois vos adieux.
Le Ciel ſçait qu’au milieu des honneurs qu’il m'envoye,	Le Ciel sait qu’au milieu des honneurs qu’il m’envoie,
Je n’attendois que vous pour témoin de ma joye.	Je n’attendais que vous pour témoin de ma joie.
Avec tout l'Uniuers j’honorois vos vertus,	Avec tout l’Univers j’honorais vos vertus,
Titus vous cheriſſoit, vous admiriez Titus.	Titus vous chérissait, vous admiriez Titus.
Cent fois je me ſuis fait une douceur extréme	Cent fois je me suis fait une douceur extrême
D’entretenir Titus dans un autre luy-méme.	D’entretenir Titus dans un autre lui-même.
Et c’eſt ce que je fuis. J’évite, mais trop tard,	Et c’est ce que je fuis. J’évite, mais trop tard,
Ces cruels entretiens où je n'ay point de part.	Ces cruels entretiens où je n’ai point de part.
Je fuis Titus. Je fuis ce nom qui m’inquiete,	Je fuis Titus. Je fuis ce nom qui m’inquiète,
Ce nom qu’à tous momens voſtre bouche repete.	Ce nom qu’à tous moments votre bouche répète.
Que vous diray-je enfin? Je fuis des yeux diſtraits	Que vous dirai-je enfin? Je fuis des yeux distraits
Qui me voyant toûjours ne me voyoient jamais.	Qui me voyant toujours ne me voyaient jamais.
Adieu, je vais le cœur trop plein de voſtre image,	Adieu, je vais le cœur trop plein de votre image,
Attendre en vous aimant la mort pour mon partage.	Attendre en vous aimant la mort pour mon partage.
Surtout ne craignez point qu’une aveugle douleur	Surtout ne craignez point qu’une aveugle douleur
Rempliſſe l’Univers du bruit de mon malheur,	Remplisse l’Univers du bruit de mon malheur,
Madame, le ſeul bruit d’une mort que j’implore,	Madame, le seul bruit d’une mort que j’implore,
Vous fera ſouvenir que je vivois encore.	Vous fera souvenir que je vivais encore.
Adieu.	Adieu.
Que je le plains! Tant de fidelité,	Que je le plains! Tant de fidélité,
Madame, meritoit plus de proſperité.	Madame, méritait plus de prospérité.
Ne le plaignez-vous pas?	Ne le plaignez-vous pas?
Cette prompte retraitte	Cette prompte retraite
Me laiſſe, je l'avouë, une douleur ſecrette.	Me laisse, je l’avoue, une douleur secrète.
Je l’aurois retenu.	Je l’aurais retenu.
Qui moy? Le retenir?	Qui moi? Le retenir?
J’en doy perdre plutoſt juſques au ſouvenir.	J’en dois perdre plutôt jusques au souvenir.
Tu veux donc que je flatte une ardeur inſenſée?	Tu veux donc que je flatte une ardeur insensée?
Titus n’a point encore expliqué la penſée.	Titus n’a point encore expliqué sa pensée.
Rome vous voit, Madame, avec des yeux jaloux,	Rome vous voit, Madame, avec des yeux jaloux,
La rigueur de ſes Loix m’épouvante pour vous.	La rigueur de ses Lois m’épouvante pour vous.
L’hymen chez les Romains n’admet qu’une Romaine.	L’hymen chez les Romains n’admet qu’une Romaine.
Rome hait tous les Rois, & Berenice eſt Reyne.	Rome hait tous les Rois, et Bérénice est Reine.
Le temps n’eſt plus, Phénice, où je pouvois trembler.	Le temps n’est plus, Phénice, où je pouvais trembler.
Titus m’aime, il peut tout, il n’a plus qu’à parler.	Titus m’aime, il peut tout, il n’a plus qu’à parler.
Il verra le Senat m’apporter ſes hommages,	Il verra le Sénat m’apporter ses hommages,
Et le Peuple, de fleurs couronner ſes images.	Et le Peuple de fleurs couronner ses images.
De cette nuit, Phénice, as-tu veu la ſplendeur?	De cette nuit, Phénice, as-tu vu la splendeur?
Tes yeux ne ſont-ils pas tous pleins de ſa grandeur?	Tes yeux ne sont-ils pas tous pleins de sa grandeur?
Ces flambeaux, ce Bucher, cette nuit enflâmée,	Ces flambeaux, ce Bûcher, cette nuit enflammée,
Ces Aigles, ces Faiſceaux, ce Peuple, cette Armée,	Ces Aigles, ces Faisceaux, ce Peuple, cette Armée,
Cette foule de Rois, ces Conſuls, ce Senat,	Cette foule de Rois, ces Consuls, ce Sénat,
Qui tous de mon Amant empruntoient leur éclat;	Qui tous de mon Amant empruntaient leur éclat;
Cette pourpre, cet or que rehauſſoit ſa gloire,	Cette pourpre, cet or que rehaussait sa gloire,
Et ces Lauriers encore témoins de ſa victoire,	Et ces Lauriers encor témoins de sa victoire,
Tous ces yeux, qu’on voyoit venir de toutes parts	Tous ces yeux, qu’on voyait venir de toutes parts
Confondre ſur luy ſeul leurs avides regards;	Confondre sur lui seul leurs avides regards;
Ce port majeſtueux, cette douce preſence.	Ce port majestueux, cette douce présence.
Ciel! avec quel reſpect, & quelle complaiſance,	Ciel! avec quel respect, et quelle complaisance,
Tous les cœurs en ſecret l’aſſuroient de leur foy!	Tous les cœurs en secret l’assuraient de leur foi!
Parle. Peut-on le voir fans penſer comme moy,	Parle. Peut-on le voir sans penser comme moi,
Qu’en quelque obſcurité que le ſort l'euſt fait naiſtre,	Qu’en quelque obscurité que le sort l’eût fait naître,
Le Monde, en le voyant euſt reconnu ſon Maiſtre?	Le Monde, en le voyant eût reconnu son Maître?
Mais, Phénice, où m’emporte un ſouvenir charmant?	Mais, Phénice, où m’emporte un souvenir charmant?
Cependant Rome entiere, en ce meſme moment,	Cependant Rome entière, en ce même moment,
Fait des vœux pour Titus, & par des ſacrifices	Fait des vœux pour Titus, et par des sacrifices
De ſon regne naiſſant conſacre les prémices.	De son règne naissant consacre les prémices.
Je prétens quelque part à des ſouhaits ſi doux.	Je prétends quelque part à des souhaits si doux.
Phénice, allons nous joindre aux vœux qu’on fait pour nous.	Phénice, allons nous joindre aux vœux qu’on fait pour nous.
Auſſitoſt ſans l’attendre, & ſans eſtre attenduë,	Aussitôt sans l’attendre, et sans être attendue,
Je reviens le chercher, & dans cette entreveuë	Je reviens le chercher, et dans cette entrevue
Dire tout ce qu’au cœur l'un de l’autre contens	Dire tout ce qu’au cœur l’un de l’autre contents
Inſpirent des tranſports retenus ſi long-temps.	Inspirent des transports retenus si longtemps.
AT-on veu de ma part le Roy de Comagene?	A-t-on vu de ma part le Roi de Comagène?
Sçait-il que je l’attens?	Sait-il que je l’attends?
J’ay couru chez la Reyne,	J'ai couru chez la Reine,
Dans ſon Apartement ce Prince avoit paru,	Dans son Appartement ce Prince avait paru,
Il en eſtoit ſorty lors que j’y ſuis couru.	Il en était sorti lorsque j’y suis couru.
De vos ordres, Seigneur, j’ay dit qu’on l’avertiſſe.	De vos ordres, Seigneur, j’ai dit qu’on l’avertisse.
Il ſuffit. Et que fait la Reyne Berenice?	Il suffit. Et que fait la Reine Bérénice?
La Reyne, en ce moment, ſenſilble à vos bontez,	La Reine, en ce moment, sensible à vos bontés,
Charge le Ciel de vœux pour vos proſperitez.	Charge le Ciel de vœux pour vos prospérités.
Elle ſortoit, Seigneur.	Elle sortait, Seigneur.
Trop aimable Princeſſe!	Trop aimable Princesse!
Helas!	Hélas!
En la faveur d’où naiſt cette triſteſſe?	En la faveur d'où naît cette tristesse?
L’Orient preſque entier va fléchir ſous ſa loy.	L’Orient presque entier va fléchir sous sa loi.
Vous la plaignez?	Vous la plaignez?
Paulin, qu'on vous laiſſe avec moy.	Paulin, qu'on vous laisse avec moi.
HE' bien, de mes deſſeins Rome encore incertaine	HÉ bien, de mes desseins Rome encore incertaine
Attend que deviendra le deſtin de la Reyne,	Attend que deviendra le destin de la Reine,
Paulin, & les ſecrets de ſon cœur & du mien	Paulin, et les secrets de son cœur et du mien
Sont de tout l’Univers devenus l’entretien.	Sont de tout l’Univers devenus l’entretien.
Voicy le temps enfin qu'il faut que je m’explique.	Voici le temps enfin qu’il faut que je m’explique.
De la Reyne & de moy que dit la voix publique?	De la Reine et de moi que dit la voix publique?
Parlez. Qu’entendez-vous?	Parlez. Qu’entendez-vous?
J’entens de tous coſtez	J'entends de tous côtés
Publier vos vertus, Seigneur, & ſes beautez,	Publier vos vertus, Seigneur, et ses beautés.
Que dit-on des ſoupirs que je pouſſe pour elle?	Que dit-on des soupirs que je pousse pour elle?
Quel ſuccés attend-on d’un amour ſi fidelle?	Quel succès attend-on d’un amour si fidèle?
Vous pouvez tout. Aimez, ceſſez d’eſtre amoureux;	Vous pouvez tout. Aimez, cessez d’être amoureux;
La Cour ſera toûjours du party de vos vœux.	La Cour sera toujours du parti de vos vœux.
Et je l’ay veuë auſſi cette Cour peu ſincere,	Et je l’ai vue aussi cette Cour peu sincère,
A ſes Maiſtres toujours trop ſoigneuſe de plaire,	À ses Maîtres toujours trop soigneuse de plaire,
Des crimes de Neron approuver les horreurs,	Des crimes de Néron approuver les horreurs,
Je l'ay veuë à genoux conſacrer ſes fureurs.	Je l’ai vue à genoux consacrer ses fureurs.
Je ne prens point pour Juge une Cour idolâtre;	Je ne prends point pour juge une Cour idolâtre;
Paulin, Je me propoſe un plus ample Theatre;	Paulin. Je me propose un plus ample Théâtre;
Et ſans preſter l’oreille à la voix des Flatteurs,	Et sans prêter l’oreille à la voix des Flatteurs,
Je veux par voſtre bouche entendre tous les Cœurs.	Je veux par votre bouche entendre tous les Cœurs.
Vous me l’avez promis. Le reſpect & la crainte	Vous me l’avez promis. Le respect et la crainte
Ferment autour de moy le paſſage à la plainte.	Ferment autour de moi le passage à la plainte.
Pour mieux voir, cher Paulin, & pour entendre mieux,	Pour mieux voir, cher Paulin, et pour entendre mieux,
Je vous ay demandé des oreilles, des yeux.	Je vous ai demandé des oreilles, des yeux.
J’ay mis meſme à ce prix mon amitié ſecrete,	J’ai mis même à ce prix mon amitié secrète,
J’ay voulu que des Cœurs vous fuſſiez l’Interprete,	J’ai voulu que des Cœurs vous fussiez l’Interprète,
Qu’au travers des Flatteurs voſtre ſincerité	Qu’au travers des Flatteurs votre sincérité
Fiſt toûjours juſqu'à moy paſſer la Verité.	Fît toujours jusqu’à moi passer la Vérité.
Parlez donc. Que faut-il que Berenice eſpere?	Parlez donc. Que faut-il que Bérénice espère?
Rome luy ſera-t'elle indulgente, ou ſevere?	Rome lui sera-t-elle indulgente, ou sévère?
Dois-je croire qu’aſſiſe au Trône des Céſars	Dois-je croire qu’assise au Trône des Césars
Une ſi belle Reyne offenſaſt ſes regards?	Une si belle Reine offensât ses regards?
N’en doutez point, Seigneur. Soit raiſon ou caprice,	N’en doutez point, Seigneur. Soit raison ou caprice,
Rome ne l’attend point pour ſon Imperatrice.	Rome ne l’attend point pour son Impératrice.
On ſçait qu’elle eſt charmante. Et de ſi belles mains	On sait qu’elle est charmante. Et de si belles mains
Semblent vous demander l’Empire des Humains.	Semblent vous demander l’Empire des Humains.
Elle a meſme, dit-on, le cœur d’une Romaine.	Elle a même, dit-on, le cœur d’une Romaine.
Elle a mille vertus. Mais, Seigneur, elle eſt Reyne.	Elle a mille vertus. Mais, Seigneur, elle est Reine.
Rome, par une Loy, qui ne ſe peut changer,	Rome, par une Loi, qui ne se peut changer,
N'admet avec ſon ſang aucun ſang étranger,	N’admet avec son sang aucun sang étranger,
Et ne reconnoiſt point les fruits illégitimes,	Et ne reconnaît point les fruits illégitimes,
Qui naiſſent d’un Hymen contraire à ſes maximes.	Qui naissent d’un Hymen contraire à ses maximes.
D’ailleurs, vous le ſçavez, en banniſſant ſes Rois,	D’ailleurs, vous le savez, en bannissant ses Rois,
Rome à ce nom ſi noble & ſi ſaint autrefois,	Rome à ce nom si noble, et si saint autrefois,
Attacha pour jamais une haine puiſſante;	Attacha pour jamais une haine puissante;
Et quoy qu'à ſes Céſars fidelle, obeïſſante,	Et quoique à ses Césars fidèle, obéissante,
Cette haine, Seigneur, reſte de ſa fierté,	Cette haine, Seigneur, reste de sa fierté,
Survit dans tous les cœurs apres la liberté.	Survit dans tous les cœurs après la liberté.
Jules, qui le premier la foûmit à ſes armes,	Jules, qui le premier la soumit à ses armes,
Qui fit taire les Lois dans le bruit des allarmes,	Qui fit taire les Lois dans le bruit des alarmes,
Brûla pour Cleopatre, & ſans ſe déclarer,	Brûla pour Cléopâtre, et sans se déclarer,
Seule dans l'Orient la laiſſa ſoupirer.	Seule dans l’Orient la laissa soupirer.
Antoine, qui l’aima juſqu’à l’idolâtrie,	Antoine, qui l’aima jusqu’à l’idolâtrie,
Oublia dans ſon ſein ſa gloire & ſa Patrie,	Oublia dans son sein sa gloire et sa Patrie,
Sans oſer toutefois ſe nommer ton Eſpoux.	Sans oser toutefois se nommer son Époux.
Rome l'alla chercher juſques à ſes genoux,	Rome l’alla chercher jusques à ses genoux,
Et ne deſarma point ſa fureur vengereſſe,	Et ne désarma point sa fureur vengeresse,
Qu'elle n’euſt accablé l'Amant & la Maiſtreſſe.	Qu’elle n’eût accablé l’Amant et la Maîtresse.
Depuis ce temps, Seigneur, Caligula, Neron,	Depuis ce temps, Seigneur, Caligula, Néron,
Monſtres, dont à regret je cite icy le nom,	Monstres, dont à regret je cite ici le nom,
Et qui ne conſervant que la figure d'Homme,	Et qui ne conservant que la figure d’Homme,
Foulerent à leurs pieds toutes les Lois de Rome,	Foulèrent à leurs pieds toutes les Lois de Rome,
Ont craint cette Loy ſeule, & n’ont point à nos yeux	Ont craint cette Loi seule, et n’ont point à nos yeux
Allumé le Flambeau d’un Hymen odieux.	Allumé le Flambeau d’un Hymen odieux.
Vous m'avez commandé ſur tout d'eſtre ſincere.	Vous m’avez commandé surtout d’être sincère.
De l’affranchy Pallas nous avons veu le Frere.	De l’affranchi Pallas nous avons vu le Frère.
Des fers de Claudius Felix encor flétry,	Des fers de Claudius Félix encor flétri,
De deux Reynes, Seigneur, devenir le Mary;	De deux Reines, Seigneur, devenir le Mari;
Et s’il faut juſqu'au bout que je vous obeïſſe,	Et s’il faut jusqu’au bout que je vous obéisse,
Ces deux Reynes eſtoient du ſang de Berenice.	Ces deux Reines étaient du sang de Bérénice.
Et vous pourriez, Seigneur, ſans bleſſer nos regards,	Et vous pourriez, Seigneur, sans blesser nos regards,
Faire entrer une Reyne au Lit de nos Ceſars,	Faire entrer une Reine au lit de nos Césars,
Tandis que l’Orient dans le Lit de ſes Reynes	Tandis que l’Orient dans le lit de ses Reines
Voir paſſer un Eſclave au ſortir de nos chaiſnes?	Voit passer un Esclave au sortir de nos chaînes?
C'eſt ce que les Romains penſent de voſtre amour.	C’est ce que les Romains pensent de votre amour.
Et je ne répons pas avant la fin du jour	Et je ne réponds pas avant la fin du jour
Que le Senat chargé des vœux de tout l’Empire,	Que le Sénat chargé des vœux de tout l’Empire,
Ne vous rediſe icy ce que je viens de dire:	Ne vous redise ici ce que je viens de dire:
Et que Rome avec luy tombant à vos genoux,	Et que Rome avec lui tombant à vos genoux,
Ne vous demande un choix digne d’elle & de vous.	Ne vous demande un choix digne d’elle et de vous.
Vous pouvez preparer, Seigneur, voſtre réponſe.	Vous pouvez préparer, Seigneur, votre réponse.
Hélas! A quel amour on veut que je renonce!	Hélas! À quel amour on veut que je renonce!
Cet amour eſt ardent, il le faut confeſſer.	Cet amour est ardent, il le faut confesser.
Plus ardent mille fois que tu ne peux penſer,	Plus ardent mille fois que tu ne peux penser,
Paulin. Je me ſuis fait un plaiſir neceſſaire	Paulin. Je me suis fait un plaisir nécessaire
De la voir chaque jour, de l'aimer, de luy plaire.	De la voir chaque jour, de l’aimer, de lui plaire.
J’ay fait plus. Je n'ay rien de ſecret à tes yeux.	J’ai fait plus. Je n’ai rien de secret à tes yeux.
J’ay pour elle cent fois rendu graces aux Dieux,	J’ai pour elle cent fois rendu grâces aux Dieux,
D’avoir choiſi mon Pere au fond de l’Idumée,	D’avoir choisi mon Père au fond de l’Idumée,
D’avoir rangé ſous luy l’Orient & l'Armée,	D’avoir rangé sous lui l’Orient et l’Armée,
Et ſoulevant encor le reſte des Humains,	Et soulevant encor le reste des Humains,
Remis Rome ſanglante en ſes paiſibles mains.	Remis Rome sanglante en ses paisibles mains.
J'ay meſme ſouhaitté la place de mon Pere,	J’ai même souhaité la place de mon Père,
Moy, Paulin, qui cent fois, ſi le Sort moins ſevere,	Moi, Paulin, qui cent fois, si le Sort moins sévère,
Euſt voulu de ſa vie étendre les liens,	Eût voulu de sa vie étendre les liens,
Aurois donné mes jours pour prolonger les ſiens.	Aurais donné mes jours pour prolonger les siens.
Tout cela (qu’un Amant ſçait mal ce qu'il deſire!)	Tout cela (qu’un Amant sait mal ce qu’il désire!)
Dans l'eſpoir d'élever Berenice à l'Empire,	Dans l’espoir d’élever Bérénice à l’Empire,
De reconnoiſtre un jour ſon amour & ſa foy,	De reconnaître un jour son amour et sa foi,
Et de voir à ſes pieds tout le monde avec moy.	Et de voir à ses pieds tout le monde avec moi.
Malgré tout mon amour, Paulin, & tous ſes charmes,	Malgré tout mon amour, Paulin, et tous ses charmes,
Apres mille ſermens appuyez de mes larmes,	Après mille serments appuyés de mes larmes,
Maintenant que je puis couronner tant d’attraits,	Maintenant que je puis couronner tant d’attraits,
Maintenant que je l’aime encor plus que jamais,	Maintenant que je l’aime encor plus que jamais,
Lors qu’un heureux hymen joignant nos deſtinées	Lorsqu’un heureux hymen joignant nos destinées
Peut payer en un jour les vœux de cinq années;	Peut payer en un jour les vœux de cinq années;
Je vais, Paulin.... O Ciel! puis-je le déclarer?	Je vais, Paulin… Ô Ciel! puis-je le déclarer?
Quoy, Seigneur?	Quoi, Seigneur?
Pour jamais je vais m'en ſeparer.	Pour jamais je vais m'en séparer.
Mon cœur en ce moment ne vient pas de ſe rendre,	Mon cœur en ce moment ne vient pas de se rendre,
Si je t’ay fait parler, ſi j’ay voulu t’entendre,	Si je t’ai fait parler, si j’ai voulu t’entendre,
Je voulois que ton zele achevaſt en ſecret	Je voulais que ton zèle achevât en secret
De confondre un amour qui ſe taiſt à regret.	De confondre un amour qui se tait à regret.
Berenice a longtemps balancé la victoire.	Bérénice a longtemps balancé la victoire.
Et ſi je panche enfin du coſté de ma Gloire,	Et si je penche enfin du côté de ma Gloire,
Croy qu’il m’en a couſté, pour vaincre tant d’amour.	Crois qu’il m’en a coûté, pour vaincre tant d’amour.
Des combats dont mon coeur ſaignera plus d'un jour.	Des combats dont mon cœur saignera plus d’un jour.
J’aimois, je ſoupirois dans une paix proſonde,	J’aimais, je soupirais dans une paix profonde,
Un autre eſtoit changé de l'Empire du Monde;	Un autre était chargé de l’Empire du Monde;
Maiſtre de mon deſtin, libre dans mes ſoupirs,	Maître de mon destin, libre dans mes soupirs,
Je ne rendois qu’à moy conte de mes deſirs.	Je ne rendais qu’à moi compte de mes désirs.
Mais à peine le Ciel eut rappellé mon Pere,	Mais à peine le Ciel eut rappelé mon Père,
Dés que ma triſte main eut fermé ſa paupiere,	Dès que ma triste main eut fermé sa paupière,
De mon aimable erreur je fus deſabuſé,	De mon aimable erreur je fus désabusé,
Je ſentis le fardeau qui m’eſtoit impoſé.	Je sentis le fardeau qui m’était imposé.
Je connus que bientoſt loin d’eſtre à ce que j’aime,	Je connus que bientôt loin d’être à ce que j’aime,
Il falloir, cher Paulin, renoncer à moy-meſme,	Il fallait, cher Paulin, renoncer à moi-même,
Et que le choix des Dieux, contraire à mes amours,	Et que le choix des Dieux, contraire à mes amours,
Livroit à l’Univers le reſte de mes jours.	Livrait à l’Univers le reste de mes jours.
Rome obſerve aujourd’huy ma conduite nouvelle.	Rome observe aujourd’hui ma conduite nouvelle.
Quelle honte pour moy! Quel préſage pour elle,	Quelle honte pour moi! Quel présage pour elle,
Si dés le premier pas renverſant tous ſes droits,	Si dès le premier pas renversant tous ses droits,
Je fondois mon bonheur ſur le débris des Lois!	Je fondais mon bonheur sur le débris des Lois!
Reſolu d’accomplir ce cruel ſacrifice,	Résolu d’accomplir ce cruel sacrifice,
J’y voulus préparer la triſte Berenice.	J’y voulus préparer la triste Bérénice.
Mais par où commencer? Vingt fois depuis huit jours	Mais par où commencer? Vingt fois depuis huit jours,
J’ay voulu devant elle en ouvrir le diſcours,	J’ai voulu devant elle en ouvrir le discours,
Et dés le premier mot ma langue embaraſſée	Et dès le premier mot ma langue embarrassée
Dans ma bouche vingt fois a demeuré glacée.	Dans ma bouche vingt fois a demeuré glacée.
J’eſperois que du moins mon trouble & ma douleur	J’espérais que du moins mon trouble et ma douleur
Luy feroit preſſentir noſtre commun malheur.	Lui ferait pressentir notre commun malheur.
Mais ſans me ſoupçonner, ſenſible à mes allarmes,	Mais sans me soupçonner, sensible à mes alarmes,
Elle m’offre ſa main pour eſſuyer mes larmes,	Elle m’offre sa main pour essuyer mes larmes,
Et ne prévoit rien moins dans cette obſcurité	Et ne prévoit rien moins dans cette obscurité
Que la fin d’un amour, quelle a trop merité.	Que la fin d’un amour, qu’elle a trop mérité.
Enfin j'ay ce matin rappellé ma conſtance.	Enfin j’ai ce matin rappelé ma constance.
Il faut la voir, Paulin, & rompre le ſilence.	Il faut la voir, Paulin, et rompre le silence.
J’attens Antiochus, pour luy recommander	J’attends Antiochus, pour lui recommander
Ce dépoſt précieux que je ne puis garder.	Ce dépôt précieux que je ne puis garder.
Juſques dans l'Orient je veux qu’il la remeine.	Jusque dans l’Orient je veux qu’il la ramène.
Demain Rome avec luy verra partir la Reyne.	Demain Rome avec lui verra partir la Reine.
Elle en ſera bientoſt inſtruite par ma voix,	Elle en sera bientôt instruite par ma voix,
Et je vais luy parler pour la derniere fois.	Et je vais lui parler pour la dernière fois.
Je n'attendois pas moins de cet amour de gloire	Je n’attendais pas moins de cet amour de gloire
Qui par tout apres vous attacha la Victoire.	Qui partout après vous attacha la Victoire.
La Judée aſſervie & ſes remparts fumans,	La Judée asservie, et ses remparts fumants,
De cette noble ardeur éternels monumens,	De cette noble ardeur éternels monuments,
Me répondoient aller que voſtre grand courage	Me répondaient assez que votre grand courage
Ne voudroit pas, Seigneur, détruire ſon ouvrage,	Ne voudrait pas, Seigneur, détruire son ouvrage,
Et qu’un Heros vainqueur de tant de Nations	Et qu’un Héros vainqueur de tant de Nations
Sçauroit bien toſt ou tard, vaincre ſes paſſions.	Saurait bien, tôt ou tard, vaincre ses passions.
Ah! que ſous de beaux noms cette Gloire eſt cruelle!	Ah! que sous de beaux noms cette Gloire est cruelle!
Combien mes triſtes yeux la trouveroient plus belle,	Combien mes tristes yeux la trouveraient plus belle,
S’il ne falloit encor qu’affronter le trépas!	S’il ne fallait encor qu’affronter le trépas!
Que dis-je? Cette ardeur que j'ay pour ſes appas,	Que dis-je? Cette ardeur que j’ai pour ses appas,
Berenice en mon ſein l’a jadis allumée.	Bérénice en mon sein l’a jadis allumée.
Tu ne l'ignores pas, toûjours la Renommée	Tu ne l’ignores pas, toujours la Renommée
Avec le meſme éclat n’a pas ſemé mon nom,	Avec le même éclat n’a pas semé mon nom,
Ma jeuneſſe nourrie à la Cour de Néron	Ma jeunesse nourrie à la Cour de Néron
S’égaroit cher Paulin, par l’exemple abuſée,	S’égarait cher Paulin, par l’exemple abusée,
Et ſuivoit du plaiſir la pente trop aiſée.	Et suivait du plaisir la pente trop aisée.
Berenice me plut. Que ne fait point un Cœur	Bérénice me plut. Que ne fait point un Cœur
Pour plaire à ce qu’il aime, & gagner ſon Vainqueur!	Pour plaire à ce qu’il aime, et gagner son Vainqueur!
Je prodiguay mon ſang. Tout fit place à mes armes.	Je prodiguai mon sang. Tout fit place à mes armes.
Je revins triomphant. Mais le ſang & les larmes	Je revins triomphant. Mais le sang et les larmes
Ne me ſuffiſoient pas pour meriter ſes vœux.	Ne me suffisaient pas pour mériter ses vœux.
J’entrepris le bonheur de mille malheureux.	J’entrepris le bonheur de mille malheureux.
On vit de toutes parts mes bontez ſe répandre;	On vit de toutes parts mes bontés se répandre;
Heureux! & plus heureux que tu ne peux comprendre,	Heureux! Et plus heureux que tu ne peux comprendre,
Quand je pouvois paroiſtre à ſes yeux ſatisfaits	Quand je pouvais paraître à ses yeux satisfaits
Chargé de mille cœurs conquis par mes bienfaits.	Chargé de mille cœurs conquis par mes bienfaits.
Je luy doy tout, Paulin. Recompenſe cruelle	Je lui dois tout, Paulin. Récompense cruelle
Tout ce que je luy doy va retomber ſur elle.	Tout ce que je lui dois va retomber sur elle.
Pour prix de tant de gloire & de tant de vertus,	Pour prix de tant de gloire et de tant de vertus,
Je luy diray, Partez & ne me voyez plus.	Je lui dirai, Partez, et ne me voyez plus.
Hé quoy, Seigneur, hé quoy? Cette magnificence	Hé quoi, Seigneur, hé quoi? Cette magnificence
Qui va juſqu'à l’Euphrate étendre ſa puiſſance,	Qui va jusqu’à l’Euphrate étendre sa puissance,
Tant d’honneurs, dont l’excés a ſurpris le Senat,	Tant d’honneurs, dont l’excès a surpris le Sénat,
Vous laiſſent-ils encor craindre le nom d’ingrat?	Vous laissent-ils encor craindre le nom d’ingrat?
Sur cent Peuples nouveaux Berenice commande.	Sur cent Peuples nouveaux Bérénice commande.
Foibles amuſemens d’une douleur ſi grande!	Faibles amusements d’une douleur si grande!
Je connoy Berenice, & ne ſçay que trop bien	Je connais Bérénice, et ne sais que trop bien
Que ſon cœur n’a jamais demandé que le mien.	Que son cœur n’a jamais demandé que le mien.
Je l’aimay, je luy plûs. Depuis cette journée,	Je l’aimai, je lui plus. Depuis cette journée,
(Dois-je dire funeſte, helas! ou fortunée?)	(Dois-je dire funeste, hélas! ou fortunée?)
Sans avoir en aimant d’objet que ſon amour,	Sans avoir en aimant d’objet que son amour,
Eſtrangere dans Rome, inconnue à la Cour,	Étrangère dans Rome, inconnue à la Cour,
Elle paſſe ſes jours, Paulin, ſans rien prétendre	Elle passe ses jours, Paulin, sans rien prétendre
Que quelque heure à me voir, & le reſte à m’attendre.	Que quelque heure à me voir, et le reste à m’attendre.
Encor ſi quelquefois un peu moins aſſidu	Encor si quelquefois un peu moins assidu
Je paſſe le moment, où je ſuis attendu,	Je passe le moment où je suis attendu,
Je la revoy bientoſt de pleurs toute trempée.	Je la revois bientôt de pleurs toute trempée.
Ma main à les ſecher eſt longtemps occupêe.	Ma main à les sécher est longtemps occupée.
Enfin tout ce qu’Amour a de nœuds plus puiſſans,	Enfin tout ce qu’Amour a de noeuds plus puissants,
Doux reproches, tranſports ſans ceſſe renaiſſans,	Doux reproches, transports sans cesse renaissants,
Soin de plaire ſans art, crainte toûjours nouvelle,	Soin de plaire sans art, crainte toujours nouvelle,
Beauté, Gloire, Vertu, je trouve tout en elle,	Beauté, Gloire, Vertu, je trouve tout en elle,
Depuis cinq ans entiers chaque jour je la vois,	Depuis cinq ans entiers chaque jour je la vois,
Et croy toûjours la voir pour la premiere fois.	Et crois toujours la voir pour la première fois.
N'y ſongeons plus. Allons, cher Paulin, plus j’y penſe,	N’y songeons plus. Allons, cher Paulin, plus j’y pense,
Plus je ſens chanceler ma cruelle confiance.	Plus je sens chanceler ma cruelle constance.
Quelle nouvelle, ô Ciel! je luy vais annoncer!	Quelle nouvelle, ô Ciel! je lui vais annoncer!
Encor un coup, allons, il n’y faut plus penſer.	Encor un coup, allons, il n’y faut plus penser.
Je connoy mon devoir, c’eſt à moy de le ſuivre,	Je connais mon devoir, c’est à moi de le suivre,
Je n’examine point ſi j’y pourray ſurvivre.	Je n’examine point si j’y pourrai survivre.
BErenice, Seigneur, demande à tous parler.	BÉrénice, Seigneur, demande à vous parler.
Ah Paulin!	Ah Paulin!
Quoy déja vous ſemblez reculer?	Quoi déjà vous semblez reculer?
De vos nobles projets, Seigneur, qu’il vous ſouvienne.	De vos nobles projets, Seigneur, qu’il vous souvienne.
Voicy le temps.	Voici le temps.
Hé bien, voyons-la. Qu'elle vienne.	Hé bien, voyons-la. Qu'elle vienne.
NE vous offenſez pas, ſi mon zele indiſcret	NE vous offensez pas, si mon zèle indiscret
De voſtre ſolitude interromp le ſecret.	De votre solitude interrompt le secret.
Tandis qu autour de moy voſtre Cour aſſemblée,	Tandis qu’autour de moi votre Cour assemblée,
Retentit des bienfaits dont vous m’avez comblée,	Retentit des bienfaits dont vous m’avez comblée,
Eſt-il juſte, Seigneur, que ſeule en ce moment	Est-il juste, Seigneur, que seule en ce moment
je demeure ſans voix & ſans reſſentiment!	Je demeure sans voix et sans ressentiment!
Mais Seigneur, (car je ſçay que cet Amy ſincere	Mais, Seigneur, (car je sais que cet Ami sincère
Du ſecret de nos coeurs connoiſt tout le myſtere)	Du secret de nos cœurs connaît tout le mystère)
Voſtre deüil eſt finy, rien n’arreſte vos pas,	Votre deuil est fini, rien n’arrête vos pas,
Vous eſtes ſeul enfin, & ne me cherchez pas.	Vous êtes seul enfin, et ne me cherchez pas.
J’entens que vous m’offrez un nouveau Diadéme,	J’entends que vous m’offrez un nouveau Diadème,
Et ne puis cependant vous entendre vous meſme.	Et ne puis cependant vous entendre vous-même.
Helas! plus de repos, Seigneur, & moins d’éclat.	Hélas! plus de repos, Seigneur, et moins d’éclat.
Voſtre amour ne peut-il paroiſtre qu’au Senat?	Votre amour ne peut-il paraître qu’au Sénat?
Ah Titus! Car enfin l’amour fuit la contrainte	Ah Titus! Car enfin l’amour fuit la contrainte
De tous ces noms, que ſuit le reſpect & la crainte.	De tous ces noms, que suit le respect et la crainte.
De quel ſoin voſtre amour va-t-il s’importuner?	De quel soin votre amour va-t-il s’importuner?
N’a-t-il que des Eſtats qu’il me puiſſe donner?	N’a-t-il que des États qu’il me puisse donner?
Depuis quand croyez-vous que ma grandeur me touche?	Depuis quand croyez-vous que ma grandeur me touche?
Un ſoupir, un regard, un mot de voſtre bouche,	Un soupir, un regard, un mot de votre bouche,
Voilà l’ambition d’un cœur comme le mien.	Voilà l’ambition d’un cœur comme le mien.
Voyez-moy plus ſouvent & ne me donnez rien.	Voyez-moi plus souvent et ne me donnez rien.
Tous vos momens ſont-ils dévoüez à l’Empire?	Tous vos moments sont-ils dévoués à l’Empire?
Ce cœur apres huit jours n’a-t-il rien à me dire?	Ce cœur après huit jours n’a-t-il rien à me dire?
Qu'un mot va raſſurer mes timides eſprits!	Qu’un mot va rassurer mes timides esprits!
Mais parliez-vous de moy, quand je vous ay surpris?	Mais parliez-vous de moi, quand je vous ai surpris?
Dans vos ſecrets diſcours eſtois-je intereſſée.	Dans vos secrets discours étais-je intéressée.
Seigneur? Eſtois-je au moins preſente à la penſée?	Seigneur? Étais-je au moins présente à la pensée?
N’en doutez point, Madame, & j’atteſte les Dieux	N’en doutez point, Madame, et j’atteste les Dieux
Que toûjours Berenice eſt preſente à mes yeux.	Que toujours Bérénice est présente à mes yeux.
L'abſence, ni le temps, je vous le jure encore,	L’absence, ni le temps, je vous le jure encore,
Ne vous peuvent ravir ce cœur qui vous adore.	Ne vous peuvent ravir ce cœur qui vous adore.
Hé quoy? vous me jurez une éternelle ardeur,	Hé quoi? vous me jurez une éternelle ardeur,
Et vous me la jurez avec cette froideur?	Et vous me la jurez avec cette froideur?
Pourquoy des Immortels atteſter la puiſſance?	Pourquoi des Immortels attester la puissance?
Faut-il par des ſermens vaincre ma défiance?	Faut-il par des serments vaincre ma défiance?
Mon cœur ne prétend point, Seigneur, vous démentir,	Mon cœur ne prétend point, Seigneur, vous démentir,
Et je vous en croiray ſur un ſimple ſoûpir.	Et je vous en croirai sur un simple soupir.
Madame....	Madame…
Hé bien, Seigneur? Mais quoy ſans me répondre	Hé bien, Seigneur? Mais quoi sans me répondre
Vous détournez les yeux & ſemblez vous confondre.	Vous détournez les yeux, et semblez vous confondre.
Ne m'offrirez-vous plus qu’un viſage interdit?	Ne m’offrirez-vous plus qu’un visage interdit?
Toûjours la mort d'un Pere occupe voſtre eſprit?	Toujours la mort d’un Père occupe votre esprit?
Rien ne peut-il charmer l’ennuy qui vous devore?	Rien ne peut-il charmer l’ennui qui vous dévore?
Pluſt aux Dieux que mon Pere, helas, veſcuſt encore!	Plût aux Dieux que mon Père, hélas, vécût encore!
Que je vivois heureux!	Que je vivais heureux!
Seigneur, tous ces regrets	Seigneur, tous ces regrets
De voſtre pieté ſont de juſtes effets.	De votre piété sont de justes effets.
Mais vos pleurs ont aſſez honoré ſa Memoire,	Mais vos pleurs ont assez honoré sa Mémoire,
Vous devez d’autres ſoins à Rome, à voſtre Gloire:	Vous devez d’autres soins à Rome, à votre Gloire:
De mon propre intereſt je n’oſe vous parler.	De mon propre intérêt je n’ose vous parler.
Berenice autrefois pouvoir vous conſoler.	Bérénice autrefois pouvait vous consoler.
Avec plus de plaiſir vous m'avez écoutée.	Avec plus de plaisir vous m’avez écoutée.
De combien de malheurs pour vous perſecutée	De combien de malheurs pour vous persécutée
Vous ay-je pour un mot ſacrifié mes pleurs!	Vous ai-je pour un mot sacrifié mes pleurs!
Vous regrettez un Pere, Helas, foibles douleurs!	Vous regrettez un Père. Hélas, faibles douleurs!
Et moy (ce ſouvenir me fait frémir encore)	Et moi (ce souvenir me fait frémir encore)
On vouloir m’arracher de tout ce que j’adore,	On voulait m’arracher de tout ce que j’adore,
Moy, dont vous connoiſſez le trouble & le tourment,	Moi, dont vous connaissez le trouble et le tourment,
Quand vous ne me quittez que pour quelque moment,	Quand vous ne me quittez que pour quelque moment,
Moy, qui mourrois le jour qu’on voudroit m’interdire	Moi, qui mourrais le jour qu’on voudrait m’interdire
De vous....	De vous…
Madame, helas! que me venez-vous dire?	Madame, hélas! que me venez-vous dire?
Quel temps choiſiſſez-vous! Ah de grace, arreſtez.	Quel temps choisissez-vous! Ah de grâce, arrêtez.
C'eſt trop pour un Ingrat prodiguer vos bontez.	C’est trop pour un Ingrat prodiguer vos bontés.
Pour un Ingrat, Seigneur! Et le pouvez-vous eſtre?	Pour un Ingrat, Seigneur! Et le pouvez-vous être?
Ainſi donc mes bontez vous fatiguent peut-eſtre?	Ainsi donc mes bontés vous fatiguent peut-être?
Non, Madame. Jamais, puis qu’il faut vous parler,	Non, Madame. Jamais, puisqu’il faut vous parler,
Mon coeur de plus de feux ne ſe ſentit bruler.	Mon cœur de plus de feux ne se sentit brûler.
Mais....	Mais…
Achevez.	Achevez.
Helas!	Hélas!
Parlez,	Parlez,
Rome.... L’Empire...	Rome… L'Empire…
Hé bien?	Hé bien?
Sortons, Paulin, je ne luy puis rien dire.	Sortons, Paulin, je ne lui puis rien dire.
QUoy me quitter ſi-toſt, & ne me dire rien?	QUoi me quitter sitôt, et ne me dire rien?
Chere Phénice, helas! Quel funeſte entretien!	Chère Phénice, hélas! Quel funeste entretien!
Qu'ay-je fait? Que veut-il? Et que dit ce ſilence?	Qu’ai-je fait? Que veut-il? Et que dit ce silence?
Comme vous je me perds d’autant plus que j’y penſe.	Comme vous je me perds d’autant plus que j’y pense.
Mais ne s’offre-t-il rien à voſtre ſouvenir?	Mais ne s’offre-t-il rien à votre souvenir?
Qui contre vous, Madame, ait pu le prévenir?	Qui contre vous, Madame, ait pu le prévenir?
Voyez, examinez.	Voyez, examinez.
Helas, tu peux m’en croire;	Hélas, tu peux m'en croire;
Plus je veux du paſſé rappeller la memoire,	Plus je veux du passé rappeler la mémoire,
Du jour que je le vis, juſqu’à ce triſte jour,	Du jour que je le vis, jusqu’à ce triste jour,
Plus je voy qu’on me peut reprocher trop d’amour.	Plus je vois qu’on me peut reprocher trop d’amour.
Mais tu nous entendois. Il ne faut rien me taire.	Mais tu nous entendais. Il ne faut rien me taire.
Parle. N’ay-je rien dit qui luy puiſſe déplaire?	Parle. N’ai-je rien dit qui lui puisse déplaire?
Que ſçay-je? J’ay peut-eſtre avec trop de chaleur	Que sais-je? J’ai peut-être avec trop de chaleur
Rabaiſſé ſes préſens, ou blâmé ſa douleur.	Rabaissé ses présents, ou blâmé sa douleur.
N’eſt-ce point que de Rome il redoute la haine?	N’est-ce point que de Rome il redoute la haine?
Il craint peut-eſtre, il craint d'épouſer une Reyne.	Il craint peut-être, il craint d’épouser une Reine.
Helas! s’il eſtoit vray.... Mais non, il a cent fois	Hélas! s’il était vrai… Mais non, il a cent fois
Raſſuré mon amour contre leurs dures Lois.	Rassuré mon amour contre leurs dures Lois.
Cent fois.. Ah! Qu’il m’explique un ſilence ſi rude.	Cent fois… Ah! Qu’il m’explique un silence si rude.
Je ne reſpire pas dans cette incertitude.	Je ne respire pas dans cette incertitude.
Moy, je vivrois, Phenice, & je pourrois penſer	Moi, je vivrais, Phénice, et je pourrais penser
Qu'il me neglige, ou bien que j’ay pu l’offenſer?	Qu’il me néglige, ou bien que j’ai pu l’offenser?
Retournons ſur ſes pas. Mais quand je m'examine,	Retournons sur ses pas. Mais quand je m’examine,
Je croy de ce deſordre entrevoir l’origine,	Je crois de ce désordre entrevoir l’origine,
Phénice, il aura ſceu tout ce qui s’eſt paſſé.	Phénice, il aura su tout ce qui s’est passé.
L'amour d’Antiochus l’a peut-eſtre offenſé.	L’amour d’Antiochus l’a peut-être offensé.
Il attend, m’a-t-on dit, le Roy de Comagene.	Il attend, m’a-t-on dit, le Roi de Comagène.
Ne cherchons point ailleurs le ſujet de ma peine.	Ne cherchons point ailleurs le sujet de ma peine.
Sans doute ce chagrin qui vient de m’allarmer,	Sans doute ce chagrin qui vient de m’alarmer,
N’eſt qu’un leger ſoupçon facile à deſarmer.	N’est qu’un léger soupçon facile à désarmer.
Je ne te vante point cette foible victoire,	Je ne te vante point cette faible victoire,
Titus. Ah, pluſt au Ciel, que ſans bleſſer ta gloire,	Titus. Ah, plût au Ciel, que sans blesser ta gloire,
Un Rival plus puiſſant vouluſt tenter ma foy,	Un Rival plus puissant voulût tenter ma foi,
Et peuſt mettre à mes piez plus d’Empires qu toy,	Et pût mettre à mes pieds plus d’Empires que toi,
Que de Sceptres ſans nombre il puſt payer ma flâme,	Que de Sceptres sans nombre il pût payer ma flamme,
Que ton amour n'euſt rien à donner que ton ame;	Que ton amour n’eût rien à donner que ton âme;
C'eſt alors, cher Titus, qu’aimé, victorieux,	C’est alors, cher Titus, qu’aimé, victorieux,
Tu verrois de quel prix ton cœur eſt à mes yeux.	Tu verrais de quel prix ton cœur est à mes yeux.
Allons, Phénice, un mot pourra le ſatisfaire.	Allons, Phénice, un mot pourra le satisfaire.
Raſſurons-nous, mon cœur, je puis encor luy plaire.	Rassurons-nous, mon cœur, je puis encor lui plaire.
Je me contois trop toſt au rang des Malheureux.	Je me comptais trop tôt au rang des Malheureux.
Si Titus eſt jaloux, Titus eſt amoureux.	Si Titus est jaloux, Titus est amoureux.
QUoy, Prince, vous partiez? Quelle raiſon ſubite	QUoi, Prince, vous partiez? Quelle raison subite
Preſſe voſtre depart, ou plutoſt voſtre fuite?	Presse votre départ, ou plutôt votre fuite?
Vouliez-vous me cacher juſques à vos Adieux?	Vouliez-vous me cacher jusques à vos Adieux?
Eſt-ce comme Ennemy que vous quittez ces Lieux?	Est-ce comme Ennemi que vous quittez ces lieux?
Que diront avec moy, la Cour, Rome, l’Empire?	Que diront avec moi, la Cour, Rome, l’Empire?
Mais comme voſtre Amy que ne puis-je point dire?	Mais comme votre Ami que ne puis-je point dire?
De quoy m'accuſez-vous? Vous avois je ſans choix	De quoi m’accusez-vous? Vous avais-je sans choix
Confondu juſqu’icy dans la foule des Rois?	Confondu jusqu’ici dans la foule des Rois?
Mon cœur vous fut ouvert tant qu’a veſcu mon Pere.	Mon cœur vous fut ouvert tant qu’a vécu mon Père.
C'eſtoit le ſeul preſent que je pouvois vous faire.	C’était le seul présent que je pouvais vous faire.
Et lors qu’avec mon cœur ma main peut s’épancher,	Et lorsqu’avec mon cœur ma main peut s’épancher,
Vous fuyez mes bienfaits tout preſts à vous chercher?	Vous fuyez mes bienfaits tout prêts à vous chercher?
Penſez-vous qu’oubliant ma fortune paſſée	Pensez-vous qu’oubliant ma fortune passée
Sur ma ſeule grandeur j’arreſte ma penſée?	Sur ma seule grandeur j’arrête ma pensée?
Et que tous mes Amis s’y préſentent de loin	Et que tous mes Amis s’y présentent de loin
Comme autant d’Inconnus, dont je n'ay plus beſoin?	Comme autant d’Inconnus, dont je n’ai plus besoin?
Vous-méme, à mes regards qui vouliez vous ſouſtraire,	Vous-même, à mes regards qui vouliez vous soustraire,
Prince, plus que jamais vous m'eſtes neceſſaire.	Prince, plus que jamais vous m’êtes nécessaire.
Moy, Seigneur?	Moi, Seigneur?
Vous.	Vous.
Helas! D’un Prince malheureux,	Hélas! D'un Prince malheureux,
Que pouvez-vous, Seigneur, attendre que des vœux?	Que pouvez-vous, Seigneur, attendre que des vœux?
Je n'ay pas oublié, Prince, que ma victoire	Je n’ai pas oublié, Prince, que ma victoire
Devoit à vos exploits la moitié de ſa gloire,	Devait à vos exploits la moitié de sa gloire,
Que Rome vit paſſer au nombre des Vaincus	Que Rome vit passer au nombre des Vaincus
Plus d’un Captif, chargé des fers d’Antiochus,	Plus d’un Captif, chargé des fers d’Antiochus,
Que dans le Capitole elle voit attachées	Que dans le Capitole elle voit attachées
Les dépoüilles des Juifs par vos mains arrachées.	Les dépouilles des Juifs par vos mains arrachées.
Je n'attens pas de vous de ces ſanglans exploits,	Je n’attends pas de vous de ces sanglants exploits,
Et je veux ſeulement emprunter voſtre voix.	Et je veux seulement emprunter votre voix.
Je ſçay que Berenice à vos ſoins redevable	Je sais que Bérénice à vos soins redevable
Croit poſſeder en vous un Amy veritable.	Croit posséder en vous un Ami véritable.
Elle ne voit dans Rome & n’écoute que vous.	Elle ne voit dans Rome et n’écoute que vous.
Vous ne faites qu’un cœur & qu’une ame avec nous.	Vous ne faites qu’un cœur et qu’une âme avec nous.
Au nom d’une Amitié ſi conſtante, & ſi belle,	Au nom d’une Amitié si constante, et si belle,
Employez le pouvoir que vous avez ſur elle.	Employez le pouvoir que vous avez sur elle.
Voyez-la de ma part.	Voyez-la de ma part.
Moy? paroiſtre à ſes yeux.	Moi? paraître à ses yeux.
La Reyne pour jamais a receu mes adieux.	La Reine pour jamais a reçu mes adieux.
Prince, il faut que pour moy vous luy parliez encore.	Prince, il faut que pour moi vous lui parliez encore.
Ah! parlez-luy, Seigneur, la Reyne vous adore.	Ah! parlez-lui, Seigneur, la Reine vous adore.
Pourquoy vous dérober vous-meſme en ce moment	Pourquoi vous dérober vous-même en ce moment
Le plaiſir de luy faire un aveu ſi charmant?	Le plaisir de lui faire un aveu si charmant?
Elle l’attend, Seigneur, avec impatience.	Elle l’attend, Seigneur, avec impatience.
Je répons en partant de ſon obeïſſance.	Je réponds en partant de son obéissance.
Et meſme elle m'a dit, que preſt à l'épouſer,	Et même elle m’a dit que prêt à l’épouser,
Vous ne la verrez plus que pour l’y diſpoſer.	Vous ne la verrez plus que pour l’y disposer.
Ah! Qu'un aveu ſi doux auroit lieu de me plaire!	Ah! Qu’un aveu si doux aurait lieu de me plaire!
Que je ſerois heureux, ſi j’avois à le faire!	Que je serais heureux, si j’avais à le faire!
Mes tranſports aujourd’huy s’attendoient d’éclatter.	Mes transports aujourd’hui s’attendaient d’éclater.
Cependant aujourd’huy, Prince, il faut la quitter.	Cependant aujourd’hui, Prince, il faut la quitter.
La quitter. Vous, Seigneur?	La quitter. Vous, Seigneur?
Telle eſt ma deſtinée.	Telle est ma destinée.
Pour elle, & pour Titus, il n’eſt plus d’hymenée.	Pour elle, et pour Titus, il n’est plus d’hyménée.
D’un eſpoir ſi charmant je me flattois en vain,	D’un espoir si charmant je me flattais en vain.
Prince, il faut avec vous qu'elle parte demain,	Prince, il faut avec vous qu’elle parte demain.
Qu’entens-je! O Ciel!	Qu’entends-je? Ô Ciel!
Plaignez ma grandeur importune.	Plaignez ma grandeur importune.
Maiſtre de l'Univers je regle ſa Fortune.	Maître de l’Univers je règle sa Fortune.
Je puis faire les Roys, je puis les dépoſer.	Je puis faire les Rois, je puis les déposer.
Cependant de mon cœur je ne puis diſpoſer.	Cependant de mon cœur je ne puis disposer.
Rome contre les Roys de tout temps ſoulevée,	Rome contre les Rois de tout temps soulevée,
Dédaigne une Beauté dans la pourpre élevée,	Dédaigne une Beauté dans la pourpre élevée,
L’éclat du Diadéme, & cent Roys pour Ayeux	L’éclat du Diadème, et cent Rois pour Aïeux
Deſ-honorent ma flâme, & bleſſent tous les yeux.	Déshonorent ma flamme, et blessent tous les yeux.
Mon cœur libre d’ailleurs, ſans craindre les murmures,	Mon cœur libre d’ailleurs, sans craindre les murmures,
Peut brûler à ſon choix dans des flâmes obſcures,	Peut brûler à son choix dans des flammes obscures,
Et Rome avec plaiſir recevroit de ma main	Et Rome avec plaisir recevrait de ma main
La moins digne Beauté, qu’elle cache en ſon ſein.	La moins digne Beauté, qu’elle cache en son sein.
Jules ceda luy-meſme au torrent qui m’entraîne,	Jules céda lui-même au torrent qui m’entraîne,
Si le Peuple demain ne voit partir la Reyne.	Si le Peuple demain ne voit partir la Reine.
Demain elle entendra ce Peuple furieux	Demain elle entendra ce Peuple furieux
Me venir demander ſon depart à ſes yeux.	Me venir demander son départ à ses yeux.
Sauvons de cet affront mon nom, & ſa memoire.	Sauvons de cet affront mon nom, et sa mémoire.
Et puis qu'il faut ceder, cedons à noſtre gloire.	Et puisqu’il faut céder, cédons à notre gloire.
Ma bouche, & mes regards muets depuis huit jours,	Ma bouche, et mes regards muets depuis huit jours,
L’auront pu préparer à ce triſte diſcours.	L’auront pu préparer à ce triste discours.
Et meſme en ce moment, inquiete, empreſſée,	Et même en ce moment, inquiète, empressée,
Elle veut qu’à ſes yeux j’explique ma penſée.	Elle veut qu’à ses yeux j’explique ma pensée.
D’un Amant interdit ſoulagez le tourment,	D’un Amant interdit soulagez le tourment.
Epargnez à mon cœur cet éclairciſſement.	Épargnez à mon cœur cet éclaircissement.
Allez, expliquez-luy mon trouble & mon ſilence,	Allez, expliquez-lui mon trouble et mon silence,
Sur tout qu’elle me laiſſe éviter ſa preſence.	Surtout qu’elle me laisse éviter sa présence.
Soyez le ſeul témoin de ſes pleurs & des miens.	Soyez le seul témoin de ses pleurs et des miens.
Portez-luy mes Adieux, & recevez les ſiens.	Portez-lui mes Adieux, et recevez les siens.
Fuyons tous deux, fuyons un ſpectacle funeſte	Fuyons tous deux, fuyons un spectacle funeste
Qui de noſtre conſtance accableroit le reſte.	Qui de notre constance accablerait le reste.
Si l'eſpoir de regner & de vivre en mon cœur	Si l’espoir de régner et de vivre en mon cœur
Peut de ſon infortune adoucir la rigueur;	Peut de son infortune adoucir la rigueur;
Ah Prince! jurez-luy que toujours trop fidelle,	Ah Prince! jurez-lui que toujours trop fidèle,
Gemiſſant dans ma Cour, & plus exilé qu'elle,	Gémissant dans ma Cour, et plus exilé qu’elle,
Portant juſqu’au tombeau le nom de ſon Amant,	Portant jusqu’au tombeau le nom de son Amant,
Mon regne ne ſera qu’un long banniſſement,	Mon règne ne sera qu’un long bannissement,
Si le Ciel non content de me l'avoir ravie	Si le Ciel non content de me l’avoir ravie
Veut encor m’affliger par une longue vie.	Veut encor m’affliger par une longue vie.
Vous, que l’amitié ſeule attache ſur les pas,	Vous, que l’amitié seule attache sur ses pas,
Prince, dans ſon malheur ne l’abandonnez pas.	Prince, dans son malheur ne l’abandonnez pas.
Que l’Orient vous voye arriver à ſa ſuite;	Que l’Orient vous voie arriver à sa suite;
Que ce ſoit un triomphe, & non pas une fuite;	Que ce soit un triomphe, et non pas une fuite;
Qu'une amitié ſi belle ait d’éternels liens,	Qu’une amitié si belle ait d’éternels liens,
Que mon nom ſoit toujours dans tous vos entretiens.	Que mon nom soit toujours dans tous vos entretiens.
Pour rendre vos Eſtats plus voiſins l'un de l’autre,	Pour rendre vos États plus voisins l’un de l’autre,
L’Euphrate bornera ſon Empire & le voſtre.	L’Euphrate bornera son Empire et le vôtre.
Je ſçay que le Senat tout plein de voſtre nom,	Je sais que le Sénat tout plein de votre nom,
D’une commune voix confirmera ce don.	D’une commune voix confirmera ce don.
Je joins la Cilicie à voſtre Comagene.	Je joins la Cilicie à votre Comagène.
Adieu, ne quittez point ma Princeſſe, ma Reyne,	Adieu, ne quittez point ma Princesse, ma Reine,
Tout ce qui de mon cœur fut l'unique deſir,	Tout ce qui de mon cœur fut l’unique désir,
Tout ce que j'aimeray juſqu’au dernier ſoupir.	Tout ce que j’aimerai jusqu’au dernier soupir.
Ainſi le Ciel s’appreſte à vous rendre juſtice.	Ainsi le Ciel s’apprête à vous rendre justice.
Vous partirez, Seigneur, mais avec Berenice.	Vous partirez, Seigneur, mais avec Bérénice.
Loin de vous la ravir on va vous la livrer.	Loin de vous la ravir on va vous la livrer.
Arſace, laiſſe-moy le temps de reſpirer.	Arsace, laisse-moi le temps de respirer.
Ce changement eſt grand, ma ſurpriſe eſt extréme.	Ce changement est grand, ma surprise est extrême.
Titus entre mes mains remet tout ce qu’il aime?	Titus entre mes mains remet tout ce qu’il aime?
Dois-je croire, grands Dieux! ce que je viens d’oüir,	Dois-je croire, grands Dieux! ce que je viens d’ouïr.
Et quand je le croiray, dois-je m’en réjoüir?	Et quand je le croirais, dois-je m’en réjouir?
Mais moy-meſme, Seigneur, que faut il que je croye?	Mais moi-même, Seigneur, que faut-il que je croie?
Quel obſtacle nouveau s’oppoſe à voſtre joye?	Quel obstacle nouveau s’oppose à votre joie?
Me trompiez-vous tantoſt au ſortir de ces Lieux,	Me trompiez-vous tantôt au sortir de ces Lieux,
Lors qu'encor tout ému de vos derniers Adieux,	Lorsque encor tout ému de vos derniers Adieux,
Tremblant d’avoir oſé s’expliquer devant elle,	Tremblant d’avoir osé s’expliquer devant elle,
Voſtre cœur me contoit ſon audace nouvelle?	Votre cœur me contait son audace nouvelle?
Vous fuyiez un hymen qui vous faiſoit trembler.	Vous fuyez un hymen qui vous faisait trembler.
Cet hymen eſt rompu. Quel ſoin peut vous troubler?	Cet hymen est rompu. Quel soin peut vous troubler?
Suivez les doux tranſports où l’amour vous invite.	Suivez les doux transports où l’amour vous invite.
Arſace, je me voy chargé de ſa conduite.	Arsace, je me vois chargé de sa conduite.
Je joüiray longtemps de ſes chers entretiens,	Je jouirai longtemps de ses chers entretiens,
Ses yeux meſme pourront s’accoutumer aux miens.	Ses yeux même pourront s’accoutumer aux miens.
Et peut-eſtre ſon cœur fera la difference	Et peut-être son cœur fera la différence
Des froideurs de Titus à ma perſeverance.	Des froideurs de Titus à ma persévérance.
Titus m’accable icy du poids de ſa grandeur.	Titus m’accable ici du poids de sa grandeur.
Tout diſparoiſt dans Rome aupres de ſa ſplendeur.	Tout disparaît dans Rome auprès de sa splendeur.
Mais quoy que l’Orient ſoit plein de ſa mémoire,	Mais quoique l’Orient soit plein de sa mémoire,
Berenice y verra des traces de ma gloire.	Bérénice y verra des traces de ma gloire.
N’en doutez point, Seigneur, tout ſuccede à vos vœux.	N’en doutez point, Seigneur, tout succède à vos vœux.
Ah! Que nous nous plaiſons à nous tromper tous deux?	Ah! Que nous nous plaisons à nous tromper tous deux?
Et pourquoy nous tromper!	Et pourquoi nous tromper!
Quoy je luy pourrois plaire?	Quoi je lui pourrais plaire?
Berenice à mes voeux ne ſeroit plus contraire?	Bérénice à mes vœux ne serait plus contraire?
Berenice d’un mot flatteroit mes douleurs?	Bérénice d’un mot flatterait mes douleurs?
Penſes-tu ſeulement que parmy ſes malheurs,	Penses-tu seulement que parmi ses malheurs,
Quand l'Univers entier negligeroit ſes charmes,	Quand l’Univers entier négligerait ses charmes,
L’Ingrate me permiſt de luy donner des larmes,	L’Ingrate me permît de lui donner des larmes,
Ou qu’elle s’abaiſſaſt juſques à recevoir	Ou qu’elle s’abaissât jusques à recevoir
Des ſoins, qu'à mon amour elle croiroit devoir?	Des soins, qu’à mon amour elle croirait devoir?
Et qui peut mieux que vous conſoler ſa diſgrace?	Et qui peut mieux que vous consoler sa disgrâce?
Sa fortune, Seigneur, va prendre une autre face.	Sa fortune, Seigneur, va prendre une autre face.
Titus la quitte.	Titus la quitte.
Helas! De ce grand changement	Hélas! De ce grand changement
Il ne me reviendra que le nouveau tourment	Il ne me reviendra que le nouveau tourment
D’apprendre par ſes pleurs à quel point elle l'aime.	D’apprendre par ses pleurs à quel point elle l’aime.
Je la verrai gémir, je la plaindray moy-meſme.	Je la verrai gémir, je la plaindrai moi-même.
Pour fruit de tant d’amour j’auray le triſte employ	Pour fruit de tant d’amour j’aurai le triste emploi
De recüeillir des pleurs oui ne ſont pas pour moy.	De recueillir des pleurs qui ne sont pas pour moi.
Quoy? Ne vous plairez-vous qu’à vous geſner ſans ceſſe?	Quoi? Ne vous plairez-vous qu’à vous gêner sans cesse?
Jamais dans un grand cœur vit-on plus de foibleſſe?	Jamais dans un grand cœur vit-on plus de faiblesse?
Ouvrez les yeux, Seigneur, & ſongeons entre nous	Ouvrez les yeux, Seigneur, et songeons entre nous
Par combien de raiſons Berenice eſt à vous.	Par combien de raisons Bérénice est à vous.
Puis qu'aujourd’huy Titus ne prétend plus luy plaire,	Puisque aujourd’hui Titus ne prétend plus lui plaire,
Songez que voſtre hymen luy devient neceſſaire.	Songez que votre hymen lui devient nécessaire.
Neceſſaire!	Nécessaire!
A ſes pleurs accordez quelques jours.	À ses pleurs accordez quelques jours.
De ſes premiers ſanglots laiſſez paſſer le cours.	De ses premiers sanglots laissez passer le cours.
Tout parlera pour vous, le dépit, la vangeance,	Tout parlera pour vous, le dépit, la vengeance,
L’abſence de Titus, le temps, voſtre préſence,	L’absence de Titus, le temps, votre présence,
Trois Sceptres, que ſon bras ne peut ſeul ſoutenir,	Trois Sceptres, que son bras ne peut seul soutenir,
Vos deux Eſtats voiſins, qui cherchent à s’unir.	Vos deux États voisins, qui cherchent à s’unir.
L'intereſt, la raiſon, l'amitié, tout vous lie.	L’intérêt, la raison, l’amitié, tout vous lie.
Ah, je reſpire Arſace, & tu me rens la vie.	Ah, je respire Arsace, et tu me rends la vie.
J'accepte avec plaiſir un préſage ſi doux.	J’accepte avec plaisir un présage si doux.
Que tardons-nous? Faiſons-ce qu'on attend de nous.	Que tardons-nous? Faisons ce qu’on attend de nous.
Entrons chez Berenice; & puis qu’on nous l'ordonne,	Entrons chez Bérénice; et puisqu’on nous l’ordonne,
Allons luy déclarer que Titus l'abandonne.	Allons lui déclarer que Titus l’abandonne.
Mais plutoſt demeurons. Que faiſois-je? Eſt-ce à moy,	Mais plutôt demeurons. Que faisais-je? Est-ce à moi,
Arſace, à me charger de ce cruel employ?	Arsace, à me charger de ce cruel emploi?
Soit vertu ſoit amour, mon cœur s'en effarouche.	Soit vertu soit amour, mon cœur s’en effarouche.
L'aimable Berenice entendroit de ma bouche,	L’aimable Bérénice entendrait de ma bouche,
Qu’on l'abandonne. Ah Reyne! Et qui l’auroit penſé	Qu’on l’abandonne. Ah Reine! Et qui l’aurait pensé
Que ce mot duſt jamais vous eſtre prononcé?	Que ce mot dût jamais vous être prononcé?
La haine ſur Titus tombera toute entiere,	La haine sur Titus tombera toute entière,
Seigneur, ſi vous parlez, ce n'eſt qu'à ſa priere.	Seigneur, si vous parlez, ce n’est qu’à sa prière.
Non, ne la voyons point. Reſpectons ſa douleur.	Non, ne la voyons point. Respectons sa douleur.
Aſſez d’autres viendront luy conter ſon malheur.	Assez d’autres viendront lui conter son malheur.
Et ne la crois-tu pas aſſez infortunée	Et ne la crois-tu pas assez infortunée
D’apprendre à quel mépris Titus l’a condannée,	D’apprendre à quel mépris Titus l’a condamnée,
Sans luy donner encor le déplaiſir fatal	Sans lui donner encor le déplaisir fatal
D'apprendre ce mépris par ſon propre Rival?	D’apprendre ce mépris par son propre Rival?
Encore un coup fuyons. Et par cette nouvelle	Encore un coup fuyons. Et par cette nouvelle
N’allons point nous charger d’une haine immortelle.	N’allons point nous charger d’une haine immortelle.
Ah! la voicy, Seigneur, prenez voſtre party.	Ah! la voici, Seigneur, prenez votre parti.
O Ciel!	Ô Ciel!
ENfin, Seigneur, vous n’eſtes point party.	Enfin, Seigneur, vous n'êtes point parti.
Madame, je voy bien que vous eſtes déceuë,	Madame, je vois bien que vous êtes déçue,
Et que c’eſtoit Ceſar que cherchoit voſtre veuë.	Et que c’était César que cherchait votre vue.
Mais n’accuſez que luy, ſi malgré mes Adieux	Mais n’accusez que lui, si malgré mes Adieux.
De ma préſence encor j’importune vos yeux.	De ma présence encor j’importune vos yeux.
Peut-eſtre en ce moment je ſerois dans Oſtie,	Peut-être en ce moment je serais dans Ostie,
S’il ne m’euſt de ſa Cour défendu la ſortie.	S’il ne m’eût de sa Cour défendu la sortie.
Il vous cherché vous ſeul. Il nous évite tous.	Il vous cherche vous seul. Il nous évite tous.
Il ne m’a retenu que pour parler de vous.	Il ne m’a retenu que pour parler de vous.
De moy, Prince?	De moi, Prince?
Oüy, Madame,	Oui, Madame,
Et qu’a-t-il pu vous dire?	Et qu’a-t-il pu vous dire?
Mille autres, mieux que moy, pourrõt vous en inſtruire.	Mille autres, mieux que moi, pourront vous en instruire.
Quoy, Seigneur...	Quoi, Seigneur…
Suſpendez voſtre reſſentiment.	Suspendez votre ressentiment.
D’autres loin de ſe taire en ce meſme moment,	D’autres loin de se taire en ce même moment,
Triompheroient peut-eſtre, & pleins de confiance	Triompheraient peut-être, et pleins de confiance
Cederoient avec joye à voſtre impatience.	Céderaient avec joie à votre impatience.
Mais moy, toujours tremblant, moy, vous le ſçavez bien,	Mais moi, toujours tremblant, moi, vous le savez bien,
A qui voſtre repos eſt plus cher que le mien,	À qui votre repos est plus cher que le mien,
Pour ne le point troubler, j’aime mieux vous déplaire,	Pour ne le point troubler, j’aime mieux vous déplaire,
Et crains voſtre douleur plus que voſtre colere.	Et crains votre douleur plus que votre colère.
Avant la fin du jour vous me juſtifierez.	Avant la fin du jour vous me justifierez.
Adieu, Madame.	Adieu, Madame.
O Ciel! Quel diſcours? Demeurez.	Ô Ciel! Quel discours! Demeurez.
Prince, c’eſt trop cacher mon trouble à voſtre veuë.	Prince, c’est trop cacher mon trouble à votre vue.
Vous voyez devant vous une Reyne éperduë,	Vous voyez devant vous une Reine éperdue,
Qui la mort dans le ſein, vous demande deux mots.	Qui la mort dans le sein, vous demande deux mots.
Vous craignez, dites-vous, de troubler mon repos.	Vous craignez, dites-vous, de troubler mon repos.
Et vos refus cruels, loin d’épargner ma peine,	Et vos refus cruels, loin d’épargner ma peine,
Excitent ma douleur, ma colere, ma haine.	Excitent ma douleur, ma colère, ma haine.
Seigneur, ſi mon repos vous eſt ſi prétieux,	Seigneur, si mon repos vous est si précieux,
Si moy-meſme jamais je fus chere à vos yeux,	Si moi-même jamais je fus chère à vos yeux,
Eclairciſſez le trouble où vous voyez mon ame,	Éclaircissez le trouble où vous voyez mon âme.
Que vous a dit Titus?	Que vous a dit Titus?
Au nom des Dieux, Madame....	Au nom des Dieux, Madame…
Quoy, vous craignez ſi peu de me deſobeïr?	Quoi, vous craignez si peu de me désobéir?
Je n’ay qu’à vous parler, pour me faire haïr.	Je n’ai qu’à vous parler, pour me faire haïr.
Je veux que vous parliez.	Je veux que vous parliez.
Dieux, quelle violence!	Dieux, quelle violence!
Madame, encore un coup, vous loüerez mon ſilence.	Madame, encore un coup, vous louerez mon silence.
Prince, dés ce moment contentez mes ſouhaits,	Prince, dès ce moment contentez mes souhaits,
Ou ſoyez de ma haine aſſuré pour jamais.	Ou soyez de ma haine assuré pour jamais.
Madame, apres cela je ne puis plus me taire.	Madame, après cela je ne puis plus me taire.
Hé bien, vous le voulez, il faut vous ſatisfaire.	Hé bien, vous le voulez, il faut vous satisfaire.
Mais ne vous flattez point. Je-vais vous annoncer	Mais ne vous flattez point. Je vais vous annoncer
Peut-eſtre des malheurs où vous n’oſez penſer.	Peut-être des malheurs, où vous n’osez penser.
Je connoy voſtre cœur. Vous devez vous attendre	Je connais votre cœur. Vous devez vous attendre
Que je le vais frapper par l’endroit le plus tendre.	Que je le vais frapper par l’endroit le plus tendre.
Titus m’a commandé....	Titus m’a commandé…
Quoy?	Quoi?
De vous déclarer	De vous déclarer
Qu’à jamais l’un de l’autre il faut vous ſeparer.	Qu’à jamais l’un de l’autre il faut vous séparer.
Nous ſeparer? Qui? Moy! Titus de Berenice!	Nous séparer? Qui? Moi! Titus de Bérénice!
Il faut que devant vous je luy rende juſtice.	Il faut que devant vous je lui rende justice.
Tout ce que dans un cœur ſenſible & genereux	Tout ce que dans un cœur sensible et généreux
L’amour au deſeſpoir peut raſſembler d’affreux.	L’amour au désespoir peut rassembler d’affreux.
Je l’ay veu dans le ſien. Il pleure, il vous adore.	Je l’ai vu dans le sien. Il pleure, il vous adore.
Mais enfin que luy ſert de vous aimer encore?	Mais enfin que lui sert de vous aimer encore?
Une Reyne eſt ſuſpecte à l’Empire Romain.	Une Reine est suspecte à l’Empire Romain.
Il faut vous ſeparer, & vous partez demain.	Il faut vous séparer, et vous partez demain.
Nous ſeparer! Helas, Phénice!	Nous séparer! Hélas, Phénice!
Hé bien, Madame!	Hé bien, Madame!
Il faut icy montrer la grandeur de voſtre ame.	Il faut ici montrer la grandeur de votre âme.
Ce coup ſans doute eſt rude, il doit vous étonner.	Ce coup sans doute est rude, il doit vous étonner.
Apres tant de ſermens Titus m’abandonner!	Après tant de serments Titus m’abandonner!
Titus qui me juroit... Non, je ne le puis croire,	Titus qui me jurait… Non, je ne le puis croire,
Il ne me quitte point, il y va de ſa gloire.	Il ne me quitte point, il y va de sa gloire.
Contre ſon innocence on veut me prévenir.	Contre son innocence on veut me prévenir.
Ce piege n’eſt tendu que pour nous deſunir.	Ce piège n’est tendu que pour nous désunir.
Titus m’aime. Titus ne veut point que je meure.	Titus m’aime. Titus ne veut point que je meure.
Allons le voir. Je veux luy parler tout à l’heure.	Allons le voir. Je veux lui parler tout à l’heure.
Allons.	Allons.
Quoy? Vous pourriez icy me regarder...	Quoi? Vous pourriez ici me regarder…
Vous le ſouhaitez trop pour me perſuader.	Vous le souhaitez trop pour me persuader.
Non, je ne vous croy point. Mais quoy qu’il en puiſſe eſtre,	Non, je ne vous crois point. Mais quoi qu’il en puisse être,
Pour jamais à mes yeux gardez-vous de paraiſtre.	Pour jamais à mes yeux gardez-vous de paraître.
* Ne m’abandonne pas dans l’état où je ſuis,	Ne m’abandonne pas dans l’état où je suis,
Helas! pour me tromper je fay ce que je puis.	Hélas! pour me tromper je fais ce que je puis.
NE me trompay-je point? L’ay-je bien entenduë?	Ne me trompé-je point? L’ai-je bien entendue?
Que je me garde, moy, de paroiſtre à ſa veuë?	Que je me garde, moi, de paraître à sa vue?
Je m’en garderay bien. Et ne partois-je pas,	Je m’en garderai bien. Et ne partais-je pas,
Si Titus malgré moy n’euſt arreſté mes pas?	Si Titus malgré moi n’eût arrêté mes pas?
Sans doute, il faut partir. Continuons, Arſace.	Sans doute, il faut partir. Continuons, Arsace.
Elle croit m'affliger. Sa haine me fait grace.	Elle croit m’affliger. Sa haine me fait grâce.
Tu me voyois tantoſt inquiet, égaré.	Tu me voyais tantôt inquiet, égaré.
Je partois amoureux, jaloux, deſeſperé.	Je partais amoureux, jaloux, désespéré.
Et maintenant, Arſace, apres cette défenſe	Et maintenant, Arsace, après cette défense
Je partiray peut-eſtre avec indifference.	Je partirai peut-être avec indifférence.
Moins que jamais, Seigneur, il faut vous éloigner.	Moins que jamais, Seigneur, il faut vous éloigner.
Moy, je demeureray pour me voir dédaigner?	Moi, je demeurerai pour me voir dédaigner?
Des froideurs de Titus je ſeray reſponsable?	Des froideurs de Titus je serai responsable?
Je me verray puny parce qu’il eſt coupable?	Je me verrai puni parce qu’il est coupable?
Avec quelle injuſtice, & quelle indignité	Avec quelle injustice, et quelle indignité
Elle doute à mes yeux de ma ſincerité!	Elle doute à mes yeux de ma sincérité!
Titus l’aime, dit-elle, & moy je l’ay trahie,	Titus l’aime, dit-elle, et moi je l’ai trahie,
L’ingrate! M’accuſer de cette perfidie?	L’ingrate! M’accuser de cette perfidie?
Et dans quel temps encor! Dans le moment fatal	Et dans quel temps encor! Dans le moment fatal
Que j’étale à ſes yeux les pleurs de mon Rival,	Que j’étale à ses yeux les pleurs de mon Rival,
Que pour la conſoler je le faiſois paraiſtre	Que pour la consoler je le faisais paraître
Amoureux & conſtant, plus qu’il ne l’eſt peut-eſtre.	Amoureux et constant, plus qu’il ne l’est peut-être.
Et de quel ſoin, Seigneur, vous allez-vous troubler?	Et de quel soin, Seigneur, vous allez-vous troubler?
Laiſſez à ce torrent le temps de s’écouler.	Laissez à ce torrent le temps de s’écouler.
Dans huit jours, dans un mois, n’importe, il faut qu’il paſſe.	Dans huit jours, dans un mois, n’importe, il faut qu’il passe.
Demeurez, ſeulement.	Demeurez, seulement.
Non, je la quitte, Arſace.	Non, je la quitte, Arsace.
Je ſens qu’à ſa douleur je pourrois compâtir,	Je sens qu’à sa douleur je pourrais compatir,
Ma gloire, mon repos, tout m'excite a partir.	Ma gloire, mon repos, tout m’excite à partir.
Allons. Et de ſi loin évitons la Cruelle,	Allons. Et de si loin évitons la Cruelle,
Que de longtemps, Arſace, on ne nous parle d’elle.	Que de longtemps, Arsace, on ne nous parle d’elle.
Toutefois il nous reſte encore aſſez de jour.	Toutefois il nous reste encore assez de jour.
Je vais dans mon Palais attendre ton retour.	Je vais dans mon Palais attendre ton retour.
Va voir ſi la douleur ne l’a point trop ſaiſie.	Va voir si la douleur ne l’a point trop saisie.
Cours. Et partons du moins aſſurez de ſa vie.	Cours. Et partons du moins assurés de sa vie.
PHenice ne vient point? Momens trop rigoureux,	PHénice ne vient point? Moments trop rigoureux,
Que vous paroiſſez lents à mes rapides vœux!	Que vous paraissez lents à mes rapides vœux!
Je m’agite, je cours, languiſſante, abattuë,	Je m’agite, je cours, languissante, abattue,
La force m’abandonne, & le repos me tuë.	La force m’abandonne, et le repos me tue.
Phénice ne vient point. Ah que cette longueur	Phénice ne vient point. Ah que cette longueur
D’un préſage funeſte épouvante mon cœur!	D’un présage funeste épouvante mon cœur!
Phénice n’aura point de réponſe à me rendre.	Phénice n’aura point de réponse à me rendre.
Titus, l’ingrat Titus n’a point voulu l’entendre.	Titus, l’ingrat Titus n’a point voulu l’entendre.
Il fuit, il ſe dérobe à ma juſte fureur.	Il fuit, il se dérobe à ma juste fureur.
CHere Phénice, hé bien, as-tu veu l’Empereur?	CHère Phénice, hé bien, as-tu vu l’Empereur?
Qu’a-t-il dit? Viendra-t-il?	Qu’a-t-il dit? Viendra-t-il?
Ouy je l’ay veû, Madame,	Oui, je l'ai vu, Madame,
Et j’ay peint à ſes yeux le trouble de voſtre ame.	Et j’ai peint à ses yeux le trouble de votre âme.
J’ay veû couler des pleurs qu’il vouloit retenir.	J’ai vu couler des pleurs qu’il voulait retenir.
Vient-il?	Vient-il?
N’en doutez point, Madame, il va venir.	N’en doutez point, Madame, il va venir.
Mais voulez-vous paroiſtre en ce deſordre extréme?	Mais voulez-vous paraître en ce désordre extrême?
Remettez-vous, Madame, & rentrez en vous-méme.	Remettez-vous, Madame, et rentrez en vous-même.
Laiſſez-moy relever ces voiles détachez,	Laissez-moi relever ces voiles détachés,
Et ces cheveux épars dont vos yeux ſont cachez.	Et ces cheveux épars dont vos yeux sont cachés.
Souffrez que de vos pleurs je repare l’outrage.	Souffrez que de vos pleurs je répare l’outrage.
Laiſſe, laiſſe, Phénice, il verra ſon ouvrage.	Laisse, laisse, Phénice, il verra son ouvrage.
Et que m’importe, helas! de ces vains ornemens?	Et que m’importe, hélas! de ces vains ornements?
Si ma foy, ſi mes pleurs, ſi mes gemiſſemens;	Si ma foi, si mes pleurs, si mes gémissements;
Mais que dis-je, mes pleurs? ſi ma perte certaine,	Mais que dis-je, mes pleurs? si ma perte certaine,
Si ma mort toute preſte enfin ne le rameine,	Si ma mort toute prête enfin ne le ramène,
Dy moy, que produiront tes ſecours ſuperflus,	Dis-moi, que produiront tes secours superflus,
Et tout ce foible éclat qui ne le touche plus?	Et tout ce faible éclat qui ne le touche plus?
Pourquoy luy faites-vous cet injuſte reproche?	Pourquoi lui faites-vous cet injuste reproche?
J’entens du bruit, Madame, & l’Empereur s’approche,	J’entends du bruit, Madame, et l’Empereur s’approche,
Venez, fuyez la foule; & rentrons promptement.	Venez, fuyez la foule, et rentrons promptement.
Vous l’entretiendrez ſeul dans voſtre Apartement.	Vous l’entretiendrez seul dans votre Appartement.
DE la Reyne, Paulin, flattez l’inquiétude.	DE la Reine, Paulin, flattez l’inquiétude.
Je vais la voir. Je veux un peu de ſolitude,	Je vais la voir. Je veux un peu de solitude.
Que l’on me laiſſe.	Que l’on me laisse.
O Ciel! Que je crains ce combat!	O Ciel! Que je crains ce combat!
Grands Dieux, ſauvez ſa gloire, & l’honneur de l’Eſtat.	Grands Dieux, sauvez sa gloire, et l’honneur de l’État.
Voyons la Reyne.	Voyons la Reine.
HE' bien, Titus, que viens-tu faire?	HÉ bien, Titus, que viens-tu faire?
Berenice t’attend. Où viens-tu, temeraire?	Bérénice t’attend. Où viens-tu, téméraire?
Tes adieux ſont-ils preſts? T’es-tu bien conſulté?	Tes adieux sont-ils prêts? T’es-tu bien consulté?
Ton cœur te promet-il aſſez de cruauté?	Ton cœur te promet-il assez de cruauté?
Car enfin au combat, qui pour toy ſe prépare,	Car enfin au combat, qui pour toi se prépare,
C’eſt peu d’eſtre conſtant, il faut eſtre barbare.	C’est peu d’être constant, il faut être barbare.
Soutiendray-je ces yeux dont la douce langueur	Soutiendrai-je ces yeux dont la douce langueur
Sçait ſi bien découvrir les chemins de mon cœur?	Sait si bien découvrir les chemins de mon cœur?
Quand je verray ces yeux armez de tous leurs charmes,	Quand je verrai ces yeux armés de tous leurs charmes,
Attachez ſur les miens, m’accabler de leurs larmes,	Attachés sur les miens, m’accabler de leurs larmes,
Me ſouviendray-je alors de mon triſte devoir?	Me souviendrai-je alors de mon triste devoir?
Pourray-je dire enfin, Je ne veux plus vous voir?	Pourrai-je dire enfin, Je ne veux plus vous voir?
Je viens percer un cœur que j’adore, qui m’aime.	Je viens percer un cœur que j’adore, qui m’aime.
Et pourquoy le percer? Qui l’ordonne? Moy-meſme.	Et pourquoi le percer? Qui l’ordonne? Moi-même.
Car enfin Rome a-t-elle expliqué ſes ſouhaits?	Car enfin Rome a-t-elle expliqué ses souhaits?
L’entendons-nous crier autour de ce Palais?	L’entendons-nous crier autour de ce Palais?
Voy-je l’Eſtat panchant au bord du précipice?	Vois-je l’État penchant au bord du précipice?
Ne le puis-je ſauver que par ce ſacrifice?	Ne le puis-je sauver que par ce sacrifice?
Tout ſe taiſt, & moy ſeul trop prompt à me troubler,	Tout se tait, et moi seul trop prompt à me troubler,
J’avance des malheurs que je puis reculer.	J’avance des malheurs que je puis reculer.
Et qui ſçait, ſi ſenſible aux vertus de la Reyne,	Et qui sait, si sensible aux vertus de la Reine,
Rome ne voudra point l’avouer pour Romaine?	Rome ne voudra point l’avouer pour Romaine?
Rome peut par ſon choix juſtifier le mien.	Rome peut par son choix justifier le mien.
Non, non, encore un coup ne précipitons rien.	Non, non, encore un coup ne précipitons rien.
Que Rome avec ſes Lois mette dans la balance	Que Rome avec ses lois mette dans la balance
Tant de pleurs, tant d’amour, tant de perſeverance.	Tant de pleurs, tant d’amour, tant de persévérance.
Rome ſera pour nous. Titus, ouvre les yeux.	Rome sera pour nous. Titus, ouvre les yeux.
Quel air reſpires-tu? N’es-tu pas dans ces lieux	Quel air respires-tu? N’es-tu pas dans ces lieux
Ou la haine des Roys avec le lait ſucée,	Où la haine des Rois avec le lait sucée,
Par crainte, ou par amour, ne peut eſtre effacée?	Par crainte, ou par amour, ne peut être effacée?
Rome jugea ta Reyne en condamnant ſes Roys.	Rome jugea ta Reine en condamnant ses Rois.
N’as-tu pas en naiſſant entendu cette voix?	N’as-tu pas en naissant entendu cette voix?
Et n’as-tu pas encore-oüi la Renommée	Et n’as-tu pas encore ouï la Renommée
T’annoncer ton devoir juſques dans ton armée?	T’annoncer ton devoir jusque dans ton armée?
Et lors que Berenice arriva ſur tes pas,	Et lorsque Bérénice arriva sur tes pas,
Ce que Rome en jugeoit, ne l’entendis-tu pas?	Ce que Rome en jugeait, ne l’entendis-tu pas?
Faut-il donc tant de fois te le faire redire?	Faut-il donc tant de fois te le faire redire?
Ah lâche! Fay l’amour, & renonce à l’Empire.	Ah lâche! Fais l’amour, et renonce à l’Empire.
Au bout de l’Univers va, cours te confiner,	Au bout de l’Univers va, cours te confiner,
Et fay place à des cœurs plus dignes de regner.	Et fais place à des cœurs plus dignes de régner.
Sont-ce là ces projets de grandeur & de gloire	Sont-ce là ces projets de grandeur et de gloire
Qui devoient dans les cœurs conſacrer ma memoire?	Qui devaient dans les cœurs consacrer ma mémoire?
Depuis huit jours je regne. Et juſques à ce jour	Depuis huit jours je règne. Et jusques à ce jour
Qu’ay-je fait pour l’honneur? J’ay tout fait pour l’amour.	Qu’ai-je fait pour l’honneur? J’ai tout fait pour l’amour.
D’un temps ſi précieux quel conte puis-je rendre?	D’un temps si précieux quel compte puis-je rendre?
Où ſont ces heureux jours que je faiſois attendre?	Où sont ces heureux jours que je faisais attendre?
Quels pleurs ay-je ſechez? Dans quels yeux ſatisfaits	Quels pleurs ai-je séchés? Dans quels yeux satisfaits
Ay-je déja goûté le fruit de mes bienfaits?	Ai-je déjà goûté le fruit de mes bienfaits?
L'Univers a-t-il veu changer ſes deſtinées?	L’Univers a-t-il vu changer ses destinées?
Sçay-je combien le Ciel m’a conté de journées?	Sais-je combien le Ciel m’a compté de journées?
Et de ce peu de jours, ſi longtemps attendus,	Et de ce peu de jours, si longtemps attendus,
Ah malheureux! combien j’en ay déja perdus!	Ah malheureux! combien j’en ai déjà perdus!
Ne tardons plus, Faiſons ce que l’honneur exige.	Ne tardons plus. Faisons ce que l’honneur exige.
Rompons le ſeul lien....	Rompons le seul lien…
Non, laiſſez-moy, vous dis-je.	Non, laissez-moi, vous dis-je.
En vain tous vos conſeils me retiennent icy.	En vain tous vos conseils me retiennent ici.
Il faut que je le voye. Ah Seigneur Vous voicy.	Il faut que je le voie. Ah Seigneur Vous voici.
Hé bien, il eſt donc vray que Titus m’abandonne?	Hé bien, il est donc vrai que Titus m’abandonne?
Il faut nous ſeparer. Et c’eſt luy qui l’ordonne.	Il faut nous séparer. Et c’est lui qui l’ordonne.
N’accablez point, Madame, un Prince malheureux.	N’accablez point, Madame, un Prince malheureux.
Il ne faut point icy nous attendrir tous deux.	Il ne faut point ici nous attendrir tous deux.
Un trouble aſſez cruel m’agite & me devore,	Un trouble assez cruel m’agite et me dévore,
Sans que des pleurs ſi chers me déchirent encore.	Sans que des pleurs si chers me déchirent encore.
Rappellez bien plutoſt ce cœur, qui tant de fois	Rappelez bien plutôt ce cœur, qui tant de fois
M’a fait de mon devoir reconnoiſtre la voix.	M’a fait de mon devoir reconnaître la voix.
Il en eſt-temps. Forcez voſtre amour à ſe taire,	Il en est temps. Forcez votre amour à se taire,
Et d’un œil que la gloire & la raiſon éclaire,	Et d’un oeil que la gloire et la raison éclaire,
Contemplez mon devoir dans toute ſa rigueur.	Contemplez mon devoir dans toute sa rigueur.
Vous-meſme contre vous fortifiez mon cœur.	Vous-même contre vous fortifiez mon cœur.
Aidez-moy, s’il ſe peut, à vaincre ſa foibleſſe,	Aidez-moi, s’il se peut, à vaincre sa faiblesse,
A retenir des pleurs qui m’échappent ſans ceſſe.	À retenir des pleurs qui m’échappent sans cesse.
Ou ſi nous ne pouvons commander à nos pleurs,	Ou si nous ne pouvons commander à nos pleurs,
Que la Gloire du moins ſoutiennne nos douleurs,	Que la Gloire du moins soutienne nos douleurs,
Et que tout l’Univers reconnoiſſe ſans peine	Et que tout l’Univers reconnaisse sans peine
Les pleurs d’un Empereur, & les pleurs d’une Reyne.	Les pleurs d’un Empereur, et les pleurs d’une Reine.
Car enfin, ma Princeſſe, il faut nous ſeparer.	Car enfin, ma Princesse, il faut nous séparer.
Ah cruel! Eſt-il temps de me le déclarer?	Ah cruel! Est-il temps de me le déclarer?
Qu’avez-vous fait? Helas! Je me ſuis crüe aimée.	Qu’avez-vous fait? Hélas! Je me suis crue aimée.
Au plaifir de vous voir mon ame accoûtumée	Au plaisir de vous voir mon âme accoutumée
Ne vit plus que pour vous. Ignoriez-vous vos Lois,	Ne vit plus que pour vous. Ignoriez-vous vos Lois,
Quand je vous l’avouay pour la premiere fois?	Quand je vous l’avouai pour la première fois?
A quel excés d’amour m’avez-vous amenée!	À quel excès d’amour m’avez-vous amenée!
Que ne me diſiez-vous, Princeſſe infortunée,	Que ne me disiez-vous, Princesse infortunée,
Où vas-tu t’engager, & quel eſt ton eſpoir?	Où vas-tu t’engager, et quel est ton espoir?
Ne donne point un cœur, qu’on ne peut recevoir.	Ne donne point un cœur, qu’on ne peut recevoir.
Ne l’avez-vous receu, cruel, que pour le rendre,	Ne l’avez-vous reçu, cruel, que pour le rendre,
Quand de vos ſeules mains ce cœur voudroit dépendre?	Quand de vos seules mains ce cœur voudrait dépendre?
Tout l’Empire a vingt fois conſpiré contre nous.	Tout l’Empire a vingt fois conspiré contre nous.
Il eſtoit temps encor. Que ne me quittiez-vous?	Il était temps encor. Que ne me quittiez-vous?
Mille raiſons alors conſoloient ma miſere.	Mille raisons alors consolaient ma misère.
Je pouvois de ma mort accuſer voſtre Pere.	Je pouvais de ma mort accuser votre Père,
le Peuple, le Senat, tout l’Empire Romain,	Le Peuple, le Sénat, tout l’Empire Romain,
Tout l'Univers plutoſt qu’une ſi chere main.	Tout l’Univers plutôt qu’une si chère main.
Leur haine dés longtemps contre moy déclarée,	Leur haine dès longtemps contre moi déclarée,
M’avoit à mon malheur des longtemps préparée.	M’avait à mon malheur dès longtemps préparée.
Je n’aurois pas, Seigneur, receu ce coup cruel	Je n’aurais pas, Seigneur, reçu ce coup cruel
Dans le temps que j’eſpere un bonheur immortel,	Dans le temps que j’espère un bonheur immortel,
Quand voſtre heureux amour peut tout ce qu’il deſire,	Quand votre heureux amour peut tout ce qu’il désire,
Lors que Rome ſe taiſt, quand voſtre Pere expire,	Lorsque Rome se tait, quand votre Père expire,
Lors que tont l’Univers fléchit à vos genoux,	Lorsque tout l’Univers fléchit à vos genoux,
Enfin quand je n’ay plus à redouter que vous.	Enfin quand je n’ai plus à redouter que vous.
Et c’eſt moy ſeul auſſi qui pouvois me détruire.	Et c’est moi seul aussi qui pouvais me détruire.
Je pouvois vivre alors, & me laiſſer ſeduire.	Je pouvais vivre alors, et me laisser séduire.
Mon cœur ſe gardoit bien d’aller dans l’avenir	Mon cœur se gardait bien d’aller dans l’avenir
Chercher ce qui pouvoit un jour nous deſunir.	Chercher ce qui pouvait un jour nous désunir.
Je voulois qu’à mes vœux rien ne fuſt invincible,	Je voulais qu’à mes vœux rien ne fût invincible,
Je n’examinois rien, j’eſperois l’impoſſible.	Je n’examinais rien, j’espérais l’impossible.
Que ſçay-je? J’eſperois de mourir à vos yeux	Que sais-je? J’espérais de mourir à vos yeux
Avant que d’en venir à ces cruels adieux.	Avant que d’en venir à ces cruels adieux.
Les obſtacles ſembloient renouveller ma flâme.	Les obstacles semblaient renouveler ma flamme.
Tout l’Empire parloit. Mais la Gloire, Madame,	Tout l’Empire parlait. Mais la Gloire, Madame,
Ne s’eſtoit point encor fait entendre à mon cœur	Ne s’était point encor fait entendre à mon cœur
Du ton dont elle parle au cœur d’un Empereur	Du ton dont elle parle au cœur d’un Empereur
Je ſçay tous les tourmens où ce deſſein me livre.	Je sais tous les tourments où ce dessein me livre.
Je ſens bien que ſans vous je ne ſçaurois plus vivre.	Je sens bien que sans vous je ne saurais plus vivre.
Que mon cœur de moy meſme eſt preſt à s’éloigner.	Que mon cœur de moi-même est prêt à s’éloigner.
Mais il ne s’agit plus de vivre, il faut regner.	Mais il ne s’agit plus de vivre, il faut régner.
Hé bien regnez cruel, contentez voſtre Gloire.	Hé bien régnez cruel, contentez votre Gloire.
Je ne diſpute plus. J’attendois, pour vous croire,	Je ne dispute plus. J’attendais, pour vous croire,
Que cette meſme bouche, apres mille ſermens	Que cette même bouche, après mille serments
D’un amour, qui devoit unir tous nos momens,	D’un amour, qui devait unir tous nos moments,
Cette bouche à mes yeux s’avoüant infidelle,	Cette bouche à mes yeux s’avouant infidèle,
M’ordonnaſt elle-meſme une abſence éternelle.	M’ordonnât elle-même une absence éternelle.
Moy-meſme j’ay voulu vous entendre en ce lieu.	Moi-même j’ai voulu vous entendre en ce lieu.
Je n’écoute plus rien, & pour jamais Adieu.	Je n’écoute plus rien, et pour jamais Adieu.
Pour jamais! Ah Seigneur, ſongez-vous en vous-meſme	Pour jamais! Ah Seigneur, songez-vous en vous-même
Combien ce mot cruel eſt affreux quand on aime?	Combien ce mot cruel est affreux quand on aime?
Dans un mois, dans un an, comment ſouffrirons-nous,	Dans un mois, dans un an, comment souffrirons-nous,
Seigneur, que tant de Mers me ſeparent de vous?	Seigneur, que tant de Mers me séparent de vous?
Que le jour recommence & que le jour finiſſe,	Que le jour recommence et que le jour finisse,
Sans que jamais Titus puiſſe voir Berenice,	Sans que jamais Titus puisse voir Bérénice,
Sans que de tout le jour je puiſſe voir Titus?	Sans que de tout le jour je puisse voir Titus?
Mais quelle eſt mon erreur, & que de ſoins perdus!	Mais quelle est mon erreur, et que de soins perdus!
L’Ingrat de mon départ conſolé par avance,	L’Ingrat de mon départ consolé par avance,
Daignera-t-il conter les jours de mon abſence?	Daignera-t-il compter les jours de mon absence?
Ces jours ſi longs pour moy luy ſembleront trop courts.	Ces jours si longs pour moi lui sembleront trop courts.
Je n’auray pas, Madame, à conter tant de jours.	Je n’aurai pas, Madame, à compter tant de jours.
J’eſpere que bientoſt la triſte Renommée	J’espère que bientôt la triste Renommée
Vous fera confeſſer que vous eſtiez aimée.	Vous fera confesser que vous étiez aimée.
Vous verrez que Titus n’a pu ſans expirer....	Vous verrez que Titus n’a pu sans expirer…
Ah Seigneur, s’il eſt vray, pourquoy nous ſeparer?	Ah Seigneur, s’il est vrai, pourquoi nous séparer?
Je ne vous parle point d’un heureux hymenée.	Je ne vous parle point d’un heureux hyménée.
Rome à ne vous plus voir m’a-t-elle condannée	Rome à ne vous plus voir m’a-t-elle condamnée
Pourquoy m’enviez-vous l’air que vous reſpirez?	Pourquoi m’enviez-vous l’air que vous respirez?
Helas! vous pouvez tout, Madame. Demeurez.	Hélas! vous pouvez tout, Madame. Demeurez.
Je n’y reſiſte point. Mais je ſens ma foibleſſe	Je n’y résiste point. Mais je sens ma faiblesse
Il faudra vous combattre & vous craindre ſans ceſſe,	Il faudra vous combattre et vous craindre sans cesse,
Et ſans ceſſe veiller à retenir mes pas	Et sans cesse veiller à retenir mes pas
Que vers vous à toute heure entraiſnent vos appas.	Que vers vous à toute heure entraînent vos appas.
Que dis-je? En ce moment mon cœur hors de luy méme	Que dis-je? En ce moment mon cœur hors de lui-même
S’oublie, & ſe ſouvient ſeulement qu’il vous aime.	S’oublie, et se souvient seulement qu’il vous aime.
Hé bien, Seigneur, hé bien, qu’en peut-il arriver?	Hé bien, Seigneur, hé bien, qu’en peut-il arriver?
Voyez-vous les Romains preſts à ſe ſoulever?	Voyez-vous les Romains prêts à se soulever?
Et qui ſçait de quel œil ils prendront cette injure?	Et qui sait de quel oeil ils prendront cette injure?
S’ils parlent, ſi les cris ſuccedent au murmure,	S’ils parlent, si les cris succèdent au murmure,
Faudra-t-il par le ſang juſtifier mon choix?	Faudra-t-il par le sang justifier mon choix?
S’ils ſe taiſent, Madame, & me vendent leurs Lois,	S’ils se taisent, Madame, et me vendent leurs Lois,
A quoy m’expoſez-vous? Par quelle complaiſance	À quoi m’exposez-vous? Par quelle complaisance
Faudra-t il quelque jour payer leur patience?	Faudra-t-il quelque jour payer leur patience?
Que n’oſeront-ils point alors me demander?	Que n’oseront-ils point alors me demander?
Maintiendray-je des Lois que je ne puis garder?	Maintiendrai-je des Lois, que je ne puis garder?
Vous ne contez pour rien les pleurs de Berenice.	Vous ne comptez pour rien les pleurs de Bérénice.
Je les conte pour rien! Ah Ciel, quelle injuſtice!	Je les compte pour rien! Ah Ciel, quelle injustice!
Quoy, pour d’injuſtes Lois que vous pouvez changer,	Quoi, pour d’injustes Lois que vous pouvez changer,
En d’éternels chagrins vous-meſme vous plonger?	En d’éternels chagrins vous-même vous plonger?
Rome a ſes droits, Seigneur. N’avez-vous pas les voſtres?	Rome a ses droits, Seigneur. N’avez-vous pas les vôtres?
Ses intereſts ſont-ils plus ſacrez que les noſtres?	Ses intérêts sont-ils plus sacrés que les nôtres?
Dites, parlez.	Dites, parlez.
Helas! Que vous me déchirez?	Hélas! Que vous me déchirez?
Vous eſtes Empereur, Seigneur, & vous pleurez.	Vous êtes Empereur, Seigneur, et vous pleurez.
Ouy, Madame, il eſt vray, je pleure, je ſoupire,	Oui, Madame, il est vrai, je pleure, je soupire,
Je fremy. Mais enfin quand j’acceptay l’Empire,	Je frémis. Mais enfin quand j’acceptai l’Empire,
Rome me fit jurer de maintenir ſes droits;	Rome me fit jurer de maintenir ses droits;
Il les faut maintenir, Déja plus d’une fois	Il les faut maintenir. Déjà plus d’une fois
Rome a de mes pareils exercé la conſtance.	Rome a de mes pareils exercé la constance.
Ah! ſi vous remontiez juſques à ſa naiſſance,	Ah! Si vous remontiez jusques à sa naissance,
Vous les verriez toujours à ſes ordres ſoumis.	Vous les verriez toujours à ses ordres soumis.
L’un jaloux de ſa foy va chez les Ennemis	L’un jaloux de sa foi va chez les Ennemis
Chercher avec la mort la peine toute preſte.	Chercher avec la mort la peine toute prête.
D’un Fils victorieux l’autre proſcrit la teſte.	D’un fils victorieux l’autre proscrit la tête.
L’autre avec des yeux ſecs, & preſque indifferens,	L’autre avec des yeux secs, et presque indifférents,
Voit mourir ſes deux Fils par ſon ordre expirans.	Voit mourir ses deux Fils par son ordre expirants.
Malheureux! Mais toujours la Patrie & la Gloire	Malheureux! Mais toujours la Patrie et la Gloire
Ont parmy les Romains remporté la Victoire.	Ont parmi les Romains remporté la Victoire.
Je ſçay qu’en vous quittant le malheureux Titus	Je sais qu’en vous quittant le malheureux Titus
Paſſe l’auſterité de toutes leurs vertus;	Passe l’austérité de toutes leurs vertus;
Qu’elle n’approche point de cet effort inſigne.	Qu’elle n’approche point de cet effort insigne.
Mais, Madame, apres tout, me croyez-vous indigne	Mais, Madame, après tout, me croyez-vous indigne
De laiſſer un Exemple à la Poſterité,	De laisser un Exemple à la postérité,
Qui ſans de grands efforts ne puiſſe eſtre imité?	Qui sans de grands efforts ne puisse être imité?
Mon, je croy tout facile à voſtre barbarie.	Non, je crois tout facile à votre barbarie.
Je vous croy digne, Ingrat, de m’arracher la vie.	Je vous crois digne, Ingrat, de m’arracher la vie.
De tous vos ſentimens mon cœur eſt éclaircy.	De tous vos sentiments mon cœur est éclairci.
Je ne vous parle plus de me laiſſer icy.	Je ne vous parle plus de me laisser ici.
Qui moy? J’aurois voulu honteuſe, & mépriſée,	Qui moi? J’aurais voulu honteuse, et méprisée,
D’un peuple qui me hait ſoutenir la riſée?	D’un peuple qui me hait soutenir la risée?
J’ay voulu vous pouſſer juſques à ce refus.	J’ai voulu vous pousser jusques à ce refus
C’en eſt fait, & bientoſt vous ne me craindrez plus.	C’en est fait, et bientôt vous ne me craindrez plus.
N’attendez pas icy que j’éclate en injures,	N’attendez pas ici que j’éclate en injures,
Que j’atteſte le Ciel ennemy des Parjures.	Que j’atteste le Ciel ennemi des Parjures.
Non, ſi le Ciel encore eſt touché de mes pleurs,	Non, si le Ciel encore est touché de mes pleurs,
Je le prie en mourant d’oublier mes douleurs.	Je le prie en mourant d’oublier mes douleurs.
Si je forme des vœux contre voſtre injuſtice,	Si je forme des vœux contre votre injustice,
Si dévant que mourir la triſte Berenice	Si devant que mourir la triste Bérénice
Vous veut de ſon trépas laiſſer quelque Vangeur,	Vous veut de son trépas laisser quelque Vengeur,
Je ne le cherche, Ingrat, qu’au fond de voſfre cœur.	Je ne le cherche, Ingrat, qu’au fond de votre cœur.
Je ſçay que tant d’amour n’en peut eſtre effacée,	Je sais que tant d’amour n’en peut être effacée,
Que ma douleur préſente, & ma bonté paſſée,	Que ma douleur présente, et ma bonté passée,
Mon ſang, qu’en ce Palais je veux meſme verſer,	Mon sang, qu’en ce Palais je veux même verser,
Sont autant d’Ennemis que je vais vous laiſſer.	Sont autant d’Ennemis que je vais vous laisser.
Et ſans me repentir de ma perſeverance,	Et sans me repentir de ma persévérance,
Je me remets ſur eux de toute ma vangeance.	Je me remets sur eux de toute ma vengeance.
Adieu.	Adieu.
DAns quel deſſein vient-elle de ſortir,	Dans quel dessein vient-elle de sortir,
Seigneur? Eſt-elle enfin diſpoſée à partir?	Seigneur? Est-elle enfin disposée à partir?
Paulin, je ſuis perdu, je n’y pourray ſurvivre.	Paulin, je suis perdu, je n’y pourrai survivre.
La Reyne veut mourir. Allons, il faut la ſuivre.	La Reine veut mourir. Allons, il faut la suivre.
Courons à ſon ſecours.	Courons à son secours.
Hé quoy? N’avez-vous pas	Hé quoi? N’avez-vous pas
Ordonné dés tantoſt qu’on obſerve ſes pas?	Ordonné dès tantôt qu’on observe ses pas?
Ses Femmes à toute heure autour d’elle empreſſées	Ses femmes à toute heure autour d’elle empressées
Sçauront la détourner de ces triſtes penſées.	Sauront la détourner de ces tristes pensées.
Non, non, ne craignez rien. Voilà les plus grands coups,	Non, non, ne craignez rien. Voilà les plus grands coups,
Seigneur, continuez, la victoire eſt à vous.	Seigneur, continuez, la victoire est à vous.
Je ſçay que ſans pitié vous n’avez pû l’entendre;	Je sais que sans pitié vous n’avez pu l’entendre;
Moy meſme en la voyant je n’ay pû m’en défendre.	Moi-même en la voyant je n’ai pu m’en défendre.
Mais regardez plus loin. Songez en ce malheur	Mais regardez plus loin. Songez en ce malheur
Quelle gloire va ſuivre un moment de douleur,	Quelle gloire va suivre un moment de douleur,
Quels applaudiſſemens l’Univers vous prepare,	Quels applaudissements l’Univers vous prépare,
Quel rang dans l’avenir.	Quel rang dans l’avenir.
Non, je ſuis un barbare,	Non, je suis un barbare,
Moi-meſme je me hais. Neron tant deteſté	Moi-même je me hais. Néron tant détesté
N’a point à cet excés pouſſé ſa cruauté.	N’a point à cet excès poussé sa cruauté.
Je ne ſouffriray point que Berenice expire.	Je ne souffrirai point que Bérénice expire.
Allons, Rome en dira ce qu’elle en voudra dire.	Allons, Rome en dira ce qu’elle en voudra dire.
Quoy, Seigneur?	Quoi, Seigneur?
Je ne ſçay, Paulin, ce que je dis.	Je ne sais, Paulin, ce que je dis.
L’excés de la douleur accable mes eſprits.	L’excès de la douleur accable mes esprits.
Ne troublez point le cours de voſtre Renommée,	Ne troublez point le cours de votre Renommée,
Seigneur. De vos Adieux la nouvelle eſt ſemée.	Seigneur. De vos Adieux la nouvelle est semée.
Rome, qui gemiſſoit, triomphe avec raiſon.	Rome, qui gémissait, triomphe avec raison.
Tous les Temples ouverts fument en voſtre nom.	Tous les Temples ouverts fument en votre nom.
Et le Peuple élevant vos vertus juſqu’aux nuës,	Et le Peuple élevant vos vertus jusqu’aux nues,
Va par tout de lauriers couronner vos Statuës.	Va partout de lauriers couronner vos Statues.
Ah Rome! Ah Berenice! Ah Prince malheureux!	Ah Rome! Ah Bérénice! Ah Prince malheureux!
Pourquoy ſuis-je Empereur? Pourquoy ſuis-je amoureux?	Pourquoi suis-je Empereur? Pourquoi suis-je amoureux?
QU’avez-vous fait, Seigneur? L’aimable Berenice	Qu’avez-vous fait, Seigneur? L’aimable Bérénice
Va peut-eſtre expirer dans les bras de Phénice.	Va peut-être expirer dans les bras de Phénice.
Elle n’entend ny pleurs, ny conſeil, ni raiſon.	Elle n’entend ni pleurs, ni conseil, ni raison.
Elle implore à grands cris le fer & le poiſon.	Elle implore à grands cris le fer et le poison.
Vous ſeul vous luy pouvez arracher cette envie.	Vous seul vous lui pouvez arracher cette envie.
On vous nomme, & ce nom la rappelle à la vie.	On vous nomme, et ce nom la rappelle à la vie.
Ses yeux toujours tournez vers voſtre Apartement	Ses yeux toujours tournés vers votre Appartement
Semblent vous demander de moment en moment.	Semblent vous demander de moment en moment.
Je n’y puis reſiſter, ce ſpectacle me tuë.	Je n’y puis résister, ce spectacle me tue.
Allez, Seigneur, allez vous montrer à ſa veuë.	Allez, Seigneur, allez vous montrer à sa vue.
Sauvez tant de vertus, de graces, de beauté,	Sauvez tant de vertus, de grâces, de beauté,
Ou renoncez, Seigneur, a toute humanité.	Ou renoncez, Seigneur, à toute humanité.
Dites un mot.	Dites un mot.
Helas! Quel mot puis-je luy dire?	Hélas! Quel mot puis-je lui dire?
Moy-meſme en ce moment ſçay-je ſi je reſpire?	Moi-même en ce moment sais-je si je respire?
SEigneur, tous les Tribuns, les Conſuls, le Senat,	Seigneur, tous les Tribuns, les Consuls, le Sénat,
Viennent vous demander au nom de tout l’Eſtat.	Viennent vous demander au nom de tout l’État.
Un grand Peuple les ſuit, qui plein d’impatience	Un grand Peuple les suit qui plein d’impatience
Dans voſtre Apartement attend voſtre préſence.	Dans votre Appartement attend votre présence.
Je vous entens, grands Dieux. Vous voulez raſſurer	Je vous entends, grands Dieux. Vous voulez rassurer
Ce cœur que vous voyez tout preſt à s’égarer.	Ce cœur que vous croyez tout prêt à s’égarer.
Venez, Seigneur, paſſons dans la Chambre prochaine,	Venez, Seigneur, passons dans la Chambre prochaine,
Allons voir le Senat.	Allons voir le Sénat.
Ah courez chez la Reyne.	Ah courez chez la Reine.
Quoy vous pourriez, Seigneur, par cette indignité,	Quoi vous pourriez, Seigneur, par cette indignité,
De l’Empire à vos piez fouler la majeſté?	De l’Empire à vos pieds fouler la majesté?
Rome....	Rome…
Il ſuffit, Paulin, nous allons les entendre.	Il suffit, Paulin, nous allons les entendre.
Prince, de ce devoir je ne puis me défendre.	Prince, de ce devoir je ne puis me défendre.
Voyez la Reyne. Allez. J’eſpere à mon retour	Voyez la Reine. Allez. J’espère à mon retour
Qu’elle ne pourra plus douter de mon amour.	Qu’elle ne pourra plus douter de mon amour.
OU pourray-je trouver ce Prince trop fidelle?	Où pourrai-je trouver ce Prince trop fidèle?
Ciel, conduiſez mes pas, & ſecondez mon zele.	Ciel, conduisez mes pas, et secondez mon zèle.
Faites qu’en ce moment je luy puiſſe annoncer	Faites qu’en ce moment je lui puisse annoncer
Un bonheur où peut-eſtre il n’oſe plus penſer.	Un bonheur où peut-être il n’ose plus penser.
AH quel heureux deſtin en ces lieux vous renvoye,	Ah quel heureux destin en ces lieux vous renvoie,
Seigneur?	Seigneur?
Si mon retour t’apporte quelque joye,	Si mon retour t’apporte quelque joie,
Arſace, rends-en grace à mon ſeul deſeſpoir.	Arsace, rends-en grâce à mon seul désespoir.
La Reyne part, Seigneur.	La Reine part, Seigneur.
Elle part?	Elle part?
Dés ce ſoir.	Dès ce soir.
Ses ordres ſont donnez. Elle s’eſt offenſée	Ses ordres sont donnés. Elle s’est offensée
Que Titus à ſes pleurs l’ait ſi longtemps laiſſée.	Que Titus à ses pleurs l’ait si longtemps laissée.
Un genereux dépit ſuccede à ſa fureur.	Un généreux dépit succède à sa fureur.
Berenice renonce à Rome, à l’Empereur,	Bérénice renonce à Rome, à l’Empereur,
Et meſme veut partir, avant que Rome inſtruite	Et même veut partir, avant que Rome instruite
Puiſſe voir ſon deſordre, & jouir de ſa fuite.	Puisse voir son désordre, et jouir de sa fuite.
Elle écrit à Ceſar.	Elle écrit à César.
O Ciel! Qui l’auroit crû?	Ô Ciel! Qui l’aurait cru?
Et Titus?	Et Titus?
A ſes yeux Titus n’a point paru.	À ses yeux Titus n'a point paru.
Le Peuple avec tranſport l’arreſte, & l’environne,	Le Peuple avec transport l’arrête, et l’environne,
Applaudiſſant aux noms que le Senat luy donne.	Applaudissant aux noms que le Sénat lui donne.
Et ces noms, ces reſpects, ces applaudiſſemens,	Et ces noms, ces respects, ces applaudissements,
Deviennent pour Titus autant d’engagemens,	Deviennent pour Titus autant d’engagements,
Qui le liant, Seigneur, d’une honorable chaîne,	Qui le liant, Seigneur, d’une honorable chaîne,
Malgré tous ſes ſoûpirs, & les pleurs de la Reyne,	Malgré tous ses soupirs, et les pleurs de la Reine,
Fixent dans ſon devoir ſes vœux irréſolus.	Fixent dans son devoir ses vœux irrésolus.
C’en eſt fait. Et peut-eſtre il ne la verra plus.	C’en est fait. Et peut-être il ne la verra plus.
Que de ſujets d’eſpoir, Arſace, je l'avouë!	Que de sujets d’espoir, Arsace, je l’avoue!
Mais d’un ſoin ſi cruel la Fortune me jouë,	Mais d’un soin si cruel la Fortune me joue,
J’ay veû tous mes projets tant de fois démentis,	J’ai vu tous mes projets tant de fois démentis,
Que j’écoute en tremblant tout ce que tu me dis;	Que j’écoute en tremblant tout ce que tu me dis;
Et mon cœur prévenu d’une crainte importune,	Et mon cœur prévenu d’une crainte importune,
Croit meſme, en eſperant, irriter la Fortune.	Croit même, en espérant, irriter la Fortune.
Mais que vois-je? Titus porte vers nous ſes pas.	Mais que vois-je? Titus porte vers nous ses pas.
Que veut-il?	Que veut-il?
DEmeurez, qu’on ne me ſuive pas.	DEmeurez, qu'on ne me suive pas.
Enfin, Prince, je viens dégager ma promeſſe.	Enfin, Prince, je viens dégager ma promesse.
Bérenice m’occupe, & m’afflige ſans ceſſe.	Bérénice m’occupe, et m’afflige sans cesse.
Je viens le cœur percé de vos pleurs, & des ſiens,	Je viens le cœur percé de vos pleurs, et des siens,
Calmer des déplaiſirs moins cruels que les miens.	Calmer des déplaisirs moins cruels que les miens.
Venez; Prince, venez. Je veux bien que vous-meſme,	Venez; Prince, venez. Je veux bien que vous-même,
Pour la derniere fois vous voyez ſi je l’aime.	Pour la dernière fois vous voyiez si je l’aime.
HE' bien, voilà l’eſpoir que tu m’avois rendu.	Hé bien, voilà l’espoir que tu m’avais rendu.
Et tu vois le triomphe où j’eſtois atttendu.	Et tu vois le triomphe où j’étais attendu.
Berenice partoit juſtement irrritée?	Bérénice partait justement irritée?
Pour ne la plus revoir Titus l’avoit quittée?	Pour ne la plus revoir Titus l’avait quittée?
Qu’ay-je donc fait, grands Dieux! Quel cours infortuné	Qu’ai-je donc fait, grands Dieux! Quel cours infortuné
A ma funeſte vie aviez-vous deſtiné!	À ma funeste vie aviez-vous destiné!
Tous mes momens ne ſont qu’un éternel paſſage	Tous mes moments ne sont qu’un éternel passage
De la crainte à l’eſpoir, de l’eſpoir à la rage.	De la crainte à l’espoir, de l’espoir à la rage.
Et je reſpire encor? Berénice! Titus!	Et je respire encor? Bérénice! Titus!
Dieux cruels! de mes pleurs vous ne vous rirez plus.	Dieux cruels! de mes pleurs vous ne vous rirez plus.
NOn, je n’écoute rien. Me voilà reſoluë.	NOn, je n’écoute rien. Me voilà résolue.
Je veux partir. Pourquoy vous montrer à ma veuë?	Je veux partir. Pourquoi vous montrer à ma vue?
Pourquoy venir encore aigrir mon deſeſpoir?	Pourquoi venir encore aigrir mon désespoir?
N’eſtes-vous pas content? Je ne veux plus vous voir.	N’êtes-vous pas content? Je ne veux plus vous voir.
Mais de grace, écoutez.	Mais de grâce, écoutez.
Il n’eſt plus temps.	Il n’est plus temps.
Madame,	Madame,
Un mot.	Un mot.
Non.	Non.
Dans quel trouble elle jette mon ame!	Dans quel trouble elle jette mon âme!
Ma Princeſſe, d’où vient ce changement ſoudain?	Ma Princesse, d’où vient ce changement soudain?
C’en eſt fait. Vous voulez que je parte demain.	C’en est fait. Vous voulez que je parte demain.
Et moy, j’ay reſolu de partir tout à l’heure.	Et moi, j’ai résolu de partir tout à l’heure.
Et je pars.	Et je pars.
Demeurez.	Demeurez.
Ingrat, que je demeure?	Ingrat, que je demeure?
Et pourquoy? Pour entendre un Peuple injurieux	Et pourquoi? Pour entendre un Peuple injurieux
Qui fait de mon malheur retentir tous ces lieux?	Qui fait de mon malheur retentir tous ces lieux?
Ne l’entendez-vous pas cette cruelle joye,	Ne l’entendez-vous pas cette cruelle joie,
Tandis que dans les pleurs moy ſeule je me noye?	Tandis que dans les pleurs moi seule je me noie?
Quel crime, quelle offenſe a pû les animer?	Quel crime, quelle offense a pu les animer?
Helas! Et qu’ay-je fait que de vous trop aimer?	Hélas! Et qu’ai-je fait que de vous trop aimer?
Ecoutez-vous, Madame, une foule inſenſée?	Écoutez-vous, Madame, une foule insensée?
Je ne voy rien icy dont je ne ſois bleſſée.	Je ne vois rien ici dont je ne sois blessée.
Tout cet Apartement preparé par vos ſoins,	Tout cet Appartement préparé par vos soins,
Ces lieux, de mon amour ſi longtemps les témoins,	Ces lieux, de mon amour si longtemps les témoins,
Qui ſembloient pour jamais me répondre du voſtre,	Qui semblaient pour jamais me répondre du vôtre,
Ces chiffres, où nos noms enlaſſez l’un dans l’autre,	Ces chiffres, où nos noms enlacés l’un dans l’autre,
A mes triſtes regards viennent par tout s’offrir,	À mes tristes regards viennent partout s’offrir,
Sont autant d’impoſteurs que je ne puis ſouffrir.	Sont autant d’imposteurs que je ne puis souffrir.
Allons, Phénice.	Allons, Phénice.
O Ciel! Que vous eſtes injuſte!	Ô Ciel! Que vous eſtes injuſte!
Retournez, retournez vers ce Senat auguſte	Retournez, retournez vers ce Sénat auguste
Qui vient vous applaudir de voſtre cruauté.	Qui vient vous applaudir de votre cruauté.
Hé bien, avec plaiſir l’avez-vous écouté?	Hé bien, avec plaisir l’avez-vous écouté?
Eſtes-vous pleinement content de voſtre gloire?	Êtes-vous pleinement content de votre gloire?
Avez-vous bien promis d’oublier ma memoire?	Avez-vous bien promis d’oublier ma mémoire?
Mais ce n’eſt pas aſſez expier vos amours.	Mais ce n’est pas assez expier vos amours.
Avez-vous bien promis de me haïr toûjours?	Avez-vous bien promis de me haïr toujours?
Non, je n’ay rien promis. Moy, que je vous haïſſe!	Non, je n’ai rien promis. Moi, que je vous haïsse!
Que je puiſſe jamais oublier Berenice!	Que je puisse jamais oublier Bérénice!
Ah Dieux! Dans quel moment ſon injuſte rigueur	Ah Dieux! Dans quel moment son injuste rigueur
De ce cruel ſoupçon vient affliger mon cœur!	De ce cruel soupçon vient affliger mon cœur!
Connoiſſez-moy, Madame, & depuis cinq années	Connaissez-moi, Madame, et depuis cinq années
Contez tous les momens, & toutes les journées	Comptez tous les moments, et toutes les journées
Où par plus de transports, & par plus de ſoupirs,	Où par plus de transports, et par plus de soupirs,
Je vous ay de mon cœur exprimé les deſirs;	Je vous ai de mon cœur exprimé les désirs;
Ce jour ſurpaſſe tout. Jamais, je le confeſſe,	Ce jour surpasse tout. Jamais, je le confesse,
Vous ne fuſtes aimée avec tant de tendreſſe.	Vous ne fûtes aimée avec tant de tendresse.
Et jamais...	Et jamais…
Vous m’aimez, vous me le ſoûtenez,	Vous m’aimez, vous me le soutenez,
Et cependant je pars, & vous me l’ordonnez?	Et cependant je pars, et vous me l’ordonnez?
Quoy, dans mon deſeſpoir trouuez-vous tant de charmes?	Quoi, dans mon désespoir trouvez-vous tant de charmes?
Craignez-vous que mes yeux versent trop peu de larmes?	Craignez-vous que mes yeux versent trop peu de larmes?
Que me ſert de ce cœur l’inutile retour?	Que me sert de ce cœur l’inutile retour?
Ah cruel! par pitié montrez-moy moins d’amour.	Ah cruel! par pitié montrez-moi moins d’amour.
Ne me rappellez point une trop chere idée.	Ne me rappelez point une trop chère idée.
Et laiſſez-moy du moins partir perſuadée	Et laissez-moi du moins partir persuadée
Que déja de voſtre ame exilée en ſecret,	Que déjà de votre âme exilée en secret,
J’abandonne un Ingrat qui me perd ſans regret.	J’abandonne un Ingrat qui me perd sans regret.
Vous m’avez arraché ce que je viens d’écrire.	Vous m’avez arraché ce que je viens d’écrire.
Voilà de voſtre amour tout ce que je deſire.	Voilà de votre amour tout ce que je désire.
Liſez, Ingrat liſez, & me laiſſez ſortir.	Lisez, Ingrat, lisez, et me laissez sortir.
Vous ne ſortirez point, je n’y puis conſentir.	Vous ne sortirez point, je n’y puis consentir.
Quoy, ce départ n’eſt donc qu’un cruel ſtratagême?	Quoi, ce départ n’est donc qu’un cruel stratagème?
Vous cherchez à mourir? Et de tout ce que j’aime	Vous cherchez à mourir? Et de tout ce que j’aime
Il ne reſtera plus qu’un triſte ſouvenir?	Il ne restera plus qu’un triste souvenir?
Qu’on cherche Antiochus, qu’on le faſſe venir.	Qu’on cherche Antiochus, qu’on le fasse venir.
MAdame, il faut vous faire un aveu veritable,	MAdame, il faut vous faire un aveu véritable,
Lors que j’enviſageay le moment redoutable	Lorsque j’envisageai le moment redoutable
Où preſſé par les lois d’un auſtere devoir	Où pressé par les lois d’un austère devoir
Il falloit pour jamais renoncer à vous voir.	Il fallait pour jamais renoncer à vous voir.
Quand de ce triſte Adieu je prévis les approches,	Quand de ce triste Adieu je prévis les approches,
Mes craintes, mes combats, vos larmes, vos reproches,	Mes craintes, mes combats, vos larmes, vos reproches,
Je m’attendis, Madame, à toutes les douleurs	Je m’attendis, Madame, à toutes les douleurs
Que peut faire ſentir le plus grand des malheurs.	Que peut faire sentir le plus grand des malheurs.
Mais quoy que je craigniſſe, il faut que je le die,	Mais quoi que je craignisse, il faut que je le die,
Je n’en avois préveû que la moindre partie.	Je n’en avais prévu que la moindre partie.
Je croyois ma vertu moins preſte à ſuccomber,	Je croyais ma vertu moins prête à succomber,
Et j’ay honte du trouble où je la voy tomber.	Et j’ai honte du trouble où je la vois tomber.
J’ay veû devant res yeux Rome entiere aſſemblée.	J’ai vu devant mes yeux Rome entière assemblée.
Le Senat m’a parlé. Mais mon ame accablée	Le Sénat m’a parlé. Mais mon âme accablée
Ecoutoit ſans entendre, & ne leur a laiſſé,	Écoutait sans entendre, et ne leur a laissé,
Pour prix de leurs transports, qu’un ſilence glacé.	Pour prix de leurs transports, qu’un silence glacé.
Rome de voſtre ſort eſt encore incertaine.	Rome de votre sort est encore incertaine.
Moy-meſme à tous momens je me ſouviens à peine	Moi-même à tous moments je me souviens à peine
Si je ſuis Empereur, ou ſi je ſuis Romain.	Si je suis Empereur, ou si je suis Romain.
Je ſuis venu vers vous ſans ſçavoir mon deſſein.	Je suis venu vers vous sans savoir mon dessein.
Mon amour m’entraiſnoit, & je venois peut-eſtre	Mon amour m’entraînait, et je venais peut-être
Pour me chercher moy- meſme, & pour me reconnaiſtre.	Pour me chercher moi-même, et pour me reconnaître.
Qu’ay-je trouvé? Je voy la mort peinte en vos yeux.	Qu’ai-je trouvé? Je vois la mort peinte en vos yeux.
Je voy pour la chercher que vous quittez ces lieux.	Je vois pour la chercher que vous quittez ces lieux.
C’en eſt trop Ma douleur à cette triſte veuë	C’en est trop Ma douleur à cette triste vue
A ſon dernier excés eſt enfin parvenuë.	À son dernier excès est enfin parvenue.
Je reſſens tous les maux que je puis reſſentir.	Je ressens tous les maux que je puis ressentir.
Mais je voy le chemin par où j’en puis ſortir.	Mais je vois le chemin par où j’en puis sortir.
Ne vous attendez point, que las de tant d’allarmes,	Ne vous attendez point, que las de tant d’alarmes,
Par un heureux hymen je tariſſe vos larmes.	Par un heureux hymen je tarisse vos larmes.
En quelque extrémité que vous m’ayez réduit,	En quelque extrémité que vous m’ayez réduit,
Ma Gloire inexorable a toute heure me ſuit.	Ma Gloire inexorable à toute heure me suit.
Sans ceſſe elle préſente à mon ame étonnée	Sans cesse elle présente à mon âme étonnée
L’Empire incompatible avec voſtre hymenée;	L’Empire incompatible avec votre hyménée;
Et je voy bien qu’apres tous les pas que j’ay faits,	Et je vois bien qu’après tous les pas que j’ai faits,
Je doy vous épouſer encor moins que jamais.	Je dois vous épouser encor moins que jamais.
Oüy, Madame. Et je doy moins encore vous dire	Oui, Madame. Et je dois moins encore vous dire
Que je ſuis preſt pour vous d’abandonner l’Empire,	Que je suis prêt pour vous d’abandonner l’Empire,
De vous ſuivre, & d’aller trop content de mes fers	De vous suivre, et d’aller trop content de mes fers
Soupirer avec vous au bout de l'Univers	Soupirer avec vous au bout de l’Univers
Vous-meſme rougiriez de ma lâche conduite.	Vous-même rougiriez de ma lâche conduite.
Vous verriez à regret marcher à voſtre ſuite	Vous verriez à regret marcher à votre suite
Un indigne Empereur ſans Empire, ſans Cour,	Un indigne Empereur sans Empire, sans Cour,
Vil ſpectacle aux humains des foibleſſes d’amour.	Vil spectacle aux humains des faiblesses d’amour.
Pour ſortir des tourmens, dont mon ame eſt la proye,	Pour sortir des tourments, dont mon âme est la proie,
Il eſt, vous le ſçavez, une plus noble voye;	Il est, vous le savez, une plus noble voie;
Je me ſuis veû, Madame, enſeigner ce chemin	Je me suis vu, Madame, enseigner ce chemin
Et par plus d’un Heros, & par plus d’un Romain.	Et par plus d’un Héros, et par plus d’un Romain.
Lors que trop de malheurs ont laſſé leur conſtance,	Lorsque trop de malheurs ont lassé leur constance,
Ils ont tous expliqué cette perſeverance	Ils ont tous expliqué cette persévérance
Dont le ſort s’attachoit à les perſecuter,	Dont le sort s’attachait à les persécuter,
Comme un ordre ſecret de n’y plus reſiſter.	Comme un ordre secret de n’y plus résister.
Si vos pleurs plus longtemps viẽnent fraper ma veuë,	Si vos pleurs plus longtemps viennent frapper ma vue,
Si toujours à mourir je vous voy reſoluë,	Si toujours à mourir je vous vois résolue,
S’il faut qu’à tous momens je tremble pour vos jours,	S’il faut qu’à tous moments je tremble pour vos jours,
Si vous ne me jurez d’en reſpecter le cours;	Si vous ne me jurez d’en respecter le cours;
Madame, à d’autres pleurs vous devez vous attendre,	Madame, à d’autres pleurs vous devez vous attendre,
En l’eſtat où je ſuis je puis tout entreprendre,	En l’état où je suis je puis tout entreprendre,
Et je ne répons pas que ma main à vos yeux	Et je ne réponds pas que ma main à vos yeux
N’enſanglante à la fin nos funeſtes Adieux.	N’ensanglante à la fin nos funestes Adieux.
Helas!	Hélas!
Non, il n’eſt rien dont je ne ſois capable.	Non, il n’est rien dont je ne sois capable.
Vous voilà de mes jours maintenant reſponſable.	Vous voilà de mes jours maintenant responsable.
Songez-y bien, Madame. Et ſi je vous ſuis cher....	Songez-y bien, Madame. Et si je vous suis cher…
VEnez, Prince, venez, je vous ay fait chercher.	VEnez, Prince, venez, je vous ai fait chercher.
Soyez icy témoin de toute ma foibleſſe.	Soyez ici témoin de toute ma faiblesse.
Voyez ſi c’eſt aimer avec peu de tendreſſe.	Voyez si c’est aimer avec peu de tendresse.
Jugez nous.	Jugez nous.
Je croy tout. Je connoy voſtre amour.	Je crois tout. Je connais votre amour.
Mais vous, connoiſſez moy, Seigneur, à voſtre tour.	Mais vous, connaissez-moi, Seigneur à votre tour.
Vous m’avez honoré, Seigneur, de voſtre eſtime,	Vous m’avez honoré, Seigneur, de votre estime,
Et moy, je puis icy vous le jurer ſans crime,	Et moi, je puis ici vous le jurer sans crime,
A vos plus chers amis j’ay disputé ce rang.	À vos plus chers amis j’ai disputé ce rang.
Je l’ay disputé meſme aux deſpens de mon ſang.	Je l’ai disputé même aux dépens de mon sang.
Vous m’avez, malgré moy, confié l’un & l’autre,	Vous m’avez, malgré moi, confié l’un et l’autre,
La Reyne ſon amour, & vous, Seigneur, le voſtre.	La Reine son amour, et vous, Seigneur, le vôtre.
La Reyne, qui m’entend, peut me deſavoüer,	La Reine, qui m’entend, peut me désavouer,
Elle m’a veû toujours ardent à vous loüer,	Elle m’a vu toujours ardent à vous louer,
Répondre par mes ſoins à voſtre confidence.	Répondre par mes soins à votre confidence.
Vous croyez m’en devoir quelque reconnoiſſance.	Vous croyez m’en devoir quelque reconnaissance.
Mais croiriez-vous, Seigneur, en ce moment fatal,	Mais croiriez-vous, Seigneur, en ce moment fatal,
Qu’un Amy ſi fidelle eſtoit voſtre Rival?	Qu’un Ami si fidèle était votre Rival?
Mon Rival!	Mon Rival!
Il eſt temps que je vous éclairciſſe.	Il est temps que je vous éclaircisse.
Oüy, Seigneur, j’ay toujours adoré Berenice.	Oui, Seigneur, j’ai toujours adoré Bérénice.
Pour ne la plus aimer, j’ay cent fois combattu.	Pour ne la plus aimer, j’ai cent fois combattu.
Je n’ay pû l’oublier, au moins je me ſuis tû.	Je n’ai pu l’oublier, au moins je me suis tu.
De voſtre changement la flatteuſe apparence	De votre changement la flatteuse apparence
M’avoit rendu tantoſt quelque foible eſperance.	M’avait rendu tantôt quelque faible espérance.
Les larmes de la Reyne ont éteint cet eſpoir.	Les larmes de la Reine ont éteint cet espoir.
Ses yeux baignez de pleurs demandoient à vous voir.	Ses yeux baignés de pleurs demandaient à vous voir.
Je ſuis venu, Seigneur, vous appeller moy-meſme.	Je suis venu, Seigneur, vous appeler moi-même.
Vous eſtes revenu. Vous aimez, on vous aime;	Vous êtes revenu. Vous aimez, on vous aime;
Vous vous eſtes rendu, je n’en ay point douté.	Vous vous êtes rendu, je n’en ai point douté.
Pour la derniere fois je me ſuis conſulté.	Pour la dernière fois je me suis consulté.
J’ay fait de mon courage une épreuve derniere,	J’ai fait de mon courage une épreuve dernière,
Je viens de rappeller ma raiſon toute entiere.	Je viens de rappeler ma raison toute entière.
Jamais je ne me ſuis ſenti plus amoureux.	Jamais je ne me suis senti plus amoureux.
Il faut d’autres efforts pour rompre tant de nœuds.	Il faut d’autres efforts pour rompre tant de nœuds.
Ce n’eſt qu’en expirant que je puis les détruire.	Ce n’est qu’en expirant que je puis le détruire.
J’y cours. Voilà dequoy j'ay voulu vous inſtruire.	J’y cours. Voilà de quoi j’ai voulu vous instruire.
Ouy, Madame, vers vous j’ay rappellé ſes pas.	Oui, Madame, vers vous j’ai rappelé ses pas.
Mes ſoins ont reüſſi, je ne m’en repens pas.	Mes soins ont réussi, je ne m’en repens pas.
Puiſſe le Ciel verſer ſur toutes vos années	Puisse le Ciel verser sur toutes vos années
Mille proſperitez l’une à l’autre enchaiſnées.	Mille prospérités l’une à l’autre enchaînées.
Ou s’il vous garde encore un reſte de courroux,	Ou s’il vous garde encore un reste de courroux,
Je conjure les Dieux d’épuiſer tous les coups	Je conjure les Dieux d’épuiser tous les coups
Qui pourroient menacer une ſi belle vie,	Qui pourraient menacer une si belle vie,
Sur ces jours malheureux que je vous ſacrifie.	Sur ces jours malheureux que je vous sacrifie.
Arreſtez. Arreſtez. Princes trop généreux,	Arrêtez. Arrêtez. Princes trop généreux,
En quelle extremité me jettez-vous tous deux!	En quelle extrémité me jetez-vous tous deux!
Soit que je vous regarde, ou que je l’enviſage,	Soit que je vous regarde, ou que je l’envisage,
Par tout du deſeſpoir je rencontre l’image.	Partout du désespoir je rencontre l’image.
Je ne voy que des pleurs. Et je n’entens parler	Je ne vois que des pleurs. Et je n’entends parler
Que de trouble, d’horreurs, de ſang preſt à couler.	Que de trouble, d’horreurs, de sang prêt à couler.
Mon cœur vous eſt connu, Seigneur * & je puis dire	Mon cœur vous est connu, Seigneur et je puis dire
Qu’on ne l’a jamais veû ſoupirer pour l’Empire.	Qu’on ne l’a jamais vu soupirer pour l’Empire.
La grandeur des Romains, la pourpre des Céſars,	La grandeur des Romains, la pourpre des Césars,
N’a point, vous le ſçavez, attiré mes regards.	N’a point, vous le savez, attiré mes regards.
J'aimois, Seigneur, j’aimois, je voulois eſtre aimée.	J’aimais, Seigneur, j’aimais, je voulais être aimée.
Ce jour, je l’avouray, je me ſuis allarmée.	Ce jour, je l’avouerai, je me suis alarmée.
J’ay crû que voſtre amour alloit ſinir ſon cours.	J’ai cru que votre amour allait finir son cours.
Je connoy mon erreur, & vous m’aimez toûjours.	Je connais mon erreur, et vous m’aimez toujours.
Voſtre cœur s’eſt troublé, j’ay veu couler vos larmes.	Votre cœur s’est troublé, j’ai vu couler vos larmes.
Berenice, Seigneur, ne vaut point tant d’allarmes,	Bérénice, Seigneur, ne vaut point tant d’alarmes,
Ny que par voſtre amour l'Univers malheureux,	Ni que par votre amour l’Univers malheureux,
Dans le temps que Titus attire tous ſes vœux,	Dans le temps que Titus attire tous ses vœux,
Et que de vos vertus il goûte les prémices,	Et que de vos vertus il goûte les prémices,
Se voye en un moment enlever ſes délices.	Se voie en un moment enlever ses délices.
Je croy depuis cinq ans juſqu’à ce dernier jour	Je crois depuis cinq ans jusqu’à ce dernier jour
Vous avoir aſſuré d’un veritable amour.	Vous avoir assuré d’un véritable amour.
Ce n’eſt pas tout, je veux en ce moment funeſte	Ce n’est pas tout, je veux en ce moment funeste
Par un dernier effort couronner tout le reſte.	Par un dernier effort couronner tout le reste.
Je vivray, je ſuivray vos ordres abſolus.	Je vivrai, je suivrai vos ordres absolus.
Adieu, Seigneur regnez, je ne vous verray plus.	Adieu, Seigneur, régnez, je ne vous verrai plus.
* Prince, apres cet adieu, vous jugez bien vous-méme	Prince, après cet adieu, vous jugez bien vous-même
Que je ne conſens pas de quitter ce que j’aime,	Que je ne consens pas de quitter ce que j’aime,
Pour aller loin de Rome écouter d’autres vœux.	Pour aller loin de Rome écouter d’autres vœux.
Vivez, & faites vous un effort genereux.	Vivez, et faites-vous un effort généreux.
Sur Titus, & ſur moy, reglez voſtre conduite.	Sur Titus, et sur moi, réglez votre conduite.
Je l’aime, je le fuis. Titus m’aime, il me quitte.	Je l’aime, je le fuis. Titus m’aime, il me quitte.
Portez loin de mes yeux vos ſoupirs, & vos fers.	Portez loin de mes yeux vos soupirs, et vos fers.
Adieu, ſervons tous trois d’exemple à l'Univers	Adieu, servons tous trois d’exemple à l’Univers
De l’amour la plus tendre, & la plus malheureuſe,	De l’amour la plus tendre, et la plus malheureuse,
Dont il puiſſe garder l’hiſtoire douloureuſe.	Dont il puisse garder l’histoire douloureuse.
Tout eſt preſt. On m’attend. Ne ſuivez point mes pas.	Tout est prêt. On m’attend. Ne suivez point mes pas.
Pour la derniere fois, * Adieu, Seigneur.	Pour la dernière fois, Adieu, Seigneur.
Helas!	Hélas!
