OVY, puis que ie retrouue vn Amy ſi fidelle,	Oui, puisque je retrouve un Ami si fidèle,
Ma Fortune va prendre vne face nouuelle;	Ma Fortune va prendre une face nouvelle;
Et déja ſon courroux ſemble s'eſtre adouci,	Et déjà son courroux semble s’être adouci,
Depuis qu'elle a pris ſoin de nous rejoindre ici.	Depuis qu’elle a pris soin de nous rejoindre ici.
Qui m'euſt dit, qu'vn riuage à mes vœux si funeſte,	Qui m’eût dit, qu’un rivage à mes vœux si funeste,
Préſenteroit d'abord Pylade aux yeux d'Oreſte,	Présenterait d’abord Pylade aux yeux d’Oreste,
Qu'apres plus de ſix mois que ie t'auois perdu,	Qu’après plus de six mois que je t’avais perdu,
A la Cour de Pyrrhus tu me ſerois rendu!	À la Cour de Pyrrhus tu me serais rendu!
I'en rends graces au Ciel, qui m'arreſtant ſans ceſſe,	J’en rends grâces au Ciel, qui m’arrêtant sans cesse,
Sembloit m'auoir fermé le chemin de la Gréce,	Semblait m’avoir fermé le chemin de la Grèce,
Depuis le jour fatal que la fureur des Eaux,	Depuis le jour fatal que la fureur des Eaux,
Preſque aux yeux de Mycéne, écarta nos Vaiſſeaux.	Presque aux yeux de Mycène, écarta nos Vaisseaux.
Combien dans cét exil ay-je ſouffert d'allarmes?	Combien dans cet exil ai-je souffert d’alarmes?
Combien à vos malheurs ay-je donné de larmes?	Combien à vos malheurs ai-je donné de larmes?
Craignant toûjours pour vous quelque nouueau danger	Craignant toujours pour vous quelque nouveau danger,
Que ma triste Amitié ne pouuoit partager.	Que ma triste Amitié ne pouvait partager.
Sur tout ie redoutois cette Mélancolie	Surtout je redoutais cette mélancolie
Où j'ay veu ſi long-temps voſtre Ame enſeuelie.	Où j’ai vu si longtemps votre Âme ensevelie.
Ie craignois que le Ciel, par vn cruel ſecours,	Je craignais que le Ciel, par un cruel secours,
Ne vous offrît la mort, que vous cherchiez toûjours.	Ne vous offrît la mort, que vous cherchiez toujours.
Mais ie vous voy, Seigneur, & ſi j'oſe le dire,	Mais je vous vois, Seigneur, et si j’ose le dire,
Vn Deſtin plus heureux vous conduit en Epire.	Un Destin plus heureux vous conduit en Épire.
Le pompeux Appareil qui ſuit icy vos pas,	Le pompeux Appareil qui suit ici vos pas,
N'eſt point d'vn Malheureux qui cherche le trépas.	N’est point d’un Malheureux qui cherche le trépas.
Helas! qui peut ſçavoir le Deſtin qui m'ameine?	Hélas! qui peut savoir le Destin qui m’amène?
L'Amour me fait icy chercher vne Inhumaine.	L’Amour me fait ici chercher une Inhumaine.
Mais qui ſçait ce qu'il doit ordonner de mon Sort,	Mais qui sait ce qu’il doit ordonner de mon Sort,
Et ſi ie viens chercher, ou la vie, ou la mort?	Et si je viens chercher, ou la vie, ou la mort?
Quoy! voſtre Ame à l'Amour, en Eſclaue aſſeruie,	Quoi! votre Âme à l’Amour, en Esclave asservie,
Se repose ſur luy du ſoin de voſtre vie?	Se repose sur lui du soin de votre vie?
Par quels charmes, apres tant de tourmens soufferts	Par quels charmes, après tant de tourments soufferts
Peut-il vous inuiter à rentrer dans ſes fers?	Peut-il vous inviter à rentrer dans ses fers?
Penſez-vous qu'Hermionne, à Sparte inéxorable,	Pensez-vous qu’Hermione, à Sparte inexorable,
Vous prépare en Epire vn Sort plus fauorable?	Vous prépare en Épire un Sort plus favorable?
Honteux d'auoir pouſsé tant de vœux ſuperflus,	Honteux d’avoir poussé tant de vœux superflus,
Vous l'abhorriez. Enfin, vous ne m'en parliez plus.	Vous l’abhorriez. Enfin, vous ne m’en parliez plus.
Vous me trompiez, Seigneur.	Vous me trompiez, Seigneur.
Ie me trompois moy-méme.	Je me trompais moi-même.
Amy, n'inſulte point vn Malheureux qui t'aime.	Ami, n’insulte point un Malheureux qui t’aime.
T'ay-je iamais caché mon cœur & mes deſirs?	T’ai-je jamais caché mon cœur et mes désirs?
Tu vis naiſtre ma flâme & mes premiers ſoûpirs.	Tu vis naître ma flamme et mes premiers soupirs.
Enfin, quand Menelas diſpoſa de ſa Fille	Enfin, quand Ménélas disposa de sa Fille
En faueur de Pyrrhus, vangeur de ſa Famille;	En faveur de Pyrrhus, vengeur de sa Famille;
Tu vis mon deſeſpoir, & tu m’as veu depuis	Tu vis mon désespoir, et tu m’as vu depuis
Traîner de Mers en Mers ma chaîne & mes ennuis.	Traîner de Mers en Mers ma chaîne et mes ennuis.
Ie te vis à regret, en cét eſtat funeſte,	Je te vis à regret, en cet état funeste,
Preſt à ſuiure par tout le déplorable Oreſte,	Prêt à suivre partout le déplorable Oreste,
Toûjours de ma fureur interrompre le cours,	Toujours de ma fureur interrompre le cours,
Et de moy-meſme enfin me ſauuer tous les jours.	Et de moi-même enfin me sauver tous les jours.
Mais quand ie me ſouuins, que parmy tant d’allarmes	Mais quand je me souvins, que parmi tant d’alarmes
Hermionne à Pyrrhus prodiguoit tous ſes charmes,	Hermione à Pyrrhus prodiguait tous ses charmes,
Tu ſçais de quel courroux mon cœur alors épris	Tu sais de quel courroux mon cœur alors épris
Voulut, en l’oubliant, vanger tous ſes mépris.	Voulut, en l’oubliant, venger tous ses mépris .
Ie fis croire, & ie crûs ma victoire certaine.	Je fis croire, et je crus ma victoire certaine.
Ie pris tous mes tranſports pour des tranſports de haine;	Je pris tous mes transports pour des transports de haine;
Déteſtant ſes rigueurs, rabaiſſant ſes attraits,	Détestant ses rigueurs, rabaissant ses attraits,
Ie défiois ſes yeux de me troubler iamais.	Je défiais ses yeux de me troubler jamais.
Voila comme ie crûs étouffer ma tendreſſe.	Voilà comme je crus étouffer ma tendresse.
Dans ce calme trompeur j’arriuay dans la Gréce;	Dans ce calme trompeur j’arrivai dans la Grèce;
Et ie trouuay d’abord ſes Princes raſſemblez,	Et je trouvai d’abord ses Princes rassemblés,
Qu’vn péril aſſez grand ſembloit auoir troublez.	Qu’un péril assez grand semblait avoir troublés.
I’y courus. Ie penſay que la Guerre, & la Gloire,	J’y courus. Je pensai que la Guerre, et la Gloire,
De ſoins plus importans rempliroient ma memoire;	De soins plus importants rempliraient ma mémoire;
Que mes ſens reprenant leur premiere vigueur,	Que mes sens reprenant leur première vigueur,
L’Amour acheueroit de ſortir de mon Cœur.	L’Amour achèverait de sortir de mon Cœur.
Mais admire auec moy le Sort, dont la pourſuite	Mais admire avec moi le Sort, dont la poursuite
Me fait courir moy-meſme au piege que j’éuite.	Me fait courir moi-même au piège que j’évite.
I’entens de tous coſtez qu’on menace Pyrrhus.	J’entends de tous côtés qu’on menace Pyrrhus.
Toute la Gréce éclate en murmures confus.	Toute la Grèce éclate en murmures confus.
On ſe plaint, qu’oubliant ſon Sang, & ſa promeſſe,	On se plaint, qu’oubliant son Sang, et sa promesse,
Il éleue en ſa Cour l’Ennemy de la Gréce,	Il élève en sa Cour l’Ennemi de la Grèce,
Aſtyanax, d'Hector jeune & malheureux Fils,	Astyanax, d’Hector jeune et malheureux Fils,
Reſte de tant de Roys ſous Troye enſeuelis.	Reste de tant de Rois sous Troie ensevelis.
I’apprens, que pour rauir ſon enfance au Suplice,	J’apprends, que pour ravir son enfance au Supplice,
Andromaque trompa l’ingénieux Vlyſſe,	Andromaque trompa l’ingénieux Ulysse,
Tandis qu’vn autre Enfant arraché de ſes bras,	Tandis qu’un autre Enfant arraché de ses bras,
Sous le nom de ſon Fils, futconduit au trépas.	Sous le nom de son Fils, fut conduit au trépas.
On dit, que peu ſenſible aux charmes d’Hermionne,	On dit, que peu sensible aux charmes d’Hermione,
Mon Riual porte ailleurs ſon Cœur & ſa Couronne;	Mon Rival porte ailleurs son Cœur et sa Couronne;
Ménelas, ſans le croire, en paroiſt affligé,	Ménélas, sans le croire, en paraît affligé,
Et ſe plaint d’vn Hymen ſi long-temps negligé.	Et se plaint d’un Hymen si longtemps négligé.
Parmy les déplaiſirs où ſon Ame ſe noye,	Parmi les déplaisirs où son Âme se noie,
Il s’éleue en la mienne vne ſecrette joye.	Il s’élève en la mienne une secrète joie.
Ie triomphe; & pourtant ie me flate d’abord	Je triomphe; et pourtant je me flatte d’abord
Que la ſeule vengeance excite ce tranſport.	Que la seule vengeance excite ce transport.
Mais l’Ingrate en mō Cœur reprit bientoſt ſa place,	Mais l’Ingrate en mon Cœur reprit bientôt sa place,
De mes feux mal éteints ie reconnus la trace,	De mes feux mal éteints je reconnus la trace,
Ie ſentis que ma haine alloit finir ſon cours,	Je sentis que ma haine allait finir son cours,
Ou plûtoſt ie ſentis que ie l’aimois toûjours.	Ou plutôt je sentis que je l’aimais toujours.
Ainſi de tous les Grecs ie brigue le ſuffrage.	Ainsi de tous les Grecs je brigue le suffrage.
On m’enuoye à Pyrrhus. I’entreprens ce voyage.	On m’envoie à Pyrrhus. J’entreprends ce voyage.
Ie viens voir ſi l’on peut arracher de ſes bras	Je viens voir si l’on peut arracher de ses bras
Cét Enfant, dont la vie allarme tant d’Eſtats.	Cet Enfant, dont la vie alarme tant d’États.
Heureux, ſi ie pouuois dans l’ardeur qui me preſſe,	Heureux, si je pouvais dans l’ardeur qui me presse,
Au lieu d’Aſtyanax, luy rauir ma Princeſſe.	Au lieu d’Astyanax, lui ravir ma Princesse.
Car enfin n’attens pas que mes feux redoublez,	Car enfin n’attends pas que mes feux redoublés,
Des périls les plus grands, puiſſent eſtre troublez.	Des périls les plus grands, puissent être troublés.
Puis qu’apres tant d’efforts ma reſiſtance eſt vaine,	Puisqu’après tant d’efforts ma résistance est vaine,
Ie me liure en aueugle au tranſport qui m’entraîne,	Je me livre en aveugle au transport qui m’entraîne,
I’aime, ie viens chercher Hermionne en ces lieux,	J’aime, je viens chercher Hermione en ces lieux,
La fléchir, l’enleuer, ou mourir à ſes yeux.	La fléchir, l’enlever, ou mourir à ses yeux.
Toy qui connois Pyrrhus, que penſes-tu qu’il faſſe?	Toi qui connais Pyrrhus, que penses-tu qu’il fasse?
Dans ſa Cour, dans ſon Cœur, dy-moy ce qui ſe paſſe.	Dans sa Cour, dans son Cœur, dis-moi ce qui se passe.
Mon Hermionne encor le tient-elle aſſeruy?	Mon Hermione encor le tient-elle asservi?
Me rendra-t'il, Pylade, vn Cœur qu’il m’a rauy?	Me rendra-t-il, Pylade, un Cœur qu’il m’a ravi?
Ie vous abuſerois, ſi i’oſois vous promettre	Je vous abuserais, si j’osais vous promettre
Qu’entre vos mains, Seigneur, il voulut la remettre.	Qu’entre vos mains, Seigneur, il voulût la remettre.
Non, que de ſa Conqueſte il paroiſſe flaté.	Non, que de sa Conquête il paraisse flatté.
Pour la Veuue d’Hector ſes feux ont éclaté.	Pour la Veuve d’Hector ses feux ont éclaté.
Il l’aime. Mais enfin cette Veuue inhumaine	Il l’aime. Mais enfin cette Veuve inhumaine
N’a payé jusqu’icy ſon amour que de haine,	N’a payé jusqu’ici son amour que de haine,
Et chaque jour encore on luy voit tout tenter,	Et chaque jour encore on lui voit tout tenter,
Pour fléchir ſa Captive, ou pour l’épouuanter.	Pour fléchir sa Captive, ou pour l’épouvanter.
Il luy cache ſon Fils, il menaſſe ſa teſte,	Il lui cache son Fils, il menace sa tête,
Et fait couler des pleurs, qu’auſſi-toſt il arreſte.	Et fait couler des pleurs, qu’aussitôt il arrête.
Hermionne elle-meſme a veu plus de cent fois	Hermione elle-même a vu plus de cent fois
Cet Amant irrité reuenir ſous ſes loix,	Cet Amant irrité revenir sous ses lois,
Et de ſes vœux troublez luy rapportant l’hommage,	Et de ses vœux troublés lui rapportant l’hommage,
Soûpirer à ſes pieds moins d’amour, que de rage.	Soupirer à ses pieds moins d’amour, que de rage.
Ainſi n’attendez pas, que l’on puiſſe aujourd’huy	Ainsi n’attendez pas, que l’on puisse aujourd’hui
Vous répondre d’vn Cœur, ſi peu maiſtre de luy.	Vous répondre d’un Cœur, si peu maître de lui.
Il peut, Seigneur, il peut dans ce deſordre extréme,	Il peut, Seigneur, il peut dans ce désordre extrême,
Epouſer ce qu’il hait, & perdre ce qu’il aime.	Épouser ce qu’il hait, et perdre ce qu’il aime .
Mais dy-moy, de quel œil Hermionne peut voir	Mais dis-moi, de quel œil Hermione peut voir
Ses attraits offenſez, & ſes yeux ſans pouuoir.	Ses attraits offensés, et ses yeux sans pouvoir?
Hermionne, Seigneur, au moins eu apparance,	Hermione, Seigneur, au moins en apparence,
Semble de ſon Amant dédaigner l’inconſtance,	Semble de son Amant dédaigner l’inconstance,
Et croit que trop heureux d’appaiſer ſa rigueur,	Et croit que trop heureux d’apaiser sa rigueur,
Il la viendra preſſer de reprendre ſon Cœur.	Il la viendra presser de reprendre son Cœur.
Mais ie l’ay veuë enfin me confier ſes larmes.	Mais je l’ai vue enfin me confier ses larmes.
Elle pleure en ſecret le mépris de ſes charmes.	Elle pleure en secret le mépris de ses charmes.
Toûjours preſte à partir, & demeurant toûjours,	Toujours prête à partir, et demeurant toujours,
Quelquefois elle appelle Oreſte à ſon ſecours.	Quelquefois elle appelle Oreste à son secours.
Ah! ſi ie le croyois, i’irois bientoſt, Pylade,	Ah! si je le croyais, j’irais bientôt, Pylade,
Me jetter…	Me jeter...
Acheuez, Seigneur, voſtre Ambaſſade.	Achevez, Seigneur, votre Ambassade.
Vous attendez le Roy. Parlez, & lui montrez	Vous attendez le Roi. Parlez, et lui montrez
Contre le Fils d’Hector tous les Grecs conjurez.	Contre le Fils d’Hector tous les Grecs conjurés.
Loin de leur accorder ce Fils de ſa Maiſtreſſe,	Loin de leur accorder ce Fils de sa Maîtresse,
Leur haine ne fera qu’irriter ſa tendreſſe.	Leur haine ne fera qu’irriter sa tendresse.
Plus on les veut broüiller, plus on va les vnir.	Plus on les veut brouiller, plus on va les unir.
Preſſez. Demandez tout, pour ne rien obtenir.	Pressez. Demandez tout, pour ne rien obtenir.
Il vient.	Il vient.
Hé bien, va donc diſpoſer la Cruelle	Hé bien, va donc disposer la Cruelle
A reuoir vn Amant qui ne vient que pour elle.	À revoir un Amant qui ne vient que pour elle.
AVant que tous les Grecs vous parlent par ma voix,	Avant que tous les Grecs vous parlent par ma voix,
Souffrez que ie me flate en ſecret de leur choix,	Souffrez que je me flatte en secret de leur choix ,
Et qu’à vos yeux, Seigneur, je montre quelque joye	Et qu’à vos yeux, Seigneur, je montre quelque joie
De voir le Fils d’Achille, & le Vainqueur de Troye.	De voir le Fils d’Achille, et le Vainqueur de Troie.
Oüy: Comme ſes exploits, nous admirons vos coups;	Oui: Comme ses exploits, nous admirons vos coups;
Hector tomba ſous luy; Troye expira ſous vous;	Hector tomba sous lui; Troie expira sous vous;
Et vous auez montré, par vne heureuſe audace,	Et vous avez montré, par une heureuse audace,
Que le Fils ſeul d’Achille a pû remplir ſa place.	Que le Fils seul d’Achille a pu remplir sa place.
Mais ce qu’il n’euſt point fait, la Gréce auec douleur	Mais ce qu’il n’eût point fait, la Grèce avec douleur
Vous voit du Sang Troyen releuer le malheur,	Vous voit du Sang Troyen relever le malheur,
Et vous laiſſant toucher d’vne pitié funeſte,	Et vous laissant toucher d’une pitié funeste,
D’vne Guerre ſi longue entretenir le reſte.	D’une Guerre si longue entretenir le reste.
Ne vous ſouuient-il plus, Seigneur, quel fut Hector?	Ne vous souvient-il plus, Seigneur, quel fut Hector?
Nos peuples affoiblis s’en ſouuiennent encor.	Nos Peuples affaiblis s’en souviennent encor.
Son nom ſeul fait frémir nos Veuues, & nos Filles,	Son nom seul fait frémir nos Veuves, et nos Filles,
Et dans toute la Gréce, il n’eſt point de Familles,	Et dans toute la Grèce, il n’est point de Familles,
Qui ne demandent conte à ce malheureux Fils,	Qui ne demandent compte à ce malheureux Fils,
D’vn Pere, ou d’vn Epoux, qu’Hector leur a rauis.	D’un Père, ou d’un Époux, qu’Hector leur a ravis.
Et qui ſçait ce qu’vn jour ce Fils peut entreprendre?	Et qui sait ce qu’un jour ce Fils peut entreprendre?
Peut-eſtre dans nos Ports nous le verrons deſcẽdre,	Peut-être dans nos Ports nous le verrons descendre,
Tel qu’on a veu ſon Pere embrazer nos Vaiſſeaux,	Tel qu’on a vu son Père embraser nos Vaisseaux,
Et la flâme à la main, les ſuiure ſur les Eaux.	Et la flamme à la main, les suivre sur les Eaux.
Oſeray-je, Seigneur, dire ce que ie penſe?	Oserai-je, Seigneur, dire ce que je pense?
Vous-meſme de vos ſoins craignez la recompenſe,	Vous-même de vos soins craignez la récompense,
Et que dans voſtre ſein ce Serpent éleué	Et que dans votre sein ce Serpent élevé
Ne vous puniſſe vn jour de l’auoir conſerué.	Ne vous punisse un jour de l’avoir conservé.
Enfin, de tous les Grecs ſatisfaites l’enuie,	Enfin, de tous les Grecs satisfaites l’envie,
Aſſurez leur vangeance, aſſurez voſtre vie.	Assurez leur vengeance, assurez votre vie.
Perdez vn Ennemy d’autant plus dangereux,	Perdez un Ennemi d’autant plus dangereux,
Qu’il s’eſſayra ſur vous à combattre contre eux.	Qu’il s’essaiera sur vous à combattre contre eux.
La Gréce en ma faueur eſt trop inquiétée.	La Grèce en ma faveur est trop inquiétée.
De ſoins plus importans ie l’ay cruë agitée,	De soins plus importants je l’ai crue agitée,
Seigneur, & ſur le nom de ſon Ambaſſadeur,	Seigneur, et sur le nom de son Ambassadeur,
I’auois dans ſes projets conceu plus de grandeur.	J’avais dans ses projets conçu plus de grandeur.
Qui croiroit en effet, qu’vne telle entrepriſe	Qui croirait en effet, qu’une telle entreprise
Du Fils d’Agamemnon meritaſt l’entremiſe,	Du Fils d’Agamemnon méritât l’entremise,
Qu’vn Peuple tout entier, tant de fois triomphant,	Qu’un Peuple tout entier, tant de fois triomphant,
N’euſt daigné conſpirer que la mort d’vn Enfant?	N’eût daigné conspirer que la mort d’un Enfant?
Mais à qui pretend-on que ie le ſacrifie?	Mais à qui prétend-on que je le sacrifie?
La Gréce a-t'elle encor quelque droit ſur ſa vie?	La Grèce a-t-elle encor quelque droit sur sa vie?
Et ſeul de tous les Grecs ne m’eſt-il pas permis	Et seul de tous les Grecs ne m’est-il pas permis
D’ordonner des Captifs que le Sort m’a ſoûmis?	D’ordonner des Captifs que le Sort m’a soumis?
Oüy, Seigneur, lors qu’au pied des murs fumans de Troye,	Oui, Seigneur, lorsqu’au pied des murs fumants de Troie,
Les Vainqueurs tout ſanglans partagerẽt leur Proye,	Les Vainqueurs tout sanglants partagèrent leur Proie,
Le Sort, dont les Arreſts furent alors ſuiuis,	Le Sort, dont les Arrêts furent alors suivis,
Fit tomber en mes mains Andromaque & ſon Fils.	Fit tomber en mes mains Andromaque et son Fils.
Hécube, pres d’Vlyſſe, acheua ſa miſere;	Hécube, près d’Ulysse, acheva sa misère;
Caſſandre, dans Argos, a ſuiuy voſtre Pere.	Cassandre, dans Argos, a suivi votre Père.
Sur eux, ſur leurs Captifs, ay-je étendu mes droicts?	Sur eux, sur leurs Captifs, ai-je étendu mes droits?
Ay-je enfin diſpoſé du fruit de leurs Exploits?	Ai-je enfin disposé du fruit de leurs Exploits?
On craint, qu’auec Hector Troye vn jour ne renaiſſe:	On craint, qu’avec Hector Troie un jour ne renaisse:
Son Fils peut me rauir le jour que ie luy laiſſe:	Son Fils peut me ravir le jour que je lui laisse:
Seigneur, tant de prudence entraiſne trop de ſoin.	Seigneur, tant de prudence entraîne trop de soin.
Ie ne ſçay point préuoir les malheurs de ſi loin.	Je ne sais point prévoir les malheurs de si loin.
Ie ſonge quelle eſtoit autrefois cette Ville,	Je songe quelle était autrefois cette Ville,
Si ſuperbe en Rampars, en Héros ſi fertile,	Si superbe en Remparts, en Héros si fertile,
Maiſtreſſe de l’Aſie, & je regarde enfin	Maîtresse de l’Asie, et je regarde enfin
Quel fut le Sort de Troye, & quel eſt ſon Deſtin.	Quel fut le sort de Troie, et quel est son Destin.
Ie ne voy que des Tours, que la cendre a couuertes,	Je ne vois que des Tours, que la cendre a couvertes,
Vn fleuue teint de ſang, des Campagnes deſertes,	Un Fleuve teint de sang, des Campagnes désertes,
Vn Enfant dans les fers, & je ne puis ſonger	Un Enfant dans les fers, et je ne puis songer
Que Troye en cet eſtat aſpire à ſe vanger.	Que Troie en cet état aspire à se venger.
Ah! ſi du Fils d’Hector la perte eſtoit jurée,	Ah! Si du Fils d’Hector la perte était jurée,
Pourquoy d’vn an entier l’auons-nous differée?	Pourquoi d’un an entier l’avons-nous différée?
Dans le ſein de Priam n’a-t'on pû l’immoler?	Dans le sein de Priam n’a-t-on pu l’immoler?
Sous tant de Morts, ſous Troye, il falloit l’accabler.	Sous tant de Morts, sous Troie, il fallait l’accabler.
Tout eſtoit juſte alors. La Vieilleſſe & l’Enfance	Tout était juste alors. La Vieillesse et l’Enfance
En vain ſur leur foibleſſe appuyoient leur defance.	En vain sur leur faiblesse appuyaient leur défense.
La Victoire, & la Nuit, plus cruelles que nous,	La Victoire, et la Nuit, plus cruelles que nous,
Nous excitoient au meurtre, & confondoient nos coups.	Nous excitaient au meurtre, et confondaient nos coups.
Mon courroux aux Vaincus ne fut que trop ſeuere.	Mon courroux aux Vaincus ne fut que trop sévère.
Mais que ma Cruauté ſuruiue à ma Colere?	Mais que ma Cruauté survive à ma Colère?
Que malgré la pitié dont ie me ſens ſaiſir,	Que malgré la pitié dont je me sens saisir,
Dans le ſang d’vn Enfant ie me baigne à loiſir?	Dans le sang d’un Enfant je me baigne à loisir?
Non, Seigneur. Que les Grecs cherchent quelque autre Proye,	Non, Seigneur. Que les Grecs cherchent quelque autre Proie,
Qu’ils pourſuiuent ailleurs ce qui reſte de Troye,	Qu’ils poursuivent ailleurs ce qui reste de Troie,
De mes inimitiez le cours eſt acheué,	De mes inimitiés le cours est achevé,
L’Epire ſauuera ce que Troye a ſauué.	L’Épire sauvera ce que Troie a sauvé.
Seigneur, vous ſçauez trop, auec quel artifice	Seigneur, vous savez trop, avec quel artifice
Vn faux Aſtianax fut offert au Suplice	Un faux Astyanax fut offert au Supplice
Où le ſeul Fils d’Hector deuoit eſtre conduit.	Où le seul Fils d’Hector devait être conduit.
Ce n’eſt pas les Troyens, c’eſt Hector qu’on pourſuit.	Ce n’est pas les Troyens, c’est Hector qu’on poursuit.
Oüy, les Grecs ſur le Fils perſecutent le Pere.	Oui, les Grecs sur le Fils persécutent le Père.
Il a par trop de ſang acheté leur colere.	Il a par trop de sang acheté leur colère.
Ce n’eſt que dans le ſien qu’elle peut expirer,	Ce n’est que dans le sien qu’elle peut expirer,
Et juſques dans l’Epire il les peut attirer.	Et jusque dans l’Épire il les peut attirer.
Préuenez les.	Prévenez-les.
Non, non. I’y conſens auec joye.	Non, non. J’y consens avec joie.
Qu’ils cherchent dans l’Epire vne ſeconde Troye.	Qu’ils cherchent dans l’Épire une seconde Troie.
Qu’ils confondent leur haine, & ne diſtinguent plus	Qu’ils confondent leur haine, et ne distinguent plus
Le ſang qui les fit vaincre, & celuy des Vaincus.	Le sang qui les fit vaincre, et celui des Vaincus.
Auſſi-bien ce n’eſt pas la premiere injuſtice,	Aussi bien ce n’est pas la première injustice,
Dont la Gréce, d’Achille a payé le ſeruice.	Dont la Grèce, d’Achille a payé le service.
Hector en profita, Seigneur, & quelque jour	Hector en profita, Seigneur, et quelque jour
Son Fils en pourroit bien profiter à ſon tour.	Son Fils en pourrait bien profiter à son tour.
Ainſi la Gréce en vous trouue vn Enfant rebelle?	Ainsi la Grèce en vous trouve un Enfant rebelle?
Et ie n’ay donc vaincu que pour dépendre d’elle?	Et je n’ai donc vaincu que pour dépendre d’elle?
Hermionne, Seigneur, arreſtera vos coups;	Hermione, Seigneur, arrêtera vos coups;
Ses yeux s’oppoſeront entre ſon Pere & vous.	Ses yeux s’opposeront entre son Père et vous.
Hermionne, Seigneur, peut m’eſtre toûjours chere,	Hermione, Seigneur, peut m’être toujours chère,
Ie puis l’aimer, ſans eſtre Eſclaue de ſon Pere.	Je puis l’aimer, sans être Esclave de son Père.
Et ie ſçauray peut-eſtre accorder en ce jour	Et je saurai peut-être accorder en ce jour
Les ſoins de ma grandeur, & ceux de mon amour.	Les soins de ma grandeur, et ceux de mon amour.
Vous pouuez cependant voir la Fille d’Helene.	Vous pouvez cependant voir la Fille d’Hélène.
Du ſang qui vous vnit ie ſçay l’étroite chaîne.	Du sang qui vous unit je sais l’étroite chaîne.
Apres cela, Seigneur, ie ne vous retiens plus,	Après cela, Seigneur, je ne vous retiens plus,
Et vous pourrez aux Grecs annoncer mon refus.	Et vous pourrez aux Grecs annoncer mon refus.
AInſi vous l’enuoyez aux pieds de ſa Maiſtreſſe?	Ainsi vous l’envoyez aux pieds de sa Maîtresse?
On dit qu’il a long-temps brûlé pour la Princeſſe.	On dit qu’il a longtemps brûlé pour la Princesse.
Mais ſi ce feu, Seigneur, vient à ſe rallumer,	Mais si ce feu, Seigneur, vient à se rallumer,
S’il luy rendoit ſon Cœur, s’il s’en faiſoit aimer?	S’il lui rendait son Cœur, s’il s’en faisait aimer?
Ah! qu’ils s’aiment, Phœnix, i’y conſens. Qu’elle parte.	Ah! qu’ils s’aiment, Phœnix, j’y consens. Qu’elle parte.
Que charmez l’vn de l’autre, ils retournẽt à Sparte.	Que charmés l’un de l’autre, ils retournent à Sparte.
Tous nos Ports ſont ouuerts & pour elle & pour luy.	Tous nos Ports sont ouverts et pour elle et pour lui.
Qu’elle m’épargneroit de contrainte & d’ennuy!	Qu’elle m’épargnerait de contrainte et d’ennui!
Seigneur…	Seigneur...
Vne autre fois ie t’ouuriray mon Ame,	Une autre fois je t’ouvrirai mon Âme,
Andromaque paroiſt.	Andromaque paraît.
ME cherchiez-vous, Madame?	Me cherchiez-vous, Madame?
Vn eſpoir ſi charmant me ſeroit-il permis?	Un espoir si charmant me serait-il permis?
Ie paſſois juſqu’aux lieux où l’on garde mon Fils.	Je passais jusqu’aux lieux, où l’on garde mon Fils.
Puis qu’vne fois le jour vous ſouffrez que ie voye	Puisqu’une fois le jour vous souffrez que je voie
Le ſeul bien qui me reſte, & d’Hector & de Troye,	Le seul bien qui me reste, et d’Hector et de Troie,
I’allois, Seigneur, pleurer vn moment auec luy,	J’allais, Seigneur, pleurer un moment avec lui,
Ie ne l’ay point encore embraſſé d’aujourd’huy.	Je ne l’ai point encore embrassé d’aujourd’hui.
Ah, Madame! les Grecs, ſi i’en croy leurs allarmes,	Ah, Madame! Les Grecs, si j’en crois leurs alarmes,
Vous donneront bientoſt d’autres ſujets de larmes.	Vous donneront bientôt d’autres sujets de larmes.
Et quelle eſt cette peur dont leur Cœur eſt frappé,	Et quelle est cette peur dont leur Cœur est frappé,
Seigneur? Quelque Troyen vous eſt-il échappé?	Seigneur? Quelque Troyen vous est-il échappé?
Leur haine pour Hector n’eſt pas encore éteinte.	Leur haine pour Hector n’est pas encore éteinte.
Ils redoutent ſon Fils.	Ils redoutent son Fils.
Digne Objet de leur crainte!	Digne Objet de leur crainte!
Vn Enfant malheureux, qui ne ſçait pas encor	Un Enfant malheureux, qui ne sait pas encor
Que Pyrrhus eſt ſon Maiſtre, & qu’il eſt Fils d’Hector.	Que Pyrrhus est son Maître, et qu’il est fils d’Hector.
Tel qu’il eſt, tous les Grecs demandent qu’il periſſe.	Tel qu’il est, tous les Grecs demandent qu’il périsse.
Le Fils d’Agamemnon vient haſter ſon ſuplice.	Le Fils d’Agamemnon vient hâter son supplice.
Et vous prononcerez vn Arreſt ſi cruel?	Et vous prononcerez un Arrêt si cruel?
Eſt-ce mon intereſt qui le rend criminel?	Est-ce mon intérêt qui le rend criminel?
Helas! on ne craint point qu’il vange vn jour ſon Pere.	Hélas! on ne craint point qu’il venge un jour son Père.
On craint qu’il n’eſſuyaſt les larmes de ſa Mere.	On craint qu’il n’essuyât les larmes de sa Mère.
Il m’auroit tenu lieu d’vn Pere, & d’vn Epoux,	Il m’aurait tenu lieu d’un Père, et d’un Époux.
Mais il me faut tout perdre, & toûjours par vos coups.	Mais il me faut tout perdre, et toujours par vos coups.
Madame, mes refus ont préuenu vos larmes.	Madame, mes refus ont prévenu vos larmes.
Tous les Grecs m’ont déja menaſſé de leurs Armes.	Tous les Grecs m’ont déjà menacé de leurs armes.
Mais dûſſent-ils encore, en repaſſant les Eaux,	Mais dussent-ils encore, en repassant les eaux,
Demander voſtre Fils, auec mille Vaiſſeaux:	Demander votre fils, avec mille vaisseaux:
Couſtaſt il tout le ſang qu’Helene a fait répandre,	Coûtât-il tout le sang qu’Hélène a fait répandre,
Dûſſay-je apres dix ans voir mon Palais en cendre,	Dussé-je après dix ans voir mon Palais en cendre,
Ie ne balance point, ie vole à ſon ſecours,	Je ne balance point, je vole à son secours,
Ie defendray ſa vie aux deſpens de mes jours.	Je défendrai sa vie aux dépens de mes jours.
Mais parmy ces perils, où ie cours pour vous plaire,	Mais parmi ces périls, où je cours pour vous plaire,
Me refuſerez-vous vn regard moins ſeuere?	Me refuserez-vous un regard moins sévère?
Haï de tous les Grecs, preſſé de tous coſtez,	Haï de tous les Grecs, pressé de tous côtés,
Me faudra-t'il combattre encor vos cruautez?	Me faudra-t-il combattre encor vos cruautés?
Ie vous offre mon Bras. Puis-je eſperer encore	Je vous offre mon Bras. Puis-je espérer encore
Que vous accepterez vn Cœur qui vous adore?	Que vous accepterez un Cœur qui vous adore?
En combattant pour vous, me ſera-t’il permis	En combattant pour vous, me sera-t-il permis
De ne vous point conter parmy mes Ennemis?	De ne vous point compter parmi mes Ennemis?
Seigneur, que faites-vous, & que dira la Gréce?	Seigneur, que faites-vous, et que dira la Grèce?
Faut-il qu’vn ſi grand Cœur montre tant de foibleſſe?	Faut-il qu’un si grand Cœur montre tant de faiblesse?
Voulez-vous qu’vn deſſein ſi beau, ſi genereux,	Voulez-vous qu’un dessein si beau, si généreux,
Paſſe pour le tranſport d’vn Eſprit amoureux?	Passe pour le transport d’un Esprit amoureux?
Captiue, toûjours triſte, importune à moy-méme,	Captive, toujours triste, importune à moi-même,
Pouuez-vous ſouhaiter qu’Andromaque vous aime?	Pouvez-vous souhaiter qu’Andromaque vous aime?
Que feriez-vous, helas! d’vn Cœur infortuné	Que feriez-vous, hélas! d’un Cœur infortuné
Qu’à des pleurs éternels vous avez condamné?	Qu’à des pleurs éternels vous avez condamné?
Non, non, d’vn Ennemy reſpecter la Miſere,	Non, non, d’un Ennemi respecter la Misère,
Sauuer des Malheureux, rendre vn Fils à ſa Mere,	Sauver des Malheureux, rendre un Fils à sa Mère,
De cent Peuples pour luy combattre la rigueur,	De cent Peuples pour lui combattre la rigueur,
Sans me faire payer ſon ſalut de mon Cœur,	Sans me faire payer son salut de mon Cœur,
Malgré moy, s’il le faut, luy donner vn azile,	Malgré moi, s’il le faut, lui donner un asile,
Seigneur, voila des ſoins dignes du Fils d’Achille.	Seigneur, voilà des soins dignes du Fils d’Achille.
Hé quoy? Voſtre courroux n’a-t’il pas eû ſon cours?	Hé quoi? Votre courroux n’a-t-il pas eu son cours?
Peut-on haïr ſans ceſſe? Et punit-on toûjours?	Peut-on haïr sans cesse? Et punit-on toujours?
I’ay fait des Malheureux, ſans doute, & la Phrygie	J’ai fait des Malheureux, sans doute, et la Phrygie
Cent fois de voſtre ſang a veu ma main rougie.	Cent fois de votre sang a vu ma main rougie.
Mais que vos yeux ſur moy ſe ſont bien exercez!	Mais que vos yeux sur moi se sont bien exercés!
Qu’ils m’ont vendu bien cher les pleurs qu’ils ont verſez!	Qu’ils m’ont vendu bien cher les pleurs qu’ils ont versés!
De combien de remords m’ont-ils rendu la Proye?	De combien de remords m’ont-ils rendu la Proie?
Ie souffre tous les maux que i’ay faits deuãt Troye.	Je souffre tous les maux que j’ai faits devant Troie.
Vaincu, chargé de fers, de regrets conſumé,	Vaincu, chargé de fers, de regrets consumé,
Brûlé de plus de feux que ie n’en allumé,	Brûlé de plus de feux que je n’en allumai,
Tant de ſoins, tant de pleurs, tant d’ardeurs inquiétes…	Tant de soins, tant de pleurs, tant d’ardeurs inquiètes...
Helas! fus-je iamais ſi cruel que vous l’eſtes?	Hélas! fus-je jamais si cruel que vous l’êtes?
Mais enfin, tour à tour, c’eſt aſſez nous punir.	Mais enfin, tour à tour, c’est assez nous punir.
Nos Ennemis communs déuroient nous reünir.	Nos Ennemis communs devraient nous réunir.
Madame, dites-moy ſeulement que i’eſpere,	Madame, dites-moi seulement que j’espère,
Ie vous rens voſtre Fils, & ie luy ſers de Pere.	Je vous rends votre Fils, et je lui sers de Père.
Ie l’inſtruiray moy-meſme à vanger les Troyens.	Je l’instruirai moi-même à venger les Troyens.
I’iray punir les Grecs de vos maux & des miens.	J’irai punir les Grecs de vos maux et des miens.
Animé d’vn regard, ie puis tout entreprendre.	Animé d’un regard, je puis tout entreprendre.
Voſtre Ilion encor peut ſortir de ſa cendre.	Votre Ilion encor peut sortir de sa cendre.
Ie puis, en moins de tẽps que les Grecs ne l’ont pris,	Je puis, en moins de temps que les Grecs ne l’ont pris,
Dans ſes Murs releuez couronner voſtre Fils.	Dans ses Murs relevés couronner votre Fils.
Seigneur, tant de grandeurs ne nous touchent plus guére,	Seigneur, tant de grandeurs ne nous touchent plus guère,
Ie les luy promettois tant qu’a veſcu ſon Pere.	Je les lui promettais tant qu’a vécu son Père.
Non, vous n’eſperez plus de nous reuoir encor,	Non, vous n’espérez plus de nous revoir encor,
Sacrez Murs, que n’a pû conſeruer mon Hector.	Sacrés Murs, que n’a pu conserver mon Hector.
A de moindres faueurs des Malheureux prétendent,	À de moindres faveurs des Malheureux prétendent,
Seigneur. C’eſt vn Exil que mes pleurs vous demandent.	Seigneur. C’est un Exil que mes pleurs vous demandent.
Souffrez que loin des Grecs, & meſme loin de vous,	Souffrez que loin des Grecs, et même loin de vous,
I’aille cacher mon Fils, & pleurer mon Epoux.	J’aille cacher mon Fils, et pleurer mon Époux.
Voſtre amour contre nous allume trop de haine.	Votre amour contre nous allume trop de haine.
Retournez, retournez à la Fille d’Helene.	Retournez, retournez à la Fille d’Hélène.
Et le puis-je, Madame? Ah, que vous me geſnez!	Et le puis-je, Madame? Ah, que vous me gênez!
Comment luy rẽdre vn Cœur que vous me retenez?	Comment lui rendre un Cœur que vous me retenez?
Ie ſçay que de mes veux on luy promit l’empire.	Je sais que de mes vœux on lui promit l’empire.
Ie ſçay que pour regner elle vint dans l’Epire.	Je sais que pour régner elle vint dans l’Épire.
Le Sort vous y voulut l’vne & l’autre amener,	Le Sort vous y voulut l’une et l’autre amener,
Vous pour porter des fers, Elle pour en donner.	Vous pour porter des fers, Elle pour en donner.
Cependant ay-je pris quelque ſoin de luy plaire?	Cependant ai-je pris quelque soin de lui plaire?
Et ne diroit-on pas, en voyant au contraire,	Et ne dirait-on pas, en voyant au contraire,
Vos charmes tout-puiſſans, & les ſiens dédaignez,	Vos charmes tout-puissants, et les siens dédaignés,
Qu’elle eſt icy Captiue, & que vous y regnez?	Qu’elle est ici Captive, et que vous y régnez?
Ah! qu’vn ſeul des ſoûpirs, que mon Cœur vous enuoye,	Ah! qu’un seul des soupirs, que mon Cœur vous envoie,
S’il s’échapoit vers elle, y porteroit de joye!	S’il s’échappait vers elle, y porterait de joie!
Et pourquoy vos ſoûpirs ſeroient-ils repouſſez?	Et pourquoi vos soupirs seraient-ils repoussés?
Auroit-elle oublié vos ſeruices paſſez?	Aurait-elle oublié vos services passés?
Troye, Hector, contre vous reuoltent-ils ſon Ame?	Troie, Hector, contre vous révoltent-ils son Âme?
Aux cendres d’vn Epoux doit-elle enfin ſa flâme?	Aux cendres d’un Époux doit-elle enfin sa flamme?
Et quel Epoux encore! Ah ſouuenir cruel!	Et quel Époux encore! Ah souvenir cruel!
Sa mort ſeule a rendu voſtre Pere immortel.	Sa mort seule a rendu votre Père immortel.
Il doit au ſang d’Hector tout l’éclat de ſes armes,	Il doit au sang d’Hector tout l’éclat de ses armes,
Et vous n’eſtes tous deux connus que par mes larmes.	Et vous n’êtes tous deux connus que par mes larmes.
Hé bien, Madame, hé bien, il faut vous obeïr.	Hé bien, Madame, hé bien, il faut vous obéir.
Il faut vous oublier, ou plûtoſt vous haïr.	Il faut vous oublier, ou plutôt vous haïr.
Oüy, mes vœux ont trop loin pouſſé leur violence,	Oui, mes vœux ont trop loin poussé leur violence,
Pour ne plus s’arreſter que dans l’indifference.	Pour ne plus s’arrêter que dans l’indifférence.
Songez-y bien. Il faut deſormais que mon Cœur,	Songez-y bien. Il faut désormais que mon Cœur,
S’il n’aime auec tranſport, haïſſe auec fureur.	S’il n’aime avec transport, haïsse avec fureur.
Ie n’épargneray rien dans ma juſte colere.	Je n’épargnerai rien dans ma juste colère.
Le Fils me répondra des mépris de la Mere,	Le Fils me répondra des mépris de la Mère,
La Gréce le demande, & je ne prétens pas	La Grèce le demande, et je ne prétends pas
Mettre toûjours ma gloire à ſauuer des Ingrats.	Mettre toujours ma gloire à sauver des Ingrats.
Helas! il mourra donc. Il n’a pour ſa défenſe,	Hélas! il mourra donc. Il n’a pour sa défense,
Que les pleurs de ſa Mere, & que ſon Innocence.	Que les pleurs de sa Mère, et que son Innocence.
Et peut-eſtre apres tout, en l’eſtat où ie ſuis,	Et peut-être après tout, en l’état où je suis,
Sa mort auancera la fin de mes ennuis.	Sa mort avancera la fin de mes ennuis.
Ie prolongeois pour luy ma vie, & ma miſere.	Je prolongeais pour lui ma vie, et ma misère.
Mais enfin ſur ſes pas j’iray reuoir ſon Pere.	Mais enfin sur ses pas j’irai revoir son Père.
Ainſi tous trois, Seigneur, par vos ſoins reünis,	Ainsi tous trois, Seigneur, par vos soins réunis,
Nos Cœurs…	Nos Cœurs...
Allez, Madame, allez voir voſtre Fils.	Allez, Madame, allez voir votre Fils.
Peut-eſtre, en le voyant, voſtre amour plus timide,	Peut-être, en le voyant, votre amour plus timide,
Ne prendra pas toûjours ſa Colere pour guide.	Ne prendra pas toujours sa Colère pour guide.
Pour ſçauoir nos Destins, j’iray vous retrouuer.	Pour savoir nos Destins, j’irai vous retrouver.
Madame, en l’embraſſant, ſongez à le ſauuer.	Madame, en l’embrassant, songez à le sauver.
E fay ce que tu veux. Ie conſens qu’il me voye.	Je fais ce que tu veux. Je consens qu’il me voie.
Ie luy veux bien encore accorder cette joye;	Je lui veux bien encore accorder cette joie;
Pylade va bien-toſt conduire icy ſes pas.	Pylade va bientôt conduire ici ses pas.
Mais, ſi ie m’en croyois, ie ne le verrois pas.	Mais, si je m’en croyais, je ne le verrais pas.
Et qu’eſt-ce que ſa veuë a pour vous de funeſte?	Et qu’est-ce que sa vue a pour vous de funeste?
Madame, n’eſt-ce pas toûjours le meſme Oreſte,	Madame, n’est-ce pas toujours le même Oreste,
Dont vous auez cent fois ſouhaité le retour,	Dont vous avez cent fois souhaité le retour,
Et dont vous regrettiez la conſtance & l’amour?	Et dont vous regrettiez la constance et l’amour?
C’eſt cet amour payé de trop d’ingratitude,	C’est cet amour payé de trop d’ingratitude,
Qui me rend en ces Lieux ſa preſence ſi rude.	Qui me rend en ces Lieux sa présence si rude.
Quelle honte pour moy! Quel triomphe pour luy,	Quelle honte pour moi! Quel triomphe pour lui,
De voir mon infortune égaler ſon ennuy!	De voir mon infortune égaler son ennui!
Eſt-ce là, dira-t’il, cette fiere Hermionne?	Est-ce là, dira-t-il, cette fière Hermione?
Elle me dédaignoit, vn autre l’abandonne.	Elle me dédaignait, un autre l’abandonne.
L’Ingrate, qui mettoit ſon Cœur à ſi haut prix,	L’Ingrate, qui mettait son Cœur à si haut prix,
Apprend donc à ſon tour à ſouffrir des mépris?	Apprend donc à son tour à souffrir des mépris?
Ah Dieux!	Ah Dieux!
Ah! diſſipez ces indignes allarmes.	Ah! dissipez ces indignes alarmes.
Il a trop bien ſenty le pouuoir de vos charmes.	Il a trop bien senti le pouvoir de vos charmes.
Vous croyez qu’vn Amant vienne vous inſulter?	Vous croyez qu’un Amant vienne vous insulter?
Il vous rapporte vn Cœur qu’il n’a pû vous oſter.	Il vous rapporte un Cœur qu’il n’a pu vous ôter.
Mais vous ne dites point ce que vous mande vn Pere.	Mais vous ne dites point ce que vous mande un Père.
Dans ſes retardemens ſi Pyrrhus perſeuere,	Dans ses retardements si Pyrrhus persévère,
A la mort du Troyen s’il ne veut conſentir,	À la mort du Troyen s’il ne veut consentir,
Mon Pere auec les Grecs m’ordonne de partir.	Mon Père avec les Grecs m’ordonne de partir.
Hé bien, Madame, hé bien, écoutez donc Oreſte.	Hé bien, Madame, hé bien, écoutez donc Oreste.
Pyrrhus a commencé, faites au moins le reſte.	Pyrrhus a commencé, faites au moins le reste.
Pour bien faire, il faudroit que vous le préuinſſiez.	Pour bien faire, il faudrait que vous le prévinssiez.
Ne m’auez-vous pas dit que vous le haïſſiez?	Ne m’avez-vous pas dit que vous le haïssiez?
Si je le hais, Cleonne? Il y va de ma gloire,	Si je le hais Cléone? Il y va de ma gloire,
Apres tant de bontez dont il perd la memoire.	Après tant de bontés dont il perd la mémoire.
Luy qui me fut ſi cher, & qui m’a pû trahir?	Lui qui me fut si cher, et qui m’a pu trahir?
Ah! ie l’ay trop aimé, pour ne le point haïr.	Ah! je l’ai trop aimé, pour ne le point haïr.
Fuyez-le donc, Madame. Et puis qu’on vous adore…	Fuyez-le donc, Madame. Et puisqu’on vous adore...
Ah! laiſſe à ma fureur le temps de croiſtre encore.	Ah! laisse à ma fureur le temps de croître encore.
Contre mon Ennemy laiſſe-moy m’aſſurer,	Contre mon Ennemi laisse-moi m’assurer,
Cleonne, auec horreur ie m’en veux ſeparer.	Cléone, avec horreur je m’en veux séparer.
Il n’y trauaillera que trop bien, l’Infidelle.	Il n’y travaillera que trop bien, l’Infidèle.
Quoy! vous en attendez quelque injure nouuelle?	Quoi! vous en attendez quelque injure nouvelle?
Aimer vne Captiue, & l’aimer à vos yeux,	Aimer une Captive, et l’aimer à vos yeux,
Tout cela n’a donc pû vous le rendre odieux?	Tout cela n’a donc pu vous le rendre odieux?
Apres ce qu’il a fait, que ſçauroit-il donc faire?	Après ce qu’il a fait, que saurait-il donc faire?
Il vous auroit déplû, s’il pouuoit vous déplaire.	Il vous aurait déplu, s’il pouvait vous déplaire.
Pourquoy veux-tu, Cruelle, irriter mes ennuis?	Pourquoi veux-tu, Cruelle, irriter mes ennuis?
Je crains de me connoiſtre, en l’eſtat où ie ſuis.	Je crains de me connaître, en l’état où je suis.
De tout ce que tu vois tâche de ne rien croire.	De tout ce que tu vois tâche de ne rien croire.
Croy que ie n’aime plus. Vante moy ma victoire.	Crois que je n’aime plus. Vante-moi ma victoire.
Croy que dans ſon dépit mon Cœur eſt endurcy.	Crois que dans son dépit mon Cœur est endurci.
Helas! & s’il ſe peut, fay-le moy croire auſſy.	Hélas! et s’il se peut, fais-le moi croire aussi.
Tu veux que ie le fuye. Hé bien, rien ne m’arreſte.	Tu veux que je le fuie. Hé bien, rien ne m’arrête.
Allons. N’enuions plus ſon indigne conqueſte.	Allons. N’envions plus son indigne conquête.
Que ſur luy ſa Captiue étende ſon pouuoir.	Que sur lui sa Captive étende son pouvoir.
Fuyons. Mais ſi l’Ingrat rentroit dans ſon deuoir!	Fuyons. Mais si l’Ingrat rentrait dans son devoir!
Si la Foy dans ſon Cœur retrouuoit quelque place!	Si la Foi dans son Cœur retrouvait quelque place!
S’il venoit à mes pieds me demander ſa Grace!	S’il venait à mes pieds me demander sa Grâce!
Si ſous mes Loix, Amour, tu pouuois l’engager!	Si sous mes Lois, Amour, tu pouvais l’engager!
S’il vouloit!… Mais l’Ingrat ne veut que m’outrager.	S’il voulait!... Mais l’Ingrat ne veut que m’outrager.
Demeurons toutefois, pour troubler leur fortune.	Demeurons toutefois, pour troubler leur fortune.
Prenons quelque plaiſir à leur eſtre importune.	Prenons quelque plaisir à leur être importune.
Ou le forçant de rompre vn nœud ſi ſolemnel,	Ou le forçant de rompre un nœud si solennel,
Aux yeux de tous les Grecs rendons-le criminel.	Aux yeux de tous les Grecs rendons-le criminel.
I’ai déja ſur le Fils attiré leur colere.	J’ai déjà sur le Fils attiré leur colère.
Ie veux qu’on viẽne encor luy demander la Mere.	Je veux qu’on vienne encor lui demander la Mère.
Rendons-luy les tourmens qu’elle me fait ſouffrir.	Rendons-lui les tourments qu’elle me fait souffrir.
Qu’elle le perde, ou bien qu’il la faſſe périr.	Qu’elle le perde, ou bien qu’il la fasse périr.
Penſez-vous que des yeux toûjours ouuerts aux larmes,	Pensez-vous que des yeux toujours ouverts aux larmes,
Songent à balancer le pouuoir de vos charmes?	Songent à balancer le pouvoir de vos charmes?
Et qu’vn Cœur accablé de tant de déplaiſirs,	Et qu’un Cœur accablé de tant de déplaisirs,
De ſon Perſecuteur ait brigué les ſoûpirs?	De son Persécuteur ait brigué les soupirs?
Voyez ſi ſa douleur en paroiſt ſoulagée.	Voyez si sa douleur en paraît soulagée.
Pourquoy dõc les chagrins où ſon Ame eſt plõgée ?	Pourquoi donc les chagrins où son Âme est plongée?
Pourquoy tant de froideurs? Pourquoy cette fierté?	Pourquoi tant de froideurs? Pourquoi cette fierté?
Helas! pour mon malheur ie l’ay trop écouté.	Hélas! pour mon malheur je l’ai trop écouté.
Ie n’ay point du ſilence affecté le myſtere.	Je n’ai point du silence affecté le mystère.
Ie croyois ſans péril pouuoir eſtre ſincere.	Je croyais sans péril pouvoir être sincère.
Et ſans armer mes yeux d’vn moment de rigueur,	Et sans armer mes yeux d’un moment de rigueur,
Ie n’ay pour luy parler, conſulté que mon Cœur.	Je n’ai pour lui parler, consulté que mon Cœur.
Et qui ne ſe ſeroit comme moy declarée,	Et qui ne se serait comme moi déclarée,
Sur la foy d’vne amour ſi ſaintement jurée?	Sur la foi d’une amour si saintement jurée?
Me voyoit-il de l’œil qu’il me voit aujourd’huy?	Me voyait-il de l’œil qu’il me voit aujourd’hui?
Tu t’en ſouuiens encor, tout conſpiroit pour luy.	Tu t’en souviens encor, tout conspirait pour lui.
Ma Famille vangée, & les Grecs dans la joye,	Ma Famille vengée, et les Grecs dans la joie,
Nos Vaiſſeaux tout chargez des dépoüilles de Troye,	Nos Vaisseaux tout chargés des dépouilles de Troie,
Les Exploits de ſon Pere, effacez par les ſiens,	Les Exploits de son Père, effacés par les siens,
Ses feux que ie croyois plus ardans que les miens,	Ses feux que je croyais plus ardents que les miens,
Mon Cœur, toy-meſme enfin de ſa gloire ébloüye,	Mon Cœur, toi-même enfin de sa gloire éblouie,
Auant qu’il me trahiſt, vous m’auez tous trahie.	Avant qu’il me trahît, vous m’avez tous trahie.
Mais c’en eſt trop, Cleonne, & quel que ſoit Pyrrhus,	Mais c’en est trop, Cléone, et quel que soit Pyrrhus,
Hermione eſt ſenſible, Oreſte a des vertus.	Hermione est sensible, Oreste a des vertus.
Il ſçait aimer du moins, & meſme ſans qu’on l’aime;	Il sait aimer du moins, et même sans qu’on l’aime;
Et peut-eſtre il ſçaura ſe faire aimer luy-méme.	Et peut-être il saura se faire aimer lui-même.
Allons. Qu’il vienne enfin.	Allons. Qu’il vienne enfin.
Madame, le voicy.	Madame, le voici.
Ah! ie ne croyois pas qu’il fuſt ſi prés d’icy.	Ah! je ne croyais pas qu’il fût si près d’ici.
LE croiray-je, Seigneur, qu’vn reſte de tendreſſe	Le croirai-je, Seigneur, qu’un reste de tendresse
Ait ſuſpendu les ſoins dont vous charge la Gréce?	Ait suspendu les soins dont vous charge la Grèce?
Ou ne dois-je imputer qu’à voſtre ſeul deuoir,	Ou ne dois-je imputer qu’à votre seul devoir,
L’heureux empreſſemẽt qui vous porte à me voir?	L’heureux empressement qui vous porte à me voir?
Tel eſt de mon amour l’aueuglement funeſte.	Tel est de mon amour l’aveuglement funeste.
Vous le ſçauez, Madame, & le destin d’Oreſte	Vous le savez, Madame, et le destin d’Oreste
Eſt de venir ſans ceſſe adorer vos attraits,	Est de venir sans cesse adorer vos attraits,
Et de jurer toûjours qu’il n’y viendra iamais.	Et de jurer toujours qu’il n’y viendra jamais.
Ie ſçay que vos regards vont rouurir mes bleſſures,	Je sais que vos regards vont rouvrir mes blessures,
Que tous mes pas vers vous ſont autãt de parjures.	Que tous mes pas vers vous sont autant de parjures.
Ie le ſçay, i’en rougis. Mais i’atteſte les Dieux,	Je le sais, j’en rougis. Mais j’atteste les Dieux,
Témoins de la fureur de mes derniers adieux,	Témoins de la fureur de mes derniers adieux,
Que i’ay couru par tout, où ma perte certaine	Que j’ai couru partout, où ma perte certaine
Dégageoit mes ſermens, & finiſſoit ma peine.	Dégageait mes serments, et finissait ma peine.
I’ay mandié la Mort, chez des Peuples cruels	J’ai mendié la Mort, chez des Peuples cruels
Qui n’apaiſoient leurs Dieux que du ſang des Mortels:	Qui n’apaisaient leurs Dieux que du sang des Mortels:
Ils m’ont fermé leur Temple, & ces Peuples barbares	Ils m’ont fermé leur Temple, et ces Peuples barbares
De mon ſang prodigué sont deuenus auares.	De mon sang prodigué sont devenus avares.
Enfin ie viens à vous, & ie me voy reduit	Enfin je viens à vous, et je me vois réduit
A chercher dans vos yeux vne mort, qui me fuit.	À chercher dans vos yeux une mort, qui me fuit.
Mon deſeſpoir n’attend que leur indifference,	Mon désespoir n’attend que leur indifférence,
Ils n’ont qu’à m’interdire vn reste d’eſperance.	Ils n’ont qu’à m’interdire un reste d’espérance.
Ils n’ont, pour auancer cette mort où ie cours,	Ils n’ont, pour avancer cette mort où je cours,
Qu’à me dire vne fois ce qu’ils m’ont dit toûjours.	Qu’à me dire une fois ce qu’ils m’ont dit toujours.
Voila depuis vn an le ſeul ſoin qui m’anime.	Voilà depuis un an le seul soin qui m’anime.
Madame, c’eſt à vous de prendre vne Victime,	Madame, c’est à vous de prendre une Victime,
Que les Scythes auroient dérobée à vos coups,	Que les Scythes auraient dérobée à vos coups,
Si i’en auois trouué d’auſſi cruels que Vous.	Si j’en avais trouvé d’aussi cruels que Vous.
Non, non, ne penſez pas qu’Hermionne diſpoſe.	Non, non, ne pensez pas qu’Hermione dispose
D’vn ſang, ſur qui la Gréce aujourd’huy ſe repoſe	D’un sang, sur qui la Grèce aujourd’hui se repose.
Mais vous-meſme, eſt-ce ainſi que vous executez	Mais vous-même, est-ce ainsi que vous exécutez
Les vœux de tant d’Eſtats que vous repreſentez?	Les vœux de tant d’États que vous représentez?
Faut-il que d’vn tranſport leur Vangeance dépende?	Faut-il que d’un transport leur Vengeance dépende?
Eſt-ce le sang d’Oreſte enfin qu’on vous demande?	Est-ce le sang d’Oreste enfin qu’on vous demande?
Dégagez-vous des ſoins dont vous eſtes chargé.	Dégagez-vous des soins dont vous êtes chargé.
Les refus de Pyrrhus m’ont aſſez dégagé,	Les refus de Pyrrhus m’ont assez dégagé,
Madame, il me renuoye, & et quelque autre Puiſſance	Madame, il me renvoie, et quelque autre Puissance
Luy fait du Fils d’Hector embraſſer la défence.	Lui fait du Fils d’Hector embrasser la défense.
L’infidelle!	L’infidèle!
Ainſi donc il ne me reſte rien,	Ainsi donc il ne me reste rien,
Qu’à venir prendre icy la place du Troyen:	Qu’à venir prendre ici la place du Troyen:
Nous sõmes Ennemis, luy des Grecs, moy le voſtre,	Nous sommes Ennemis, lui des Grecs, moi le vôtre,
Pyrrhus protege l’vn, & ie vous liure l’autre.	Pyrrhus protège l’un, et je vous livre l’autre.
Hé quoy? Dans vos chagrins ſans raiſon affermy,	Hé quoi? Dans vos chagrins sans raison affermi,
Vous croirez-vous toûjours, Seigneur, mon Ennemy?	Vous croirez-vous toujours, Seigneur, mon Ennemi?
Quelle eſt cette rigueur tant de fois alleguée?	Quelle est cette rigueur tant de fois alléguée?
I’ay paſſé dans l’Epire où j’eſtois releguée.	J’ai passé dans l’Épire où j’étais reléguée.
Mon Pere l’ordonnoit. Mais qui ſçait ſi depuis,	Mon Père l’ordonnait. Mais qui sait si depuis,
Ie n’ay point en ſecret partagé vos ennuis?	Je n’ai point en secret partagé vos ennuis?
Penſez-vous auoir ſeul éprouué des allarmes?	Pensez-vous avoir seul éprouvé des alarmes?
Que l’Epire iamais n’ait veû couler mes larmes?	Que l’Épire jamais n’ait vu couler mes larmes?
Enfin, qui vous a dit, que malgré mon deuoir,	Enfin, qui vous a dit, que malgré mon devoir,
Ie n’ay pas quelquefois ſouhaitté de vous voir?	Je n’ai pas quelquefois souhaité de vous voir?
Souhaitté de me voir? Ah diuine Princeſſe…	Souhaité de me voir? Ah divine Princesse...
Mais de grace, eſt-ce à moy que ce diſcours s’adreſſe?	Mais de grâce, est-ce à moi que ce discours s’adresse?
Ouurez les yeux. Songez qu’Oreſte eſt deuant vous,	Ouvrez les yeux . Songez qu’Oreste est devant vous,
Oreſte ſi long-temps l’objet de leur courroux.	Oreste si longtemps l’objet de leur courroux.
Oüy, c’eſt vous dont l’amour naiſſant auec leurs charmes,	Oui, c’est vous dont l’amour naissant avec leurs charmes,
Leur apprit le premier le pouuoir de leurs armes,	Leur apprit le premier le pouvoir de leurs armes,
Vous que mille vertus me forçoient d’eſtimer,	Vous que mille vertus me forçaient d’estimer,
Vous que i’ay plaint, enfin que ie voudrois aimer.	Vous que j’ai plaint, enfin que je voudrais aimer.
Ie vous entens. Tel eſt mon partage funeſte.	Je vous entends. Tel est mon partage funeste.
Le Cœur eſt pour Pyrrhus, & les vœux pour Oreſte.	Le Cœur est pour Pyrrhus, et les vœux pour Oreste.
Ah! ne ſouhaittez-pas le deſtin de Pyrrhus,	Ah! ne souhaitez pas le destin de Pyrrhus,
Ie vous haïrois trop.	Je vous haïrais trop.
Vous m’en aimeriez plus.	Vous m’en aimeriez plus.
Ah! que vous me verriez d’vn regard bien contraire!	Ah! que vous me verriez d’un regard bien contraire!
Vous me voulez aimer, & ie ne puis vous plaire,	Vous me voulez aimer, et je ne puis vous plaire,
Et l’Amour ſeul alors ſe faiſant obeïr,	Et l’Amour seul alors se faisant obéir,
Vous m’aimeriez, Madame, en me voulant haïr.	Vous m’aimeriez, Madame, en me voulant haïr.
O dieux! Tant de reſpects, vne amitié ſi tendre…	Ô dieux! Tant de respects, une amitié si tendre...
Que de raiſons pour moy, ſi vous pouuiez m’entendre!	Que de raisons pour moi, si vous pouviez m’entendre!
Vous ſeule pour Pyrrhus diſputez aujourd’huy,	Vous seule pour Pyrrhus disputez aujourd’hui,
Peut-eſtre malgré vous, ſans doute malgré luy.	Peut-être malgré vous, sans doute malgré lui.
Car enfin il vous hait. Son ame ailleurs épriſe	Car enfin il vous hait. Son âme ailleurs éprise
N’a plus…	N’a plus...
Qui vous l’a dit. Seigneur, qu’il me mépriſe?	Qui vous l’a dit, Seigneur, qu’il me méprise?
Ses regards, ſes diſcours vous l’ont-ils donc appris?	Ses regards, ses discours vous l’ont-ils donc appris?
Iugez vous que ma veuë inſpire des mépris?	Jugez-vous que ma vue inspire des mépris?
Qu’elle allume en vn cœur des feux ſi peu durables?	Qu’elle allume en un cœur des feux si peu durables?
Peut-eſtre d’autres yeux me sont plus fauorables.	Peut-être d’autres yeux me sont plus favorables.
Pourſuivez. Il eſt beau de m’inſulter ainſi.	Poursuivez. Il est beau de m’insulter ainsi.
Cruelle, c’est donc moy qui vous mépriſe ici.	Cruelle, c’est donc moi qui vous méprise ici.
Vos yeux n’ont pas aſſez éprouué ma conſtance.	Vos yeux n’ont pas assez éprouvé ma constance.
Ie ſuis donc vn témoin de leur peu de puiſſance.	Je suis donc un témoin de leur peu de puissance.
Ie les ay mépriſez? Ah! Qu’ils voudroient bien voir	Je les ai méprisés? Ah. Qu’ils voudraient bien voir
Un Riual, comme moy, mépriſer leur pouuoir.	Un Rival, comme moi, mépriser leur pouvoir.
Que m’importe, Seigneur, ſa haine, ou ſa tendreſſe?	Que m’importe, Seigneur, sa haine, ou sa tendresse?
Allez contre vn Rebelle armer toute la Gréce.	Allez contre un Rebelle armer toute la Grèce.
Rapportez-luy le prix de ſa rebellion.	Rapportez-lui le prix de sa rébellion.
Qu’on faſſe de l’Epire vn ſecond Ilion.	Qu’on fasse de l’Épire un second Ilion.
Allez. Apres cela, direz-vous que ie l’aime?	Allez. Après cela, direz-vous que je l’aime?
Madame, faites plus, & venez-y vous-meſme.	Madame, faites plus, et venez-y vous-même.
Voulez-vous demeurer pour oſtage en ces lieux?	Voulez-vous demeurer pour otage en ces lieux?
Venez dans tous les cœurs faire parler vos yeux.	Venez dans tous les cœurs faire parler vos yeux.
Faiſons de noſtre haine vne commune attaque.	Faisons de notre haine une commune attaque.
Mais, Seigneur, cependant s’il épouſe Andromaque?	Mais, Seigneur, cependant s’il épouse Andromaque?
Hé Madame!	Hé Madame!
Songez quelle honte pour nous,	Songez quelle honte pour nous,
Si d’vne Phrygienne il deuenoit l’Eſpoux.	Si d’une Phrygienne il devenait l’Époux.
Et vous le haïſſez? Auoüez-le, Madame,	Et vous le haïssez? Avouez-le, Madame,
L’Amour n’eſt pas un feu qu’on renferme en vne ame.	L’Amour n’est pas un feu qu’on renferme en une âme.
Tout nous trahit, la voix, le ſilence, les yeux.	Tout nous trahit, la voix, le silence, les yeux.
Et les feux mal couuerts n’en éclatent que mieux.	Et les feux mal couverts n’en éclatent que mieux.
Seigneur, ie le voy bien, voſtre ame préuenuë	Seigneur, je le vois bien, votre âme prévenue
Répand ſur mes diſcours le venin qui la tuë,	Répand sur mes discours le venin qui la tue,
Toûjours dans mes raiſons cherche quelque détour,	Toujours dans mes raisons cherche quelque détour,
Et croit qu’en moy la haine eſt vn effort d’amour.	Et croit qu’en moi la haine est un effort d’amour.
Il faut donc m’expliquer. Vous agirez en ſuite.	Il faut donc m’expliquer. Vous agirez ensuite.
Vous ſçauez qu’en ces lieux mon deuoir m’a conduite,	Vous savez qu’en ces lieux mon devoir m’a conduite,
Mon deuoir m’y retient, & ie n’en puis partir,	Mon devoir m’y retient, et je n’en puis partir,
Que mon Pere, ou Pyrrhus ne m’en faſſe ſortir.	Que mon Père, ou Pyrrhus ne m’en fasse sortir.
Au nom de Menelas allez luy faire entendre,	Au nom de Ménélas allez lui faire entendre,
Que l’Ennemy des Grecs ne peut eſtre ſon Gendre.	Que l’Ennemi des Grecs ne peut être son Gendre.
Du Troyen, ou de moy, faites le decider:	Du Troyen, ou de moi, faites-le décider:
Qu’il ſonge qui des deux, il veut rendre, ou garder.	Qu’il songe qui des deux, il veut rendre, ou garder.
Enfin qu’il me renuoye, ou bien qu’il vous le liure.	Enfin qu’il me renvoie, ou bien qu’il vous le livre.
Adieu, s’il y conſent, ie ſuis preſte à vous ſuiure.	Adieu, s’il y consent, je suis prête à vous suivre.
OVy, oüy, vous me ſuivrez, n’en doutez nul-lement.	Oui, oui, vous me suivrez, n’en doutez nullement.
Ie vous reſpons déja de ſon conſentement.	Je vous réponds déjà de son consentement.
Ie ne crains pas, enfin, que Pyrrhus la retienne,	Je ne crains pas, enfin, que Pyrrhus la retienne,
Il n’a deuant les yeux que ſa chere Troyenne,	Il n’a devant les yeux que sa chère Troyenne,
Tout autre objet le bleſſe, & peut-eſtre aujourd’huy	Tout autre objet le blesse, et peut-être aujourd’hui
Il n’attend qu’vn prétexte à l’éloigner de luy.	Il n’attend qu’un prétexte à l’éloigner de lui.
Nous n’auons qu’à parler. C’en eſt fait. Quelle joye	Nous n’avons qu’à parler. C’en est fait. Quelle joie
D’enleuer à l’Epire vne ſi belle Proye!	D’enlever à l’Épire une si belle Proie!
Sauue tout ce qui reſte, & de Troye, & d’Hector.	Sauve tout ce qui reste, et de Troie, et d’Hector.
Garde ſon Fils, ſa Veuue, & mille autres encor:	Garde son Fils, sa Veuve, et mille autres encor:
Epire, c’eſt aſſez qu’Hermionne renduë	Épire, c’est assez qu’Hermione rendue
Perde à jamais tes bords, & ton Prince de veuë.	Perde à jamais tes bords, et ton Prince de vue.
Mais vn heureux deſtin le conduit en ces lieux.	Mais un heureux destin le conduit en ces lieux.
Parlons. A tant d’attraits, Amour, ferme ſes yeux.	Parlons. À tant d’attraits, Amour, ferme ses yeux.
IE vous cherchois, Seigneur. Vn peu de violence	Je vous cherchais, Seigneur. Un peu de violence
M’a fait de vos raiſons combattre la puiſſance,	M’a fait de vos raisons combattre la puissance,
Ie l’auouë. Et depuis que ie vous ay quitté,	Je l’avoue. Et depuis que je vous ai quitté,
I’en ay ſenty la force, & connu l’équité.	J’en ai senti la force, et connu l’équité.
I’ay ſongé comme vous, qu’à la Grece, à mon Pere,	J’ai songé comme vous, qu’à la Grèce, à mon Père,
A moy-meſme en vn mot ie deuenois contraire,	À moi-même en un mot je devenais contraire,
Que ie releuois Troye, & rendois imparfait	Que je relevais Troie, et rendais imparfait
Tout ce qu’a fait Achille, & tout ce que i’ay fait.	Tout ce qu’a fait Achille, et tout ce que j’ai fait.
Ie ne condamne plus vn courroux legitime,	Je ne condamne plus un courroux légitime,
Et l’on vous va, Seigneur, liurer voſtre Victime.	Et l’on vous va, Seigneur, livrer votre Victime.
Seigneur, par ce conſeil prudent & rigoureux,	Seigneur, par ce conseil prudent et rigoureux,
C’eſt acheter la Paix du ſang d’vn Malheureux.	C’est acheter la Paix du sang d’un Malheureux.
Oüy. Mais ie veux, Seigneur, l’aſſurer dauantage.	Oui. Mais je veux, Seigneur, l’assurer davantage.
D’vne eternelle Paix Hermionne eſt le gage.	D’une éternelle Paix Hermione est le gage.
Ie l’eſpouſe. Il ſembloit qu’vn ſpectacle ſi doux	Je l’épouse. Il semblait qu’un spectacle si doux
N’attendiſt en ces lieux qu’vn Teſmoin tel que vous.	N’attendît en ces lieux qu’un Témoin tel que vous.
Vous y repréſentez tous les Grecs & ſon Pere,	Vous y représentez tous les Grecs et son Père,
Puis qu’en vous Menelas voit reuiure ſon Frere.	Puisqu’en vous Ménélas voit revivre son Frère.
Voyez-la donc. Allez. Dites-luy que demain	Voyez-la donc. Allez. Dites-lui que demain
I’attens, auec la Paix, ſon cœur de voſtre Main.	J’attends, avec la Paix, son cœur de votre Main.
Ah dieux!	Ah dieux!
HE bien, Phœnix, l’Amour eſt-il le Maiſtre?	Hé bien, Phœnix, l’Amour est-il le Maître?
Tes yeux refuſent-ils encor de me connaiſtre?	Tes yeux refusent-ils encor de me connaître?
Ah! je vous reconnois, & ce juste courroux	Ah! je vous reconnais, et ce juste courroux
Ainſi qu’à tous les Grecs, Seigneur, vous rend à vous.	Ainsi qu’à tous les Grecs, Seigneur, vous rend à vous.
Et qui l’auroit penſé, qu’vne ſi noble audace	Et qui l’aurait pensé, qu’une si noble audace
D’vn long abaiſſement prendroit ſi-toſt la place?	D’un long abaissement prendrait si tôt la place?
Que l’on pût ſi-toſt vaincre vn poiſon ſi charmant?	Que l’on pût si tôt vaincre un poison si charmant?
Mais Pyrrhus, quand il veut, ſçait vaincre en vn moment.	Mais Pyrrhus, quand il veut, sait vaincre en un moment.
Ce n’eſt plus le jouët d’vne flamme ſeruile.	Ce n’est plus le jouet d’une flamme servile.
C’eſt Pyrrhus. C’est le Fils, & le Riual d’Achille,	C’est Pyrrhus. C’est le Fils, et le Rival d’Achille,
Que la Gloire à la fin rameine ſous ſes lois,	Que la Gloire à la fin ramène sous ses lois,
Qui triomphe de Troye vne ſeconde fois.	Qui triomphe de Troie une seconde fois.
Dy plutoſt, qu’aujourd’huy commence ma Victoire.	Dis plutôt, qu’aujourd’hui commence ma Victoire.
D’aujourd’huy ſeulement ie jouïs de ma gloire,	D’aujourd’hui seulement je jouis de ma gloire,
Et mon cœur auſſi fier, que tu l’as veû ſoûmis,	Et mon cœur aussi fier, que tu l’as vu soumis,
Croit auoir en l’Amour vaincu mille Ennemis.	Croit avoir en l’Amour vaincu mille Ennemis.
Conſidere, Phœnix, les troubles que j’éuite,	Considère, Phœnix, les troubles que j’évite,
Quelle foule de maux l’Amour traiſne à ſa ſuite;	Quelle foule de maux l’Amour traîne à sa suite;
Que d’Amis, de deuoirs j’allois ſacrifier;	Que d’Amis, de devoirs j’allais sacrifier;
Quels perils… Vn regard m’euſt tout fait oublier.	Quels périls... Un regard m’eût tout fait oublier.
Tous les Grecs conjurez fondoient ſur vn Rebelle.	Tous les Grecs conjurés fondaient sur un Rebelle.
Ie trouuois du plaiſir à me perdre pour Elle.	Je trouvais du plaisir à me perdre pour Elle.
Oüy, ie benis, Seigneur, l’heureuſe cruauté	Oui, je bénis, Seigneur, l’heureuse cruauté
Qui vous rend…	Qui vous rend...
Tu l’as veû comme elle m’a traitté.	Tu l’as vu comme elle m’a traité.
Ie penſois, en voyant ſa tendreſſe allarmée,	Je pensais, en voyant sa tendresse alarmée,
Que ſon Fils me la duſt renuoyer deſarmée.	Que son Fils me la dût renvoyer désarmée.
I’allois voir le ſuccez de ſes embraſſemens.	J’allais voir le succès de ses embrassements.
Ie n’ay trouué que pleurs mélez d’emportemens.	Je n’ai trouvé que pleurs mêlés d’emportements.
Sa miſere l’aigrit. Et touſiours plus farouche	Sa misère l’aigrit. Et toujours plus farouche
Cent fois le nom d’Hector eſt ſorti de ſa bouche.	Cent fois le nom d’Hector est sorti de sa bouche.
Vainement à ſon Fils j’aſſurois mon ſecours,	Vainement à son Fils j’assurais mon secours,
C’eſt Hector, (diſoit-elle en l’embraſſant toûjours;)	C’est Hector, (disait-elle en l’embrassant toujours; )
Voila ſes yeux, ſa bouche, & déja ſon audace,	Voilà ses yeux, sa bouche, et déjà son audace,
C’eſt luy-meſme, c’eſt toy cher Eſpoux que j’embraſſe.	C’est lui-même, c’est toi, cher Époux, que j’embrasse.
Et quelle eſt ſa penſée? Attend-elle en ce iour	Et quelle est sa pensée? Attend-elle en ce jour
Que ie luy laiſſe vn Fils pour nourrir ſon amour?	Que je lui laisse un Fils pour nourrir son amour?
Sans doute. C’eſt le prix que vous gardoit l’Ingrate.	Sans doute. C’est le prix que vous gardait l’Ingrate.
Mais laiſſez-la, Seigneur.	Mais laissez-la, Seigneur.
Ie voy ce qui la flatte.	Je vois ce qui la flatte.
Sa beauté la raſſure, & malgré mon courroux.	Sa beauté la rassure, et malgré mon courroux,
L’Orgueilleuſe m’attend encore à ſes genoux.	L’Orgueilleuse m’attend encore à ses genoux.
Ie la verrois aux miens, Phœnix, d’vn œil trãquile.	Je la verrais aux miens, Phœnix, d’un œil tranquille.
Elle eſt Veuue d’Hector. Et ie ſuis Fils d’Achile.	Elle est Veuve d’Hector. Et je suis Fils d’Achille.
Trop de haine ſepare Andromaque & Pyrrhus.	Trop de haine sépare Andromaque et Pyrrhus.
Commencez donc, Seigneur, à ne m’en parler plus.	Commencez donc, Seigneur, à ne m’en parler plus.
Allez voir Hermionne, & content de luy plaire,	Allez voir Hermione, et content de lui plaire,
Oubliez à ſes pieds iuſqu’à voſtre colere.	Oubliez à ses pieds jusqu’à votre colère.
Vous-meſme à cét hymen venez la diſpoſer?	Vous-même à cet hymen venez la disposer.
Eſt-ce ſur vn Riual qu’il s’en faut repoſer?	Est-ce sur un Rival qu’il s’en faut reposer?
Il ne l’aime que trop.	Il ne l’aime que trop.
Crois-tu, ſi ie l’eſpouſe,	Crois-tu, si je l’épouse,
Qu’Andromaque en ſecret n’en ſera pas jalouſe?	Qu’Andromaque en secret n’en sera pas jalouse?
Quoy touſiours Andromaque occupe voſtre eſprit?	Quoi toujours Andromaque occupe votre esprit?
Que vous importe, ô Dieux! ſa joye, ou ſon deſpit?	Que vous importe, ô Dieux! sa joie, ou son dépit?
Quel charme malgré vous vers elle vous attire?	Quel charme malgré vous vers elle vous attire?
Non, ie n’ay pas bien dit tout ce qu’il luy faut dire.	Non, je n’ai pas bien dit tout ce qu’il lui faut dire.
Ma colere à ſes yeux n’a paru qu’à demy.	Ma colère à ses yeux n’a paru qu’à demi.
Elle ignore à quel point ie ſuis ſon Ennemy.	Elle ignore à quel point je suis son Ennemi.
Retournons-y. Ie veux la brauer à ſa veuë,	Retournons-y. Je veux la braver à sa vue,
Et donner à ma haine une libre eſtenduë.	Et donner à ma haine une libre étendue.
Vien voir tous ſes attraits, Phœnix, humiliez.	Viens voir tous ses attraits, Phœnix, humiliés.
Allons.	Allons.
Allez, Seigneur, vous jeter à ſes piez.	Allez, Seigneur, vous jeter à ses pieds.
Allez, en luy jurant que voſtre ame l’adore,	Allez, en lui jurant que votre âme l’adore,
A de nouveaux meſpris l’encourager encore.	À de nouveaux mépris l’encourager encore.
Ie le voy bien, tu crois que preſt à l’excuſer.	Je le vois bien, tu crois que prêt à l’excuser
Mon Cœur court apres elle, & cherche à s’apaiſer.	Mon Cœur court après elle, et cherche à s’apaiser.
Vous aimez, c’eſt aſſez.	Vous aimez, c’est assez.
Moy l’aimer? Vne Ingrate,	Moi l’aimer? une Ingrate,
Qui me hait d’autant plus que mon amour la flate?	Qui me hait d’autant plus que mon amour la flatte?
Sans Parens, ſans Amis, ſans eſpoir que ſur moy.	Sans Parents, sans Amis, sans espoir que sur moi.
Ie puis perdre ſon Fils, peut-eſtre ie le doy.	Je puis perdre son Fils, peut-être je le dois.
Eſtrangere… Que dis-je? Eſclaue dans l’Epire,	Étrangère... Que dis-je? Esclave dans l’Épire,
Ie luy donne ſon Fils, mon Ame, mon Empire,	Je lui donne son Fils, mon Âme, mon Empire,
Et ie ne puis gagner dans ſon perfide Cœur	Et je ne puis gagner dans son perfide Cœur
D’autre rang que celuy de ſon Perſecuteur?	D’autre rang que celui de son Persécuteur?
Non, non, ie l’ay juré, ma vangeance eſt certaine.	Non, non, je l’ai juré, ma vengeance est certaine.
Il faut bien vne fois juſtifier ſa haine.	Il faut bien une fois justifier sa haine.
I’abandonne ſon Fils. Que de pleurs vont couler!	J’abandonne son Fils. Que de pleurs vont couler!
De quel nom ſa douleur me va-t’elle appeller?	De quel nom sa douleur me va-t-elle appeler?
Quel ſpectacle pour elle aujourd’huy ſe diſpoſe!	Quel spectacle pour elle aujourd’hui se dispose!
Elle en mourra, Phœnix, & j’en ſeray la cauſe.	Elle en mourra, Phœnix, et j’en serai la cause.
C’eſt luy mettre moy-meſme vn poignard dans le ſein.	C’est lui mettre moi-même un poignard dans le sein.
Et pourquoy donc en faire éclater le deſſein?	Et pourquoi donc en faire éclater le dessein?
Que ne conſultiez-vous tantoſt voſtre foibleſſe?	Que ne consultiez-vous tantôt votre faiblesse?
Ie t’entens. Mais excuſe vn reſte de tendreſſe.	Je t’entends. Mais excuse un reste de tendresse.
Crains-tu pour ma colere vn ſi foible combat?	Crains-tu pour ma colère un si faible combat?
D’vn amour qui s’eſteint c’eſt le dernier éclat.	D’un amour qui s’éteint c’est le dernier éclat.
Allons. A tes conſeils, Phœnix, ie m’abandonne.	Allons. À tes conseils, Phœnix, je m’abandonne;
Faut-il liurer ſon Fils? Faut-il voir Hermionne?	Faut-il livrer son Fils? Faut-il voir Hermione?
Oüy, voyez-la, Seigneur, & par des vœux ſoûmis	Oui, voyez-la, Seigneur, et par des vœux soumis
Proteſtez-luy…	Protestez-lui...
Faiſons tout ce que i’ay promis.	Faisons tout ce que j’ai promis.
Moderez donc, Seigneur, cette fureur extréme.	Modérez donc, Seigneur, cette fureur extrême.
Ie ne vous connoy plus. Vous n’eſtes plus vous-meſme.	Je ne vous connais plus. Vous n’êtes plus vous-même.
Souffrez…	Souffrez...
Non, tes conſeils ne ſont plus de ſaiſon,	Non, tes conseils ne sont plus de saison,
Pylade, ie ſuis las d’écouter la raiſon.	Pylade, je suis las d’écouter la raison.
C’eſt traiſner trop long-temps ma vie & mon ſupplice.	C’est traîner trop longtemps ma vie et mon supplice.
Il faut que ie l’enleue, ou bien que ie periſſe.	Il faut que je l’enlève, ou bien que je périsse.
Le deſſein en eſt pris, ie le veux acheuer.	Le dessein en est pris, je le veux achever.
Oüy ie le veux.	Oui je le veux.
Hé bien, il la faut enleuer.	Hé bien il la faut enlever.
I’y conſens. Mais ſongez cependant où vous eſtes.	J’y consens. Mais songez cependant où vous êtes.
Que croira-t’on de vous à voir ce que vous faites?	Que croira-t-on de vous à voir ce que vous faites?
Faites taire, Seigneur, ce tranſport inquiet.	Faites taire, Seigneur, ce transport inquiet .
Commandez à vos yeux de garder le ſecret.	Commandez à vos yeux de garder le secret.
Ces Gardes, cette Cour, l’air qui vous enuironne.	Ces Gardes, cette Cour, l’air qui vous environne.
Tout dépend de Pyrrhus, & ſur tout d’Hermionne.	Tout dépend de Pyrrhus, et surtout d’Hermione.
A ſes regards ſur tout cachez voſtre courroux.	À ses regards surtout cachez votre courroux.
O dieux! en cet eſtat pourquoy la cherchiez-vous?	Ô dieux! en cet état pourquoi la cherchiez-vous?
Que ſçay-je? De moy-meſme eſtois-je alors le maiſtre?	Que sais-je? De moi-même étais-je alors le maître?
La fureur m’emportoit, & ie venois peut-eſtre	La fureur m’emportait, et je venais peut-être
Menaſſer à la fois l’Ingrate & ſon Amant.	Menacer à la fois l’Ingrate et son Amant.
Et quel eſtoit le fruit de cet emportement?	Et quel était le fruit de cet emportement?
Et quelle ame, dy-moy, ne ſeroit éperduë	Et quelle âme, dis-moi, ne serait éperdue
Du coup dont ma raiſon vient d’eſtre confonduë?	Du coup dont ma raison vient d’être confondue?
Il épouſe, dit-il, Hermionne demain.	Il épouse, dit-il, Hermione demain.
Il veut pour m’honorer la tenir de ma main.	Il veut pour m’honorer la tenir de ma main.
Ah! pluſtoſt cette main dans le ſang du Barbare…	Ah! plutôt cette main dans le sang du Barbare...
Vous l’accuſez, Seigneur, de ce deſtin bizare.	Vous l’accusez, Seigneur, de ce destin bizarre.
Cependant tourmenté de ſes propres deſſeins,	Cependant tourmenté de ses propres desseins,
Il eſt peut-eſtre à plaindre, autant que ie vous plains.	Il est peut-être à plaindre, autant que je vous plains.
Non, non, ie le connoy, mon deſeſpoir le flate	Non, non, je le connais, mon désespoir le flatte
Sans moy, ſans mon amour il dédaignoit l’Ingrate	Sans moi, sans mon amour il dédaignait l’Ingrate.
Ses charmes iuſques-là n’auoient pû le toucher.	Ses charmes jusque-là n’avaient pu le toucher.
Le Cruel ne la prend que pour me l’arracher.	Le Cruel ne la prend que pour me l’arracher.
Ah dieux! c’en eſtoit fait. Hermionne gagnée	Ah dieux! c’en était fait. Hermione gagnée
Pour iamais de ſa veuë alloit eſtre éloignée.	Pour jamais de sa vue allait être éloignée.
Son cœur entre l’amour & le dépit confus.	Son cœur entre l’amour et le dépit confus
Pour ſe donner à moy n’attendoit qu’vn refus.	Pour se donner à moi n’attendait qu’un refus.
Ses yeux s’ouuroient, Pylade. Elle écoutoit Oreſte,	Ses yeux s’ouvraient, Pylade. Elle écoutait Oreste,
Luy parloit, le plaignoit. Vn mot euſt fait le reſte.	Lui parlait, le plaignait. Un mot eût fait le reste.
Vous le croyez.	Vous le croyez.
Hé quoy? ce courroux enflammé	Hé quoi? Ce courroux enflammé
Contre vn Ingrat…	Contre un Ingrat...
Iamais il ne fut plus aimé.	Jamais il ne fut plus aimé.
Penſez-vous, quand Pyrrhus vous l’auroit accordée,	Pensez-vous, quand Pyrrhus vous l’aurait accordée,
Qu’vn prétexte tout preſt ne l’euſt pas retardée?	Qu’un prétexte tout prêt ne l’eût pas retardée?
M’en croirez-vous? Laſſé de ſes trompeurs attraits,	M’en croirez-vous? Lassé de ses trompeurs attraits,
Au lieu de l’enleuer, Seigneur, ie la fuirais.	Au lieu de l’enlever, Seigneur, je la fuirais .
Quoy? Voſtre amour ſe veut charger d’vne Furie	Quoi? Votre amour se veut charger d’une Furie
Qui vous déteſtera, qui toute voſtre vie	Qui vous détestera, qui toute votre vie
Regrettant vn hymen tout preſt à s’acheuer,	Regrettant un hymen tout prêt à s’achever,
Voudra…	Voudra...
C’eſt pour cela que ie veux l’enleuer.	C’est pour cela que je veux l’enlever.
Tout luy riroit, Pylade, & moy, pour mon partage,	Tout lui rirait, Pylade, et moi, pour mon partage,
Ie n’emporterois donc qu’vne inutile rage?	Je n’emporterais donc qu’une inutile rage?
I’irois loin d’elle encor, taſcher de l’oublier?	J’irais loin d’elle encor, tâcher de l’oublier?
Non, non, à mes tourmens ie veux l’aſſocier.	Non, non, à mes tourments je veux l’associer.
C’eſt trop gémir tout ſeul. Ie ſuis las qu’on me plaigne.	C’est trop gémir tout seul. Je suis las qu’on me plaigne.
Ie prétens qu’à mon tour l’Inhumaine me craigne,	Je prétends qu’à mon tour l’Inhumaine me craigne,
Et que ſes Yeux cruels à pleurer condannez,	Et que ses Yeux cruels à pleurer condamnés,
Me rendent tous les noms, que ie leur ay donnez.	Me rendent tous les noms, que je leur ai donnés.
Voila donc le ſuccez qu’aura voſtre Ambassade,	Voilà donc le succès qu’aura votre Ambassade,
Oreſte rauiſſeur.	Oreste ravisseur.
Et qu’importe, Pylade?	Et qu’importe, Pylade?
Quand nos Eſtats vangez jouïront de mes ſoins,	Quand nos États vengés jouiront de mes soins,
L’Ingrate de mes pleurs jouïra-t’elle moins?	L’Ingrate de mes pleurs jouira-t-elle moins?
Et que me ſeruira que la Gréce m’admire	Et que me servira que la Grèce m’admire,
Tandis que ie ſeray la fable de l’Epire?	Tandis que je serai la fable de l’Épire?
Que veux-tu? Mais, s’il faut ne te rien déguiſer,	Que veux-tu? Mais s’il faut ne te rien déguiser,
Mon Innocence enfin commence à me peſer.	Mon Innocence enfin commence à me peser.
Ie ne ſçay de tout temps quelle injuſte Puiſſance	Je ne sais de tout temps quelle injuste Puissance
Laiſſe le Crime en paix, & pourſuit l’Innocence.	Laisse le Crime en paix, et poursuit l’Innocence.
De quelque part ſur moy que ie tourne les yeux,	De quelque part sur moi que je tourne les yeux,
Ie ne voy que malheurs qui condannent les Dieux.	Je ne vois que malheurs qui condamnent les Dieux.
Meritons leur courroux, juſtifions leur haine,	Méritons leur courroux, justifions leur haine,
Et que le fruit du Crime en précede la peine.	Et que le fruit du Crime en précède la peine.
Mais toy, par quelle erreur veux-tu toûjours ſur toy	Mais toi, par quelle erreur veux-tu toujours sur toi
Deſtourner vn courroux qui ne cherche que moy?	Détourner un courroux qui ne cherche que moi?
Aſſez & trop long-temps mon amitié t’accable.	Assez et trop longtemps mon amitié t’accable.
Euite vn Malheureux, abandonne vn Coupable.	Évite un malheureux, abandonne un Coupable.
Cher Pylade, croy-moy, mon tourment me ſuffit,	Cher Pylade, crois-moi, mon tourment me suffit,
Laiſſe-moy des perils dont j’attens tout le fruit.	Laisse-moi des périls dont j’attends tout le fruit.
Porte aux Grecs cet Enfant que Pyrrhus m’abandonne.	Porte aux Grecs cet Enfant que Pyrrhus m’abandonne.
Va-t’en.	Va-t’en.
Allons, Seigneur, enleuons Hermionne.	Allons, Seigneur, enlevons Hermione.
Au trauers des perils vn grand Cœur ſe fait iour.	Au travers des périls un grand Cœur se fait jour.
Que ne peut l’amitié conduite par l’amour?	Que ne peut l’amitié conduite par l’amour?
Allons de tous vos Grecs encourager le zele.	Allons de tous vos Grecs encourager le zèle.
Nos vaiſſeaux ſont tous preſts, & le vent nous appelle.	Nos vaisseaux sont tous prêts , et le vent nous appelle.
Ie ſçay de ce Palais tous les détours obſcurs.	Je sais de ce Palais tous les détours obscurs.
Vous voyez que la Mer en vient battre les Murs.	Vous voyez que la Mer en vient battre les Murs.
Et cette Nuit ſans peine vne ſecrette voye,	Et cette Nuit sans peine une secrète voie,
Iuſqu’en voſtre vaiſſeau conduira voſtre Proye.	Jusqu’en votre vaisseau conduira votre Proie.
I’abuſe, cher Amy, de ton trop d’amitié.	J’abuse, cher Ami, de ton trop d’amitié.
Mais pardonne à des maux, dont toy ſeul as pitié.	Mais pardonne à des maux, dont toi seul as pitié.
Excuſe vn Malheureux, qui perd tout ce qu’il aime,	Excuse un Malheureux, qui perd tout ce qu’il aime,
Que tout le monde hait, & qui ſe hait luy-meſme.	Que tout le Monde hait, et qui se hait lui-même.
Que ne puis-je à mon tour, dans vn ſort plus heureux…	Que ne puis-je à mon tour, dans un sort plus heureux...
Diſſimulez, Seigneur, c’eſt tout ce que ie veux.	Dissimulez, Seigneur, c’est tout ce que je veux.
Gardez qu’auant le coup voſtre deſſein n’éclate.	Gardez qu’avant le coup votre dessein n’éclate.
Oubliez iuſque-là qu’Hermionne eſt ingrate.	Oubliez jusques-là qu’Hermione est ingrate.
Oubliez voſtre amour. Elle vient, ie la voy.	Oubliez votre amour. Elle vient, je la vois.
Va-t’en. Répons-moy d’elle, & ie répons de moy.	Va-t’en. Réponds-moi d’elle, et je réponds de moi.
HE bien? Mes ſoins vous ont rendu voſtre Conqueſte.	Hé bien? Mes soins vous ont rendu votre Conquête.
I’ay veû Pyrrhus, Madame, & voſtre hymen s’apreſte.	J’ai vu Pyrrhus, Madame, et votre hymen s’apprête.
On le dit. Et de plus, on vient de m’aſſurer,	On le dit. Et de plus, on vient de m’assurer,
Que vous ne me cherchiez que pour m’y préparer.	Que vous ne me cherchiez que pour m’y préparer.
Et voſtre ame à ſes vœux ne ſera pas rebelle?	Et votre âme à ses vœux ne sera pas rebelle?
Qui l’euſt crû, que Pyrrhus ne fuſt pas infidelle?	Qui l’eût cru, que Pyrrhus ne fût pas infidèle?
Que ſa flamme attendroit ſi tard pour éclater,	Que sa flamme attendrait si tard pour éclater,
Qu’il reuiendroit à moy, quand ie l’allois quitter?	Qu’il reviendrait à moi, quand je l’allais quitter?
Ie veux croire auec vous, qu’il redoute la Grece,	Je veux croire avec vous, qu’il redoute la Grèce,
Qu’il ſuit ſon intereſt plûtoſt que ſa tendreſſe,	Qu’il suit son intérêt plutôt que sa tendresse,
Que mes yeux ſur voſtre ame eſtoiẽt plus abſolus.	Que mes yeux sur votre âme étaient plus absolus.
Non, Madame, il vous aime, & ie n’en doute plus.	Non, Madame, il vous aime, et je n’en doute plus.
Vos yeux ne font-ils pas tout ce qu’ils veulent faire?	Vos yeux ne font-ils pas tout ce qu’ils veulent faire?
Et vous ne vouliez pas ſans doute luy déplaire.	Et vous ne vouliez pas sans doute lui déplaire.
Mais que puis-je, Seigneur? On a promis ma foy.	Mais que puis-je, Seigneur? On a promis ma foi.
Luy rauiray-je vn bien, qu’il ne tient pas de moy?	Lui ravirai-je un bien, qu’il ne tient pas de moi?
L’Amour ne regle pas le ſort d’vne Princeſſe.	L’Amour ne règle pas le sort d’une Princesse.
La gloire d’obeïr eſt tout ce qu’on nous laiſſe.	La gloire d’obéir est tout ce qu’on nous laisse.
Cependant ie partois, & vous auez pû voir	Cependant je partais, et vous avez pu voir
Combien ie relaſchois pour vous de mon deuoir.	Combien je relâchais pour vous de mon devoir.
Ah! que vous ſçauiez bien, Cruelle… Mais, Madame,	Ah! que vous saviez bien, Cruelle... Mais, Madame,
Chacun peut à ſon choix diſpoſer de ſon ame.	Chacun peut à son choix disposer de son âme.
La voſtre eſtoit à vous. I’eſperois. Mais enfin	La vôtre était à vous. J’espérais. Mais enfin
Vous l’auez pû donner ſans me faire vn larcin.	Vous l’avez pu donner sans me faire un larcin.
Ie vous accuſe auſſi, bien moins que la Fortune.	Je vous accuse aussi, bien moins que la Fortune.
Et pourquoy vous laſſer d’vne plainte importune?	Et pourquoi vous lasser d’une plainte importune?
Tel eſt voſtre deuoir, ie l’auouë. Et le mien	Tel est votre devoir, je l’avoue. Et le mien
Eſt de vous épargner vn ſi triſte entretien.	Est de vous épargner un si triste entretien.
ATendois-tu, Cleonne, vn courroux ſi mo-deſte?	Attendais-tu, Cléone, un courroux si modeste?
La douleur qui ſe taiſt n’en eſt que plus funeſte.	La douleur qui se tait n’en est que plus funeste.
Ie le plains. D’autant plus qu’Auteur de ſon ennuy,	Je le plains. D’autant plus qu’Auteur de son ennui,
Le coup qui l’a perdu n’eſt parti que de luy.	Le coup qui l’a perdu n’est parti que de lui.
Contez depuis quel tẽps voſtre hymen ſe prépare.	Comptez, depuis quel temps votre hymen se prépare.
Il a parlé, Madame, & Pyrrhus ſe déclare.	Il a parlé, Madame, et Pyrrhus se déclare.
Tu crois que Pyrrhus craint? Et que craint-il encor?	Tu crois que Pyrrhus craint? Et que craint-il encor?
Des Peuples, qui dix ans ont fuy deuant Hector?	Des Peuples, qui dix ans ont fui devant Hector?
Qui cent fois effrayez de l’abſence d’Achille,	Qui cent fois effrayés de l’absence d’Achille,
Dans leurs vaiſſeaux brulans ont cherché leur azile,	Dans leurs vaisseaux brûlants ont cherché leur asile,
Et qu’on verroit encor, ſans l’appuy de ſon Fils,	Et qu’on verrait encor, sans l’appui de son Fils,
Redemander Helene aux Troyens impunis?	Redemander Hélène aux Troyens impunis.
Non, Cleonne, il n’eſt point Ennemy de luy-meſme,	Non, Cléone, il n’est point Ennemi de lui-même,
Il veut tout ce qu’il fait, & s’il m’eſpouſe, il m’aime.	Il veut tout ce qu’il fait, et s’il m’épouse, il m’aime.
Mais qu’Oreſte à ſon gré m’impute ſes douleurs.	Mais qu’Oreste à son gré m’impute ses douleurs.
N’auons-nous d’entretien que celuy de ſes pleurs?	N’avons-nous d’entretien que celui de ses pleurs?
Pyrrhus reuient à nous. Hé bien, chere Cleonne,	Pyrrhus revient à nous. Hé bien, chère Cléone,
Conçois-tu les tranſports de l’heureuſe Hermiõne ?	Conçois-tu les transports de l’heureuse Hermione?
Sçais-tu quel eſt Pyrrhus? T’és-tu fait raconter	Sais-tu quel est Pyrrhus? T’es-tu fait raconter
Le nombre des Exploits… Mais qui les peut conter?	Le nombre des Exploits... Mais qui les peut conter?
Intrepide, & par tout ſuiuy de la Victoire,	Intrépide, et partout suivi de la Victoire,
Charmant, Fidelle enfin, rien ne mãque à ſa Gloire.	Charmant, Fidèle enfin, rien ne manque à sa Gloire.
Songe…	Songe...
Diſſimulez. Voſtre Riuale en pleurs,	Dissimulez. Votre Rivale en pleurs,
Vient à vos pieds ſans doute apporter ſes douleurs.	Vient à vos pieds sans doute apporter ses douleurs.
Dieux! ne puis-je à ma joye abandonner mon ame?	Dieux! Ne puis-je à ma joie abandonner mon âme?
Sortons. Que luy dirois-je?	Sortons. Que lui dirais-je?
OV fuyez-vous, Madame?	Où fuyez-vous, Madame?
N’eſt-ce point à vos yeux, vn ſpectacle aſſez doux	N’est-ce point à vos yeux, un spectacle assez doux
Que la Veuue d’Hector pleurante à vos genoux?	Que la Veuve d’Hector pleurante à vos genoux?
Ie ne viens point icy, par de jalouſes larmes,	Je ne viens point ici, par de jalouses larmes,
Vous enuier vn Cœur, qui ſe rend à vos charmes.	Vous envier un Cœur, qui se rend à vos charmes.
Par les mains de ſon Pere, helas! i’ay veû percer	Par les mains de son Père , hélas! j’ai vu percer
Le ſeul, où mes regards pretendoient s’adreſſer.	Le seul, où mes regards prétendaient s’adresser.
Ma flamme par Hector fut jadis allumée,	Ma flamme par Hector fut jadis allumée,
Auec luy dans la tombe elle s’eſt enfermée.	Avec lui dans la tombe elle s’est enfermée.
Mais il me reſte vn Fils. Vous ſçaurez quelque iour,	Mais il me reste un Fils. Vous saurez quelque jour,
Madame, pour vn Fils iuſqu’où va noſtre amour.	Madame, pour un Fils jusqu’où va notre amour.
Mais vous ne ſçaurez pas, du moins ie le ſouhaitte,	Mais vous ne saurez pas, du moins je le souhaite,
En quel trouble mortel ſon intereſt nous jette,	En quel trouble mortel son intérêt nous jette,
Lors que de tant de biens, qui pouuoient nous flatter,	Lorsque de tant de biens, qui pouvaient nous flatter,
C’eſt le ſeul qui nous reſte, & qu’on veut nous l’oſter.	C’est le seul qui nous reste, et qu’on veut nous l’ôter.
Helas! Lors que laſſez de dix ans de miſere,	Hélas! Lorsque lassés de dix ans de misère,
Les Troyens en courroux menaçoient voſtre Mere,	Les Troyens en courroux menaçaient votre Mère,
I’ay ſçeû de mon Hector luy procurer l’appuy;	J’ai su de mon Hector lui procurer l’appui;
Vous pouuez ſur Pyrrhus, ce que i’ay pû ſur luy.	Vous pouvez sur Pyrrhus, ce que j’ai pu sur lui.
Que craint-on d’vn Enfant, qui ſuruit à ſa perte?	Que craint-on d’un Enfant, qui survit à sa perte?
Laiſſez-moy le cacher en quelque Iſle deſerte.	Laissez-moi le cacher en quelque Île déserte.
Sur les ſoins de ſa Mere on peut s’en aſſurer,	Sur les soins de sa Mère on peut s’en assurer,
Et mon Fils auec moy n’aprendra qu’à pleurer.	Et mon Fils avec moi n’apprendra qu’à pleurer.
Ie conçoy vos douleurs. Mais vn devoir auſtere,	Je conçois vos douleurs. Mais un devoir austère,
Quand mon Pere a parlé, m’ordonne de me taire.	Quand mon Père a parlé, m’ordonne de me taire.
C’eſt luy, qui de Pyrrhus fait agir le courroux.	C’est lui, qui de Pyrrhus fait agir le courroux.
S’il faut fléchir Pyrrhus, qui le peut mieux que vous?	S’il faut fléchir Pyrrhus, qui le peut mieux que vous?
Vos yeux aſſez long-temps ont régné ſur ſon ame.	Vos yeux assez longtemps ont régné sur son âme.
Faites-le prononcer, j’y ſouſcriray, Madame.	Faites-le prononcer, j’y souscrirai, Madame.
QVel mépris la Cruelle attache à ſes refus!	Quel mépris la Cruelle attache à ses refus!
Ie croirois ſes conſeils, & je verrois Pyrrhus.	Je croirais ses conseils, et je verrais Pyrrhus.
Vn regard confondroit Hermionne & la Gréce…	Un regard confondrait Hermione et la Grèce...
Mais luy-meſme il vous cherche.	Mais lui-même il vous cherche.
OV donc eſt la Princeſſe?	Où donc est la Princesse?
Ne m’auois-tu pas dit qu’elle eſtoit en ces lieux?	Ne m’avais-tu pas dit qu’elle était en ces lieux?
Ie le croyois.	Je le croyais.
Tu vois le pouuoir de mes yeux.	Tu vois le pouvoir de mes yeux.
Que dit-elle, Phœnix?	Que dit-elle, Phœnix?
Helas! tout m’abandonne.	Hélas! tout m’abandonne.
Allons, Seigneur, marchons ſur les pas d’Hermionne.	Allons, Seigneur, marchons sur les pas d’Hermione.
Qu’attendez-vous? Forcez ce ſilence obſtiné.	Qu’attendez-vous? Forcez ce silence obstiné .
Il a promis mon Fils.	Il a promis mon Fils.
Il ne l’a pas donné.	Il ne l’a pas donné.
Non, non, j’ay beau pleurer, ſa mort eſt reſoluë.	Non, non, j’ai beau pleurer, sa mort est résolue.
Daigne-t’elle ſur nous tourner au moins la veuë?	Daigne-t-elle sur nous tourner au moins la vue?
Quel orgueil!	Quel orgueil!
Ie ne fay que l’irriter encor.	Je ne fais que l’irriter encor.
Sortons.	Sortons.
Allons aux Grecs liurer le Fils d’Hector.	Allons aux Grecs livrer le Fils d’Hector.
Ah, Seigneur, arreſtez. Que prétendez-vous faire?	Ah! Seigneur, arrêtez. Que prétendez-vous faire?
Si vous liurez le Fils, liurez-leur donc la Mere.	Si vous livrez le Fils, livrez-leur donc la Mère.
Vos ſermens m’ont tantoſt iuré tant d’amitié.	Vos serments m’ont tantôt juré tant d’amitié.
Dieux! N’en reſte-t’il pas du moins quelque pitié?	Dieux! N’en reste-t-il pas du moins quelque pitié?
Sans eſpoir de pardon m’auez-vous condamnée?	Sans espoir de pardon m’avez-vous condamnée?
Phœnix vous le dira, ma parole eſt donnée.	Phœnix vous le dira, ma parole est donnée.
Vous qui brauiez pour moy tant de perils diuers?	Vous qui braviez pour moi tant de périls divers?
I’eſtois aueugle alors, mes yeux ſe ſont ouuers.	J’étais aveugle alors, mes yeux se sont ouverts.
Sa grace à vos deſirs pouuoit eſtre accordée.	Sa grâce à vos désirs pouvait être accordée.
Mais vous ne l’auez pas ſeulement demandée.	Mais vous ne l’avez pas seulement demandée.
C’en eſt fait.	C’en est fait.
Ah! Seigneur, vous entendiez aſſez	Ah! Seigneur, vous entendiez assez
Des ſoûpirs, qui craignoient de ſe voir repouſſez.	Des soupirs, qui craignaient de se voir repoussés.
Pardonnez à l’éclat d’vne illuſtre fortune	Pardonnez à l’éclat d’une illustre fortune
Ce reſte de fierté, qui craint d’eſtre importune.	Ce reste de fierté, qui craint d’être importune.
Vous ne l’ignorez pas, Andromaque ſans vous	Vous ne l’ignorez pas, Andromaque sans vous
N’auroit jamais d’vn Maiſtre embraſſé les genoux.	N’aurait jamais d’un Maître embrassé les genoux.
Non, vous me haïſſez. Et dans le fonds de l’ame	Non, vous me haïssez. Et dans le fond de l’âme
Vous craignez de deuoir quelque choſe à ma flâme.	Vous craignez de devoir quelque chose à ma flamme.
Ce Fils meſme, ce Fils, l’objet de tant de ſoins,	Ce Fils même, ce Fils, l’objet de tant de soins,
Si je l’auois ſauué, vous l’en aimeriez moins.	Si je l’avais sauvé, vous l’en aimeriez moins.
La haine, le meſpris, contre moy tout s’aſſemble.	La haine, le mépris, contre moi tout s’assemble.
Vous me haïſſez plus que tous les Grecs enſemble.	Vous me haïssez plus que tous les Grecs ensemble.
Ioüiſſez à loiſir d’vn ſi noble courroux.	Jouissez à loisir d’un si noble courroux.
Allons, Phœnix.	Allons, Phœnix.
Allons rejoindre mon Eſpoux.	Allons rejoindre mon Époux.
Madame…	Madame...
Et que veux-tu que je lui dise encore?	Et que veux-tu que je lui dise encore?
Auteur de tous mes maux crois-tu qu’il les ignore?	Auteur de tous mes maux crois-tu qu’il les ignore?
Seigneur, voyez l’eſtat où vous me reduiſez?	Seigneur, voyez l’état où vous me réduisez.
I’ay veu mon Pere mort, & nos Murs embraſez,	J’ai vu mon Père mort, et nos Murs embrasés,
I’ay veû trancher les iours de ma Famille entiere,	J’ai vu trancher les jours de ma Famille entière,
Et mon Eſpoux ſanglant traiſné ſur la pouſſiere,	Et mon Époux sanglant traîné sur la poussière,
Son Fils ſeul avec moy reſerué pour les fers.	Son Fils seul avec moi réservé pour les fers.
Mais que ne peut vn Fils, ie reſpire, ie ſers.	Mais que ne peut un Fils, je respire, je sers.
I’ay fait plus. Ie me suis quelquefois conſolée	J’ai fait plus. Je me suis quelquefois consolée
Qu’icy plûtoſt qu’ailleurs le ſort m’euſt exhilée;	Qu’ici plutôt qu’ailleurs le sort m’eût exilée;
Qu’heureux dãs ſon malheur, le Fils de tant de Rois.	Qu’heureux dans son malheur, le Fils de tant de Rois,
Puis qu’il deuoit ſeruir, fuſt tombé ſous vos lois.	Puisqu’il devait servir, fût tombé sous vos lois.
I’ay crû que ſa Priſon deuiendroit ſon Azile.	J’ai cru que sa Prison deviendrait son Asile.
Iadis Priam ſoûmis fut reſpecté d’Achile.	Jadis Priam soumis fut respecté d’Achille.
I’attendois de ſon Fils encor plus de bonté.	J’attendais de son Fils encor plus de bonté.
Pardonne, cher Hector, à ma crédulité.	Pardonne, cher Hector, à ma crédulité.
Ie n’ay pû ſoupçonner ton Ennemy d’vn crime,	Je n’ai pu soupçonner ton Ennemi d’un crime,
Malgré luy-meſme enfin je l’ay crû magnanime.	Malgré lui-même enfin je l’ai cru magnanime.
Ah! s’il l’eſtoit aſſez, pour nous laiſſer du moins	Ah! s’il l’était assez, pour nous laisser du moins
Au Tombeau qu’à ta Cendre ont éleué mes ſoins;	Au Tombeau qu’à ta Cendre ont élevé mes soins;
Et que finiſſant-là ſa haine & nos miſeres,	Et que finissant là sa haine et nos misères,
Il ne ſéparaſt point des deſpoüilles ſi cheres!	Il ne séparât point des dépouilles si chères!
Va m’attendre, Phœnix.	Va m’attendre, Phœnix.
MAdame, demeurez;	Madame, demeurez;
On peut vous rendre encor ce Fils que vous pleurez.	On peut vous rendre encor ce Fils que vous pleurez.
Oüy, je ſens à regret, qu’en excitant vos larmes,	Oui, je sens à regret, qu’en excitant vos larmes,
Ie ne fay contre moy que vous donner des armes.	Je ne fais contre moi que vous donner des armes.
Ie croyois apporter plus de haine en ces lieux.	Je croyais apporter plus de haine en ces lieux.
Mais, Madame, du moins tournez vers moy les yeux.	Mais, Madame, du moins tournez vers moi les yeux.
Voyez ſi mes regards ſont d’vn Iuge ſeuere,	Voyez si mes regards sont d’un Juge sévère,
S’ils ſont d’un Ennemy qui cherche à vous déplaire.	S’ils sont d’un Ennemi qui cherche à vous déplaire.
Pourquoy me forcez-vous vous-meſme à vous trahir?	Pourquoi me forcez-vous vous-même à vous trahir?
Au nom de voſtre Fils, ceſſons de nous haïr.	Au nom de votre Fils, cessons de nous haïr.
A le ſauuer enfin, c’eſt moy qui vous conuie.	À le sauver enfin, c’est moi qui vous convie.
Faut-il que mes ſoûpirs vous demandent ſa vie?	Faut-il que mes soupirs vous demandent sa vie?
Faut-il qu’en ſa faueur j’embraſſe vos genoux?	Faut-il qu’en sa faveur j’embrasse vos genoux?
Pour la dernière fois, ſauuez-le, ſauuez-vous.	Pour la dernière fois, sauvez-le, sauvez-vous.
Ie ſçay de quels ſermens ie romps pour vous les chaiſnes,	Je sais de quels serments je romps pour vous les chaînes,
Combien ie vais ſur moy faire éclater de haines.	Combien je vais sur moi faire éclater de haines.
Ie renuoye Hermionne, & ie mets ſur ſon front,	Je renvoie Hermione, et je mets sur son front,
Au lieu de ma Couronne, vn eternel affront.	Au lieu de ma Couronne, un éternel affront.
Ie vous conduis au Temple, où ſon Hymen s’appreſte.	Je vous conduis au Temple, où son Hymen s’apprête.
Ie vous ceins du Bandeau, préparé pour ſa Teſte.	Je vous ceins du Bandeau, préparé pour sa Tête.
Mais ce n’eſt plus, Madame, vne offre à dédaigner.	Mais ce n’est plus, Madame, une offre à dédaigner.
Ie vous le dis, il faut ou perir, ou regner.	Je vous le dis, il faut ou périr, ou régner.
Mon cœur, deſeſperé d’vn an d’ingratitude,	Mon cœur, désespéré d’un an d’ingratitude,
Ne peut plus de ſon ſort ſouffrir l’incertitude.	Ne peut plus de son sort souffrir l’incertitude.
C’eſt craindre, menaſſer, & gemir trop long-temps.	C’est craindre, menacer, et gémir trop longtemps.
Ie meurs, ſi ie vous pers, mais ie meurs, ſi j’attens.	Je meurs, si je vous perds, mais je meurs, si j’attends.
Songez-y, ie vous laiſſe, & ie viendray vous prendre,	Songez-y, je vous laisse, et je viendrai vous prendre,
Pour vous mener au Temple, où ce Fils doit m’attendre.	Pour vous mener au Temple, où ce Fils doit m’attendre.
Et là vous me verrez ſoûmis, ou furieux,	Et là vous me verrez soumis, ou furieux,
Vous couronner, Madame, ou le perdre à vos yeux.	Vous couronner, Madame, ou le perdre à vos yeux.
HE bien, ie vous l'ay dit, qu'en deſpit de la  Grece	Hé bien, je vous l’ai dit, qu’en dépit de la Grèce
De voſtre ſort encor vous ſeriez la Maiſtreſſe.	De votre sort encor vous seriez la Maîtresse.
Helas! De quel effet tes diſcours ſont ſuiuis?	Hélas! De quel effet tes discours sont suivis?
Il ne me reſtoit plus qu’à condamner mon Fils.	Il ne me restait plus qu’à condamner mon Fils.
Madame, à voſtre Eſpoux c’eſt eſtre aſſez fidelle.	Madame, à votre Époux c’est être assez fidèle.
Trop de vertu pourroit vous rendre criminelle.	Trop de vertu pourrait vous rendre criminelle.
Luy-meſme il porteroit voſtre ame à la douceur.	Lui-même il porterait votre âme à la douceur.
Quoy, je lui donnerois Pyrrhus pour ſucceſſeur?	Quoi, je lui donnerais Pyrrhus pour successeur?
Ainſi le veut ſon Fils, que les Grecs vous rauiſſent.	Ainsi le veut son Fils, que les Grecs vous ravissent.
Penſez-vous qu’aprés tout ſes Manes en rougiſſent?	Pensez-vous qu’après tout ses Mânes en rougissent?
Qu’il meſpriſaſt, Madame, vn Roy victorieux,	Qu’il méprisât, Madame, un Roi victorieux,
Qui vous fait remonter au rang de vos Ayeux;	Qui vous fait remonter au rang de vos Aïeux;
Qui foule aux pieds pour vous vos Vainqueurs en colere,	Qui foule aux pieds pour vous vos Vainqueurs en colère,
Qui ne ſe ſouuient plus qu’Achile eſtoit ſon Pere,	Qui ne se souvient plus qu’Achille était son Père,
Qui dément ſes Exploits, & les rend ſuperflus?	Qui dément ses Exploits, et les rend superflus?
Dois-je les oublier, s’il ne s’en ſouuient plus?	Dois-je les oublier, s’il ne s’en souvient plus?
Dois-je oublier Hector priué de funerailles,	Dois-je oublier Hector privé de funérailles,
Et traiſné ſans honneur autour de nos murailles?	Et traîné sans honneur autour de nos murailles?
Dois-je oublier ſon Pere à mes pieds renuerſé,	Dois-je oublier son Père à mes pieds renversé,
Enſanglantant l’Autel qu’il tenoit embraſſé?	Ensanglantant l’Autel qu’il tenait embrassé?
Songe, ſonge, Cephiſe, à cette Nuit cruelle,	Songe, songe, Céphise, à cette Nuit cruelle,
Qui fut pour tout vn Peuple vne Nuit éternelle.	Qui fut pour tout un Peuple une Nuit éternelle.
Figure-toy Pyrrhus les yeux étincelans,	Figure-toi Pyrrhus les yeux étincelants,
Entrant à la lueur de nos Palais brûlans;	Entrant à la lueur de nos Palais brûlants;
Sur tous mes Freres morts ſe faiſant vn passage,	Sur tous mes Frères morts se faisant un passage,
Et de ſang tout couuert échauffant le carnage.	Et de sang tout couvert échauffant le carnage.
Songe aux cris des Vainqueurs, ſonge aux cris des Mourans,	Songe aux cris des Vainqueurs, songe aux cris des Mourants,
Dans la flamme étouffez, ſous le fer expirans.	Dans la flamme étouffés, sous le fer expirants.
Peins-toy dans ces horreurs Andromaque eſ-perduë.	Peins-toi dans ces horreurs Andromaque éperdue.
Voila comme Pyrrhus vint s’offrir à ma veuë,	Voilà comme Pyrrhus vint s’offrir à ma vue,
Voila par quels exploits il ſçeût ſe couronner,	Voilà par quels exploits il sut se couronner,
Enfin voila l’Eſpoux que tu me veux donner.	Enfin voilà l’Époux que tu me veux donner.
Non, ie ne ſeray point complice de ſes crimes.	Non, je ne serai point complice de ses crimes.
Qu’il nous prenne, s’il veut, pour dernieres Victimes.	Qu’il nous prenne, s’il veut, pour dernières Victimes.
Tous mes reſſentimens luy seroient aſſeruis.	Tous mes ressentiments lui seraient asservis.
Hé bien, allons donc voir expirer voſtre Fils.	Hé bien, allons donc voir expirer votre Fils.
On n’attend plus que vous. Vous fremiſſez, Ma-dame?	On n’attend plus que vous. Vous frémissez, Madame?
Ah! de quel ſouuenir viens-tu frapper mon ame?	Ah! de quel souvenir viens-tu frapper mon âme?
Quoy, Cephiſe, j’iray voir expirer encor	Quoi, Céphise, j’irai voir expirer encor
Ce Fils, ma ſeule joye, & l’image d’Hector?	Ce Fils, ma seule joie, et l’image d’Hector?
Ce Fils que de ſa flamme il me laiſſa pour gage?	Ce Fils que de sa flamme il me laissa pour gage?
Helas! il m’en ſouuient, le jour que ſon courage,	Hélas! il m’en souvient, le jour que son courage,
Luy fit chercher Achile, ou plûtoſt le treſpas;	Lui fit chercher Achille, ou plutôt le trépas,
Il demanda ſon Fils, & le prit dans ſes bras.	Il demanda son Fils, et le prit dans ses bras.
Chere Eſpouſe, dit-il, en eſſuyant mes larmes,	Chère Épouse, dit-il, en essuyant mes larmes,
I’ignore quel ſuccez le ſort garde à mes armes,	J’ignore quel succès le sort garde à mes armes,
Ie te laiſſe mon Fils, pour gage de ma foy;	Je te laisse mon Fils, pour gage de ma foi;
S’il me perd, ie prétens qu’il me retrouue en toy.	S’il me perd, je prétends qu’il me retrouve en toi.
Si d’vn heureux hymen la memoire t’eſt chere,	Si d’un heureux hymen la mémoire t’est chère,
Montre au Fils à quel point tu cheriſſois le Pere.	Montre au Fils à quel point tu chérissais le Père.
Et ie puis voir reſpandre vn sang ſi pretieux?	Et je puis voir répandre un sang si précieux?
Et ie laiſſe auec luy perir tous ſes Ayeux?	Et je laisse avec lui périr tous ses Aïeux?
Roy barbare, faut-il que mon crime l’entraiſne?	Roi barbare, faut-il que mon crime l’entraîne?
Si je te haïs, eſt-il coupable de ma haine?	Si je te hais, est-il coupable de ma haine?
T’a-t’il de tous les ſiens reproché le treſpas?	T’a-t-il de tous les siens reproché le trépas?
S’eſt-il plaint à tes yeux des maux qu’il ne ſent pas?	S’est-il plaint à tes yeux des maux qu’il ne sent pas?
Mais cependant, mon Fils, tu meurs, ſi je n’arreſte	Mais cependant, mon Fils, tu meurs, si je n’arrête
Le fer, que ce Cruel tient leué ſur ta teſte.	Le fer, que ce Cruel tient levé sur ta tête.
Ie l’en puis détourner, & je t’y vais offrir?	Je l’en puis détourner, et je t’y vais offrir?
Non tu ne mourras point, je ne le puis ſouffrir.	Non tu ne mourras point, je ne le puis souffrir.
Allons trouver Pyrrhus. Mais non, chere Cephiſe,	Allons trouver Pyrrhus. Mais non, chère Céphise,
Va le trouuer pour moy.	Va le trouver pour moi.
Que faut-il que ie diſe?	Que faut-il que je dise?
Dy-luy que de mon Fils l’amour eſt aſſez fort…	Dis-lui que de mon Fils l’amour est assez fort...
Crois-tu que dans ſon cœur il ait juré ſa mort?	Crois-tu que dans son cœur il ait juré sa mort?
L’amour peut-il ſi loin pousser ſa barbarie?	L’amour peut-il si loin pousser sa barbarie?
Madame, il va bien-toſt reuenir en furie.	Madame, il va bientôt revenir en furie.
Hé bien, va l’aſſurer…	Hé bien, va l’assurer...
De quoy? de voſtre foy?	De quoi? De votre foi?
Helas! pour la promettre eſt-elle encore à moy?	Hélas! pour la promettre est-elle encore à moi?
O cendres d’vn Eſpoux! ô Troyens! ô mon Pere!	Ô cendres d’un Époux! ô Troyens! ô mon Père!
O mon Fils, que tes iours couſtent cher à ta Mere!	Ô mon Fils, que tes jours coûtent cher à ta Mère!
Allons.	Allons.
Où donc, Madame, & que reſoluez-vous?	Où donc, Madame? et que résolvez-vous?
Allons, ſur ſon tombeau, conſulter mon Eſpoux.	Allons, sur son tombeau, consulter mon Époux.
Ah! je n’en doute point. C’eſt voſtre Eſpoux, Madame,	Ah! je n’en doute point. C’est votre Époux, Madame,
C’eſt Hector qui produit ce miracle en voſtre ame.	C’est Hector qui produit ce miracle en votre âme.
Il veut que Troye encor ſe puiſſe re-leuer,	Il veut que Troie encor se puisse relever,
Auec cét heureux Fils, qu’il vous fait conſeruer.	Avec cet heureux Fils, qu’il vous fait conserver.
Pyrrhus vous l’a promis. Vous venez de l’entendre,	Pyrrhus vous l’a promis. Vous venez de l’entendre,
Madame, il n’attendoit qu’vn mot pour vous le rendre.	Madame, il n’attendait qu’un mot pour vous le rendre.
Croyez en ſes tranſports. Pere, Sceptre, Alliez,	Croyez-en ses transports. Père, Sceptre, Alliés,
Content de voſtre cœur, il met tout à vos pieds.	Content de votre cœur, il met tout à vos pieds.
Sur luy, ſur tout ſon Peuple il vous rend Souueraine.	Sur lui, sur tout son Peuple il vous rend Souveraine.
Eſt-ce là ce Vainqueur digne de tant de haine?	Est-ce là ce Vainqueur digne de tant de haine?
Déja contre les Grecs plein d’vn noble courroux,	Déjà contre les Grecs plein d’un noble courroux,
Le ſoin de voſtre Fils le touche autant que vous;	Le soin de votre Fils le touche autant que vous;
Il preuient leur fureur, il luy laiſſe ſa Garde,	Il prévient leur fureur, il lui laisse sa Garde,
Pour ne pas l’expoſer luy-meſme il ſe hazarde.	Pour ne pas l’exposer lui-même il se hasarde.
Mais tout s’apreſte au Temple. Et vous auez promis…	Mais tout s’apprête au Temple. Et vous avez promis...
Ouy, je m’y trouuerai. Mais allons voir mon Fils.	Oui, je m’y trouverai. Mais allons voir mon Fils.
Madame, qui vous preſſe? Il ſuffit que ſa veuë	Madame, qui vous presse? Il suffit que sa vue
Deſormais à vos yeux ne ſoit plus deffenduë.	Désormais à vos yeux ne soit plus défendue.
Vous luy pourrez bientoſt prodiguer vos bontez,	Vous lui pourrez bientôt prodiguer vos bontés,
Et vos embraſſemens ne ſeront plus contez.	Et vos embrassements ne seront plus comptés.
Quel plaiſir! d’éleuer vn Enfant qu’on voit craiſtre,	Quel plaisir! d’élever un Enfant qu’on voit craître,
Non plus comme vn Eſclaue éleué pour ſon Maître,	Non plus comme un Esclave élevé pour son Maître,
Mais pour voir auec luy renaiſtre tant de Rois.	Mais pour voir avec lui renaître tant de Rois.
Cephize, allons le voir pour la derniere fois.	Céphise, allons le voir pour la dernière fois.
Que dites-vous? ô Dieux!	Que dites-vous? ô Dieux!
O! ma chere Cephize,	Ô! ma chère Céphise,
Ce n’eſt point auec toy que mon cœur ſe déguiſe.	Ce n’est point avec toi que mon cœur se déguise.
Ta foy dans mon malheur s’eſt montrée à mes yeux.	Ta foi dans mon malheur s’est montrée à mes yeux.
Mais j’ay crû qu’à mon tour tu me connoiſſois mieux.	Mais j’ai cru qu’à mon tour tu me connaissais mieux.
Quoy donc as-tu penſé qu’Andromaque infidelle,	Quoi donc as-tu pensé qu’Andromaque infidèle,
Pûſt trahir vn Eſpoux qui croit reuiure en elle,	Pût trahir un Époux qui croit revivre en elle,
Et que de tant de Morts réueillant la douleur,	Et que de tant de Morts réveillant la douleur,
Le ſoin de mon repos me fiſt troubler le leur?	Le soin de mon repos me fît troubler le leur?
Eſt-ce là cette ardeur tant promiſe à ſa cendre.	Est-ce là cette ardeur tant promise à sa cendre?
Mais ſon Fils periſſoit, il l’a falu défendre?	Mais son Fils périssait, il l’a fallu défendre.
Pyrrhus en m’épouſant s’en déclare l’appuy.	Pyrrhus en m’épousant s’en déclare l’appui.
Il ſuffit. Je veux bien m’en repoſer ſur luy.	Il suffit. Je veux bien m’en reposer sur lui.
Ie ſçay quel eſt Pyrrhus. Violent, mais ſincere,	Je sais quel est Pyrrhus. Violent, mais sincère,
Cephize, il fera plus qu’il n’a promis de faire.	Céphise, il fera plus qu’il n’a promis de faire.
Sur le courroux des Grecs, je m’en repoſe encor,	Sur le courroux des Grecs, je m’en repose encor,
Leur haine va donner vn Pere au Fils d’Hector.	Leur haine va donner un Père au Fils d’Hector.
Ie vais donc, puiſqu’il faut que je me ſacrifie,	Je vais donc, puisqu’il faut que je me sacrifie,
Aſſurer à Pyrrhus le reſte de ma vie.	Assurer à Pyrrhus le reste de ma vie.
Ie vais en receuant ſa foy ſur les Autels,	Je vais en recevant sa foi sur les Autels,
L’engager à mon Fils par des nœuds îmmortels.	L’engager à mon Fils par des nœuds immortels.
Mais auſſi-toſt ma main, à moy ſeule funeſte,	Mais aussitôt ma main, à moi seule funeste,
D’vne infidelle vie abbregera le reſte,	D’une infidèle vie abrégera le reste,
Et ſauuant ma vertu, rendra ce que ie doy,	Et sauvant ma vertu, rendra ce que je dois,
A Pyrrhus, à mon Fils, à mon Eſpoux, à moy.	À Pyrrhus, à mon Fils, à mon Époux, à moi.
Voila de mon amour l’innocent ſtratagéme;	Voilà de mon amour l’innocent stratagème;
Voila ce qu’vn Eſpoux m’a commandé luy-méme.	Voilà ce qu’un Époux m’a commandé lui-même.
I’iray ſeule rejoindre Hector, & mes Ayeux.	J’irai seule rejoindre Hector, et mes Aïeux.
Cephize, c’eſt à toy de me fermer les yeux.	Céphise, c’est à toi de me fermer les yeux.
Ah! ne pretendez pas que je puiſſe ſuruiure.	Ah! ne prétendez pas que je puisse survivre.
Non, non, ie te deffens, Cephize, de me ſuiure.	Non non, je te défends, Céphise, de me suivre.
Ie confie à tes ſoins mon vnique treſor,	Je confie à tes soins mon unique trésor,
Si tu viuois pour moy, vy pour le Fils d’Hector.	Si tu vivais pour moi, vis pour le Fils d’Hector.
De l’eſpoir des Troyens ſeule dépoſitaire,	De l’espoir des Troyens seule dépositaire,
Songe, à combien de Roys tu deuiens neceſſaire.	Songe, à combien de Rois tu deviens nécessaire.
Veille auprés de Pyrrhus. Fay-luy garder ſa foy.	Veille auprès de Pyrrhus. Fais-lui garder sa foi.
S’il le faut, je conſens que tu parles de moy.	S’il le faut, je consens que tu parles de moi .
Fais-luy valoir l’hymen, où ie me ſuis rangée;	Fais-lui valoir l’hymen, où je me suis rangée;
Dy-luy, qu’auant ma mort ie luy fus engagée,	Dis-lui, qu’avant ma mort je lui fus engagée,
Que ſes reſſentimens doiuent eſtre effacez,	Que ses ressentiments doivent être effacés,
Qu’en luy laiſſant mon Fils, c’eſt l’eſtimer aſſez.	Qu’en lui laissant mon Fils, c’est l’estimer assez.
Fay connoiſtre à mon Fils les Heros de ſa Race;	Fais connaître à mon Fils les Héros de sa Race;
Autant que tu pourras, conduy-le ſur leur trace.	Autant que tu pourras, conduis-le sur leur trace.
Dy-luy, par quels exploits leurs noms ont éclaté,	Dis-lui, par quels exploits leurs noms ont éclaté,
Pluſtoſt ce qu’ils ont fait, que ce qu’ils ont eſté.	Plutôt ce qu’ils ont fait, que ce qu’ils ont été.
Parle luy tous les jours des Vertus de ſon Pere,	Parle-lui tous les jours des Vertus de son Père,
Et quelquefois auſſi parle luy de ſa Mere.	Et quelquefois aussi parle-lui de sa Mère.
Mais qu’il ne ſonge plus, Cephize, à nous vanger	Mais qu’il ne songe plus, Céphise, à nous venger,
Nous luy laiſſons vn Maiſtre, il le doit ménager.	Nous lui laissons un Maître, il le doit ménager.
Qu’il ait de ſes Ayeux vn ſouuenir modeſte,	Qu’il ait de ses Aïeux un souvenir modeste,
Il eſt du ſang d’Hector, mais il en eſt le reſte.	Il est du sang d’Hector, mais il en est le reste.
Et pour ce reſte enfin i’ay moy-meſme en vn jour,	Et pour ce reste enfin j’ai moi-même en un jour,
Sacrifié mon ſang, ma haine, & mon amour.	Sacrifié mon sang, ma haine, et mon amour.
Helas!	Hélas!
Ne me ſuis point, ſi ton cœur en allarmes,	Ne me suis point, si ton cœur en alarmes,
Preuoit qu’il ne pourra commander à tes larmes,	Prévoit qu’il ne pourra commander à tes larmes.
On vient. Cache tes pleurs, Cephize, & ſouuiens-toy,	On vient. Cache tes pleurs, Céphise, et souviens-toi,
Que le ſort d’Andromaque eſt commis à ta foy.	Que le sort d’Andromaque est commis à ta foi.
C’eſt Hermionne. Allons, fuyons ſa violence.	C’est Hermione. Allons, fuyons sa violence.
NOn, ie ne puis aſſez admirer ce ſilence.	Non, je ne puis assez admirer ce silence.
Vous vous taiſez, Madame, & ce cruel mépris	Vous vous taisez, Madame, et ce cruel mépris
N’a pas du moindre trouble agité vos eſprits?	N’a pas du moindre trouble agité vos esprits?
Vous ſouſtenez en paix vne ſi rude attaque?	Vous soutenez en paix une si rude attaque?
Vous qu’on voyoit fremir au ſeul nom d’Andro-maque?	Vous qu’on voyait frémir au seul nom d’Andromaque?
Vous qui ſans deſeſpoir ne pouuiez endurer	Vous qui sans désespoir ne pouviez endurer
Que Pyrrhus d’vn regard la vouluſt honorer?	Que Pyrrhus d’un regard la voulût honorer?
Il l’épouſe. Il luy donne auec ſon Diadéme	Il l’épouse. Il lui donne avec son Diadème
La foy, que vous venez de receuoir vous-meſme;	La foi, que vous venez de recevoir vous-même;
Et voſtre bouche encor muette à tant d’ennuy,	Et votre bouche encor muette à tant d’ennui,
N’a pas daigné s’ouurir pour ſe plaindre de luy?	N’a pas daigné s’ouvrir pour se plaindre de lui?
Ah! que ie crains, Madame, vn calme ſi funeſte!	Ah! que je crains, Madame, un calme si funeste!
Et qu’il vaudroit bien mieux…	Et qu’il vaudrait bien mieux...
Fais-tu venir Oreſte!	Fais-tu venir Oreste!
Il vient, Madame, il vient. Et vous pouuez juger,	Il vient, Madame, il vient. Et vous pouvez juger,
Que bien-toſt à vos pieds il alloit ſe ranger.	Que bientôt à vos pieds il allait se ranger.
Preſt à ſeruir toûjours ſans eſpoir de ſalaire,	Prêt à servir toujours sans espoir de salaire,
Vos yeux ne sont que trop aſſurez de luy plaire.	Vos yeux ne sont que trop assurés de lui plaire.
Mais il entre.	Mais il entre.
AH Madame? Eſt-il vray qu’vne fois	Ah Madame? Est-il vrai qu’une fois
Oreſte en vous cherchant obeïſſe à vos lois?	Oreste en vous cherchant obéisse à vos lois?
Ne m’a-t-on point flatté d’vne fauſſe eſperance?	Ne m’a-t-on point flatté d’une fausse espérance?
Auez-vous en effet ſouhaitté ma preſence?	Avez-vous en effet souhaité ma présence?
Croiray-ie que vos yeux à la fin deſarmez	Croirai-je que vos yeux à la fin désarmés
Veulent…	Veulent...
Ie veux ſçauoir, Seigneur, ſi vous m’aimez.	Je veux savoir, Seigneur, si vous m’aimez.
Si je vous aime? O Dieux! mes ſermens, mes parjures,	Si je vous aime? Ô Dieux! mes serments, mes parjures,
Ma fuite, mon retour, mes reſpects, mes injures,	Ma fuite, mon retour, mes respects, mes injures,
Mon deſeſpoir, mes yeux de pleurs toûjours noyez,	Mon désespoir, mes yeux de pleurs toujours noyés,
Quels témoins croirez-vous, ſi vous ne les croyez?	Quels témoins croirez-vous, si vous ne les croyez?
Vangez-moy, je croy tout.	Vengez-moi, je crois tout.
Hé bien allons, Madame.	Hé bien allons, Madame.
Mettons encore vn coup toute la Grece en flame.	Mettons encore un coup toute la Grèce en flamme.
Prenons, en ſignalant mon bras, & voſtre nom,	Prenons, en signalant mon bras, et votre nom,
Vous la place d’Helene, & moy d’Agamemnon.	Vous la place d’Hélène, et moi d’Agamemnon.
De Troye en ce pays réueillons les miſeres,	De Troie en ce pays réveillons les misères,
Et qu’on parle de nous, ainſi que de nos Peres.	Et qu’on parle de nous, ainsi que de nos Pères.
Partons, je ſuis tout preſt.	Partons, je suis tout prêt.
Non, Seigneur, demeurons,	Non, Seigneur, demeurons,
Ie ne veux pas ſi loin porter de tels affrons.	Je ne veux pas si loin porter de tels affronts.
Quoy de mes ennemis couronnant l’inſolence,	Quoi de mes ennemis couronnant l’insolence,
I’irois attendre ailleurs vne lente vengeance,	J’irais attendre ailleurs une lente vengeance,
Et ie m’en remettrois au deſtin des combats,	Et je m’en remettrais au destin des combats,
Qui peut-eſtre à la fin ne me vangeroit pas?	Qui peut-être à la fin ne me vengerait pas?
Ie veux qu’à mon depart toute l’Epire pleure.	Je veux qu’à mon départ toute l’Épire pleure.
Mais ſi vous me vangez, vangez-moydans vne heure.	Mais si vous me vengez, vengez-moi dans une heure.
Tous vos retardemens ſont pour moy des refus.	Tous vos retardements sont pour moi des refus.
Courez au temple. Il faut immoler…	Courez au Temple. Il faut immoler...
Qui?	Qui?
Pyrrhus.	Pyrrhus.
Pyrrhus, Madame?	Pyrrhus, Madame?
Hé! quoy? voſtre haine chancelle?	Hé! quoi? votre haine chancelle?
Ah! courez, & craignez que je ne vous rappelle.	Ah! courez, et craignez que je ne vous rappelle.
N’alleguez point des droits que ie veux oublier.	N’alléguez point des droits que je veux oublier.
Et ce n’eſt pas à vous à le juſtifier.	Et ce n’est pas à vous à le justifier.
Moy, ie l’excuserois? Ah! vos bontez, Madame,	Moi, je l’excuserais? Ah! vos bontés, Madame,
Ont graué trop auant ſes crimes dans mon ame.	Ont gravé trop avant ses crimes dans mon âme.
Vangeons-nous, j’y conſens. Mais par d’autres chemins.	Vengeons-nous, j’y consens. Mais par d’autres chemins.
Soyons ſes Ennemis, & non ſes Aſſaſſins.	Soyons ses Ennemis, et non ses Assassins.
Faiſons de ſa ruine vne juſte Conqueſte.	Faisons de sa ruine une juste Conquête.
Quoy pour réponſe aux Grecs porteray-je ſa teſte?	Quoi pour réponse aux Grecs porterai-je sa tête?
Et n’ay-je pris ſur moy le ſoin de tout l’Eſtat,	Et n’ai-je pris sur moi le soin de tout l’État,
Que pour m’en acquitter par vn Aſſaſſinat?	Que pour m’en acquitter par un Assassinat?
Souffrez, au nom des Dieux, que la Grece s’explique,	Souffrez, au nom des Dieux, que la Grèce s’explique,
Et qu’il meure chargé de la haine publique.	Et qu’il meure chargé de la haine publique.
Souuenez-vous qu’il regne, & qu’vn front couronné…	Souvenez-vous qu’il règne, et qu’un front couronné...
Ne vous ſuffit-il pas que ie l’ay condamné?	Ne vous suffit-il pas que je l’ai condamné?
Ne vous ſuffit-il pas que ma Gloire offenſée	Ne vous suffit-il pas que ma Gloire offensée
Demande vne Victime, à moy ſeule adreſſée;	Demande une Victime, à moi seule adressée;
Qu’Hermionne eſt le prix d’vn Tyran opprimé,	Qu’Hermione est le prix d’un Tyran opprimé,
Que je le hais, enfin, Seigneur, que ie l’aimay?	Que je le hais, enfin, Seigneur, que je l’aimai?
Ie ne m’en cache point. L’ingrat m’auoit ſçeu plaire,	Je ne m’en cache point. L’Ingrat m’avait su plaire,
Soit qu’ainſi l’ordonnaſt mon amour, ou mon Pere,	Soit qu’ainsi l’ordonnât mon amour, ou mon Père,
N’importe. Mais enfin reglez-vous là-deſſus.	N’importe. Mais enfin réglez-vous là-dessus.
Malgré mes vœux, Seigneur, honteuſement deceûs,	Malgré mes vœux, Seigneur, honteusement déçus,
Malgré la juſte horreur que ſon crime me donne,	Malgré la juste horreur que son crime me donne,
Tant qu’il viura, craignez que je ne luy pardonne.	Tant qu’il vivra, craignez que je ne lui pardonne.
Doutez juſqu’à ſa mort d’vn courroux incertain,	Doutez jusqu’à sa mort d’un courroux incertain,
S’il ne meurt aujourd’huy, je puis l’aimer demain.	S’il ne meurt aujourd’hui, je puis l’aimer demain.
Hé bien, il faut le perdre, & préuenir ſa grace.	Hé bien, il faut le perdre, et prévenir sa grâce.
Il faut… Mais cependant, que faut-il que ie faſſe?	Il faut... Mais cependant, que faut-il que je fasse?
Comment puis-je ſi-toſt ſeruir voſtre courroux?	Comment puis-je si tôt servir votre courroux?
Quel chemin iuſqu'à luy peut conduire mes coups?	Quel chemin jusqu’à lui peut conduire mes coups?
A peine ſuis-je encore arriué dans l’Epire,	À peine suis-je encore arrivé dans l’Épire,
Vous voulez par mes mains renuerſer vn Empire.	Vous voulez par mes mains renverser un Empire.
Vous voulez qu’vn Roy meure, & pour ſon chaſtiment,	Vous voulez qu’un Roi meure, et pour son châtiment,
Vous ne donnez qu’vn jour, qu’vne heure, qu’vn moment.	Vous ne donnez qu’un jour, qu’une heure, qu’un moment.
Aux yeux de tout ſon Peuple, il faut que je l’opprime?	Aux yeux de tout son Peuple, il faut que je l’opprime?
Laiſſez-moy vers l’Autel conduire ma Victime.	Laissez-moi vers l’Autel conduire ma Victime.
Ie ne m’en défens plus. Et ie ne veux qu’aller	Je ne m’en défends plus. Et je ne veux qu’aller
Reconnoiſtre la place où ie dois l’immoler.	Reconnaître la place où je dois l’immoler.
Cette Nuit je vous ſers. Cette Nuit ie l’attaque.	Cette Nuit je vous sers. Cette Nuit je l’attaque.
Mais cependant ce Iour il eſpouſe Andromaque.	Mais cependant ce Jour il épouse Andromaque.
Dans le Temple déja le troſne eſt éleué.	Dans le Temple déjà le trône est élevé.
Ma honte eſt confirmée, & ſon Crime acheué.	Ma honte est confirmée, et son Crime achevé.
Enfin qu’attendez-vous? Il vous offre ſa Teſte.	Enfin qu’attendez-vous? Il vous offre sa Tête.
Sans Gardes, ſans défenſe il marche à cette Feſte.	Sans Gardes, sans défense il marche à cette Fête.
Autour du Fils d’Hector il les fait tous ranger.	Autour du Fils d’Hector il les fait tous ranger.
Il s’abandonne au bras qui me voudra vanger.	Il s’abandonne au bras qui me voudra venger.
Voulez-vous, malgré luy, prendre ſoin de ſa vie?	Voulez-vous, malgré lui, prendre soin de sa vie?
Armez auec vos Grecs, tous ceux qui m’ont ſuiuie.	Armez avec vos Grecs, tous ceux qui m’ont suivie.
Souleuez vos Amis. Tous les miens ſont à vous.	Soulevez vos Amis. Tous les miens sont à vous.
Il me trahit, vous trompe, & nous meſpriſe tous.	Il me trahit, vous trompe, et nous méprise tous.
Mais quoy? Déja leur haine eſt égale à la mienne.	Mais quoi? Déjà leur haine est égale à la mienne.
Elle eſpargne à regret l’Eſpoux d’vne Troyenne.	Elle épargne à regret l’Époux d’une Troyenne.
Parlez. Mon Ennemy ne vous peut échapper.	Parlez. Mon Ennemi ne vous peut échapper.
Ou plûtoſt, il ne faut que les laiſſer frapper.	Ou plutôt, il ne faut que les laisser frapper.
Conduiſez, ou ſuiuez vne fureur ſi belle.	Conduisez, ou suivez une fureur si belle.
Reuenez tout couuert du ſang de l’Infidelle.	Revenez tout couvert du sang de l’Infidèle.
Allez, en cét eſtat ſoyez ſeûr de mon cœur.	Allez, en cet état soyez sûr de mon cœur.
Mais, Madame, ſongez…	Mais, Madame, songez...
Ah! c’en eſt trop, Seigneur.	Ah! c’en est trop, Seigneur.
Tant de raiſonnemens offenſent ma colere.	Tant de raisonnements offensent ma colère.
I’ay voulu vous donner les moyens de me plaire,	J’ai voulu vous donner les moyens de me plaire,
Rendre Oreſte content. Mais enfin ie voy bien,	Rendre Oreste content. Mais enfin je vois bien,
Qu’il veut touſiours ſe plaindre, & ne meriter rien.	Qu’il veut toujours se plaindre, et ne mériter rien.
Partez. Allez ailleurs vanter voſtre conſtance,	Partez. Allez ailleurs vanter votre constance,
Et me laiſſez icy le ſoin de ma vangeance.	Et me laissez ici le soin de ma vengeance.
De mes laſches bontez mon courage eſt confus,	De mes lâches bontés mon courage est confus,
Et c’eſt trop en vn iour eſſuyer de refus.	Et c’est trop en un jour essuyer de refus.
Ie m’en vais ſeule au Temple, où leur hymen s’apreſte,	Je m’en vais seule au Temple, où leur hymen s’apprête,
Où vous n’oſez aller meriter ma conqueſte.	Où vous n’osez aller mériter ma conquête.
Là, de mon Ennemy ie ſçauray m’approcher.	Là, de mon Ennemi je saurai m’approcher.
Ie perceray le Cœur, que ie n’ay pû toucher.	Je percerai le Cœur, que je n’ai pu toucher.
Et mes ſanglantes mains ſur moy-meſme tournées,	Et mes sanglantes mains sur moi-même tournées,
Auſſi-toſt, malgré luy, joindront nos deſtinées,	Aussitôt, malgré lui, joindront nos destinées,
Et tout Ingrat qu’il eſt, il me ſera plus doux	Et tout Ingrat qu’il est, il me sera plus doux
De mourir auec luy, que de viure auec vous.	De mourir avec lui, que de vivre avec vous.
Non, ie vous priueray de ce plaiſir funeſte,	Non, je vous priverai de ce plaisir funeste,
Madame. Il ne mourra que de la main d’Oreſte.	Madame. Il ne mourra que de la main d’Oreste.
Vos Ennemis par moy vont vous eſtre immolez.	Vos Ennemis par moi vont vous être immolés.
Et vous reconnoiſtrez mes ſoins, ſi vous voulez.	Et vous reconnaîtrez mes soins, si vous voulez.
Mais que dis-je? Ah plûtoſt! permettez que j’eſpere.	Mais que dis-je? Ah plutôt! permettez que j’espère.
Excuſez vn Amant, que trouble ſa miſere,	Excusez un Amant, que trouble sa misère,
Qui tout preſt d’eſtre heureux, enuie encor le ſort	Qui tout prêt d’être heureux, envie encor le sort
D’vn Ingrat, condamné par vous-meſme à la mort.	D’un Ingrat, condamné par vous-même à la mort.
Allez. De voſtre ſort laiſſez-moy la conduite.	Allez. De votre sort laissez-moi la conduite.
Et que tous vos Vaiſſeaux ſoient preſts pour noſtre fuite.	Et que tous vos Vaisseaux soient prêts pour notre fuite.
VOus vous perdez, Madame. Et vous deuez ſonger…	Vous vous perdez, Madame. Et vous devez songer...
Que ie me perde, ou non, ie ſonge à me vanger.	Que je me perde, ou non, je songe à me venger.
Ie ne ſçay meſme encor, quoy qu’il m’ait pû promettre,	Je ne sais même encor, quoi qu’il m’ait pu promettre,
Sur d’autres que ſur moy, ſi je doy m’en remettre.	Sur d’autres que sur moi, si je dois m’en remettre.
Pyrrhus n’eſt pas coupable à ſes yeux comme aux miens,	Pyrrhus n’est pas coupable à ses yeux, comme aux miens,
Et ie tiendrois mes coups bien plus ſeûrs que les ſiens.	Et je tiendrais mes coups bien plus sûrs que les siens.
Quel plaiſir! de vanger moy-meſme mon injure,	Quel plaisir! de venger moi-même mon injure,
De retirer mon bras teint du ſang du Parjure,	De retirer mon bras teint du sang du Parjure,
Et pour rendre ſa peine & mes plaiſirs plus grands,	Et pour rendre sa peine et mes plaisirs plus grands,
De cacher ma Riuale à ſes regards mourans.	De cacher ma Rivale à ses regards mourants.
Ah! ſi du moins Oreſte, en puniſſant ſon crime,	Ah! si du moins Oreste, en punissant son crime,
Luy laiſſoit le regret de mourir ma Victime.	Lui laissait le regret de mourir ma Victime.
Va le trouuer. Dy-luy qu’il apprenne à l’Ingrat,	Va le trouver. Dis-lui qu’il apprenne à l’Ingrat,
Qu’on l’immole à ma haine, & non pas à l’Eſtat.	Qu’on l’immole à ma haine, et non pas à l’État.
Chere Cleonne cours. Ma vangeance eſt perduë,	Chère Cléone, cours. Ma vengeance est perdue,
S’il ignore, en mourant, que c’eſt moy qui le tuë.	S’il ignore, en mourant, que c’est moi qui le tue.
Ie vous obeïray. Mais qu’eſt-ce que ie voy?	Je vous obéirai. Mais qu’est-ce que je vois?
O Dieux! Qui l’auroit crû, Madame? C’eſt le Roy.	Ô Dieux! Qui l’aurait cru, Madame? C’est le Roi.
Ah! cours apres Oreſte, & dy-luy, ma Cleonne,	Ah! cours après Oreste, et dis-lui, ma Cléone,
Qu’il n’entreprenne rien ſans reuoir Hermionne.	Qu’il n’entreprenne rien sans revoir Hermione.
VOus ne m’attendiez pas, Madame, & ie voy bien	Vous ne m’attendiez pas, Madame, et je vois bien
Que mon abord icy trouble voſtre entretien.	Que mon abord ici trouble votre entretien.
Ie ne viens point armé d’vn indigne artifice	Je ne viens point armé d’un indigne artifice
D’vn voile d’équité couurir mon injuſtice.	D’un voile d’équité couvrir mon injustice.
Il ſuffit, que mon cœur me condamne tout bas,	Il suffit, que mon cœur me condamne tout bas,
Et ie ſoûtiendrois mal ce que ie ne croy pas.	Et je soutiendrais mal ce que je ne crois pas.
I’épouſe vne Troyenne. Oüy, Madame, & j’auouë	J’épouse une Troyenne. Oui, Madame, et j’avoue
Que ie vous ay promis la foy, que ie luy vouë.	Que je vous ai promis la foi, que je lui voue.
Vn autre vous diroit, que dans les champs Troyens	Un autre vous dirait, que dans les champs Troyens
Nos deux Peres ſans nous formerent ces liens,	Nos deux Pères sans nous formèrent ces liens,
Et que ſans conſulter ny mon cœur ny le voſtre,	Et que sans consulter ni mon cœur ni le vôtre,
Nous fuſmes ſans amour engagez l’vn à l’autre.	Nous fûmes sans amour engagés l’un à l’autre.
Mais c’eſt aſſez pour moy que ie me ſois ſoûmis.	Mais c’est assez pour moi que je me sois soumis.
Par mes Ambaſſadeurs mon cœur vous fut promis.	Par mes Ambassadeurs mon cœur vous fut promis.
Loin de les reuoquer, ie voulus y ſouſcrire.	Loin de les révoquer, je voulus y souscrire.
Ie vous vis auec eux arriuer en Epire.	Je vous vis avec eux arriver en Épire.
Et quoy que d’vn autre œil l’éclat victorieux	Et quoique d’un autre œil l’éclat victorieux
Euſt déja préuenu le pouuoir de vos yeux;	Eût déjà prévenu le pouvoir de vos yeux;
Ie ne m’arreſtay point à cette ardeur nouuelle.	Je ne m’arrêtai point à cette ardeur nouvelle.
Ie voulus m’obſtiner à vous eſtre fidelle.	Je voulus m’obstiner à vous être fidèle.
Ie vous receûs en Reine, & iuſques à ce jour,	Je vous reçus en Reine, et jusques à ce jour,
I’ay cru que mes ſermens me tiendroient lieu d’amour.	J’ai cru que mes serments me tiendraient lieu d’amour.
Mais cét amour l’emporte. Et par vn coup funeſte,	Mais cet amour l’emporte. Et par un coup funeste,
Andromaque m’arrache vn cœur qu’elle déteſte.	Andromaque m’arrache un cœur qu’elle déteste.
L’vn par l’autre entraiſnez, nous courons à l’Autel	L’un par l’autre entraînés, nous courons à l’Autel
Nous jurer, malgré nous, vn amour immortel.	Nous jurer, malgré nous, un amour immortel.
Apres cela, Madame, éclatez contre vn Traiſtre,	Après cela, Madame, éclatez contre un Traître,
Qui l’eſt auec douleur, & qui pourtant veut l’eſtre.	Qui l’est avec douleur, et qui pourtant veut l’être.
Pour moy, loin de contraindre vn ſi iuſte courroux,	Pour moi, loin de contraindre un si juste courroux,
Il me ſoulagera peut-eſtre autant que vous.	Il me soulagera peut-être autant que vous.
Donnez-moy tous les noms deſtinez aux Parjures.	Donnez-moi tous les noms destinés aux Parjures.
Ie crains voſtre ſilence, & non pas vos injures,	Je crains votre silence, et non pas vos injures,
Et mon Cœur ſouleuant mille ſecrets teſmoins,	Et mon Cœur soulevant mille secrets témoins,
M’en dira d’autant plus que vous m’en direz moins.	M’en dira d’autant plus que vous m’en direz moins.
Seigneur, dans cét aueu deſpoüillé d’artifice,	Seigneur, dans cet aveu dépouillé d’artifice,
I’aime à voir que du moins vous vous rendiez juſtice,	J’aime à voir que du moins vous vous rendiez justice,
Et que voulant bien rompre vn nœud ſi ſolennel,	Et que voulant bien rompre un nœud si solennel,
Vous vous abandonniez au crime en criminel.	Vous vous abandonniez au crime en criminel.
Eſt-il juſte apres tout, qu’vn Conquerant s’abaiſſe	Est-il juste après tout, qu’un Conquérant s’abaisse
Sous la ſeruile loy de garder ſa promeſſe?	Sous la servile loi de garder sa promesse?
Non, non, la Perfidie a dequoy vous tenter.	Non, non, la Perfidie a de quoi vous tenter.
Et vous ne me cherchez que pour vous en vanter.	Et vous ne me cherchez que pour vous en vanter.
Quoy? Sans que ny ſerment, ny deuoir vous retienne,	Quoi? Sans que ni serment, ni devoir vous retienne,
Rechercher vne Grecque, Amant d’vne Troyenne?	Rechercher une Grecque, Amant d’une Troyenne?
Me quitter, me reprendre, & retourner encor	Me quitter, me reprendre, et retourner encor
De la Fille d’Helene, à la Veuue d’Hector?	De la Fille d’Hélène, à la Veuve d’Hector?
Couronner tour à tour l’Eſclaue, & la Princeſſe,	Couronner tour à tour l’Esclave, et la Princesse,
Immoler Troye aux Grecs, au Fils d’Hector la Grece?	Immoler Troie aux Grecs, au Fils d’Hector la Grèce?
Tout cela part d’vn cœur touſiours maiſtre de ſoy,	Tout cela part d’un cœur toujours maître de soi,
D’vn Heros qui n’eſt point Eſclaue de ſa foy.	D’un Héros qui n’est point Esclave de sa foi.
Pour plaire à voſtre Eſpouſe, il vous faudroit peut-eſtre	Pour plaire à votre Épouse, il vous faudrait peut-être
Prodiguer les doux noms de Parjure, & de Traiſtre.	Prodiguer les doux noms de Parjure, et de Traître.
Voſtre grand cœur ſans doute attend apres mes pleurs,	Votre grand cœur sans doute attend après mes pleurs,
Pour aller dans ſes bras joüir de mes douleurs?	Pour aller dans ses bras jouir de mes douleurs?
Chargé de tant d’honneur il veut qu’on le renuoye?	Chargé de tant d’honneur il veut qu’on le renvoie?
Mais, Seigneur, en vn iour ce ſeroit trop de joye.	Mais, Seigneur, en un jour ce serait trop de joie.
Et ſans chercher ailleurs des titres empruntez,	Et sans chercher ailleurs des titres empruntés,
Ne vous ſuffit-il pas de ceux que vous portez?	Ne vous suffit-il pas de ceux que vous portez?
Du vieux Pere d’Hector la valeur abbattuë	Du vieux Père d’Hector la valeur abattue
Aux pieds de ſa Famille expirante à ſa veuë,	Aux pieds de sa Famille expirante à sa vue,
Tandis que dans ſon ſein voſtre bras enfoncé	Tandis que dans son sein votre bras enfoncé
Cherche vn reſte de ſang que l’âge auoit glacé;	Cherche un reste de sang que l’âge avait glacé;
Dans des ruiſſeaux de ſang Troye ardante plongée,	Dans des ruisseaux de sang Troie ardente plongée,
De voſtre propre main Polyxene eſgorgée	De votre propre main Polyxène égorgée
Aux yeux de tous les Grecs indignez contre vous,	Aux yeux de tous les Grecs indignés contre vous,
Que peut-on refuſer à ces genereux coups?	Que peut-on refuser à ces généreux coups?
Madame, ie ſçay trop, à quel excez de rage	Madame, je sais trop, à quel excès de rage
L’ardeur de vous vanger emporta mon courage.	L’ardeur de vous venger emporta mon courage.
Ie puis me plaindre à vous du ſang que i’ay verſé,	Je puis me plaindre à vous du sang que j’ai versé.
Mais enfin ie conſens d’oublier le paſſé.	Mais enfin je consens d’oublier le passé.
Ie rends graces au Ciel, que voſtre indifference	Je rends grâces au Ciel, que votre indifférence
De mes heureux ſoûpirs m’aprenne l’innocence.	De mes heureux soupirs m’apprenne l’innocence.
Mon cœur, ie le voy bien, trop prompt à ſe geſner,	Mon cœur, je le vois bien, trop prompt à se gêner,
Deuoit mieux vous cõnoiſtre, & mieux s’examiner.	Devait mieux vous connaître, et mieux s’examiner.
Mes remords vous faiſoient vne injure mortelle,	Mes remords vous faisaient une injure mortelle,
Il faut ſe croire aimé, pour ſe croire infidelle.	Il faut se croire aimé, pour se croire infidèle.
Vous ne prétendiez point m’arreſter dans vos fers.	Vous ne prétendiez point m’arrêter dans vos fers.
I’ay craint de vous trahir, peut-eſtre ie vous ſers.	J’ai craint de vous trahir, peut-être je vous sers.
Nos Cœurs n’eſtoient point faits dépendans l’vn de l’autre.	Nos Cœurs n’étaient point faits dépendants l’un de l’autre.
Ie ſuivois mon deuoir, & vous cediez au voſtre.	Je suivais mon devoir, et vous cédiez au vôtre.
Rien ne vous engageoit à m’aimer en effet.	Rien ne vous engageait à m’aimer en effet.
Ie ne t'ay point aimé, Cruel? Qu'ay-je donc fait?	Je ne t’ai point aimé, Cruel? Qu’ai-je donc fait?
I’ay deſdaigné pour toy les vœux de tous nos Princes,	J’ai dédaigné pour toi les vœux de tous nos Princes,
Ie t’ay cherché moy-meſme au fond de tes Prouinces.	Je t’ai cherché moi-même au fond de tes Provinces.
I’y ſuis encor, malgré tes infidelitez,	J’y suis encor, malgré tes infidélités,
Et malgré tous mes Grecs honteux de mes bontez.	Et malgré tous mes Grecs honteux de mes bontés.
Ie leur ay commandé de cacher mon injure,	Je leur ai commandé de cacher mon injure,
I’attendois en ſecret le retour d’vn Parjure,	J’attendais en secret le retour d’un Parjure,
I’ay creu que toſt ou tard à ton deuoir rendu,	J’ai cru que tôt ou tard à ton devoir rendu,
Tu me rapporterois vn Cœur qui m’eſtoit dû.	Tu me rapporterais un Cœur qui m’était dû.
Ie t’aimois inconſtant, qu’aurois-je fait fidelle?	Je t’aimais inconstant, qu’aurais-je fait fidèle?
Et meſme en ce moment, où ta bouche cruelle	Et même en ce moment, où ta bouche cruelle
Vient ſi tranquillement m’annoncer le treſpas,	Vient si tranquillement m’annoncer le trépas,
Ingrat, ie doute encor, ſi ie ne t’aime pas.	Ingrat, je doute encor, si je ne t’aime pas.
Mais, Seigneur, s’il le faut, ſi le Ciel en colere	Mais, Seigneur, s’il le faut, si le Ciel en colère
Reſerue à d’autres yeux la gloire de vous plaire,	Réserve à d’autres yeux la gloire de vous plaire,
Acheuez voſtre hymen, j’y conſens. Mais du moins	Achevez votre hymen, j’y consens. Mais du moins
Ne forcez pas mes yeux d’en eſtre les teſmoins.	Ne forcez pas mes yeux d’en être les témoins.
Pour la derniere fois ie vous parle peut-eſtre,	Pour la dernière fois je vous parle peut-être,
Differez-le d’vn iour, demain vous ſerez maiſtre.	Différez-le d’un jour, demain vous serez maître.
Vous ne reſpondez point. Perfide, ie le voy,	Vous ne répondez point. Perfide, je le vois,
Tu contes les momens que tu perds auec moy.	Tu comptes les moments que tu perds avec moi.
Ton cœur impatient de reuoir ſa Troyenne,	Ton cœur impatient de revoir sa Troyenne ,
Ne ſouffre qu’à regret qu’vn autre t’entretienne,	Ne souffre qu’à regret qu’un autre t’entretienne,
Tu luy parles du cœur, tu la cherches des yeux.	Tu lui parles du cœur, tu la cherches des yeux.
Ie ne te retiens plus, ſauue-toy de ces lieux.	Je ne te retiens plus, sauve-toi de ces lieux.
Va luy jurer la foy, que tu m’auois jurée.	Va lui jurer la foi, que tu m’avais jurée.
Va profaner des Dieux la Majeſté ſacrée.	Va profaner des Dieux la Majesté sacrée.
Ces Dieux, ces juſtes Dieux n’auront pas oublié,	Ces Dieux, ces justes Dieux n’auront pas oublié,
Que les meſmes ſermens auec moy t’ont lié.	Que les mêmes serments avec moi t’ont lié.
Porte aux pieds des Autels ce Cœur qui m’aban-donne.	Porte aux pieds des Autels ce Cœur qui m’abandonne.
Va, cours. Mais crains encor d’y trouver Hermionne.	Va, cours. Mais crains encor d’y trouver Hermione.
SEigneur, vous l’entendez. Gardez de negliger	Seigneur, vous l’entendez . Gardez de négliger
Vne Amante en fureur, qui cherche à ſe vanger.	Une Amante en fureur, qui cherche à se venger.
Elle n’eſt en ces lieux que trop bien appuyée,	Elle n’est en ces lieux que trop bien appuyée,
La querelle des Grecs à la ſienne eſt liée.	La querelle des Grecs à la sienne est liée.
Oreſte l’aime encore. Et peut-eſtre à ce prix…	Oreste l’aime encore. Et peut-être à ce prix...
Andromaque m’attend. Phœnix, garde ſon Fils.	Andromaque m’attend. Phœnix, garde son Fils.
Ov ſuis-je? Qu’ay-je fait? Que dois-je faire encore?	Où suis-je? Qu’ai-je fait? Que dois-je faire encore?
Quel tranſport me ſaiſit? Quel cha-grin me deuore?	Quel transport me saisit? Quel chagrin me dévore?
Errante, & ſans deſſein, ie cours dans ce Palais.	Errante, et sans dessein, je cours dans ce Palais.
Ah! ne puis-je ſçavoir ſi j’aime, ou ſi ie hais!	Ah! ne puis-je savoir si j’aime, ou si je hais!
Le Cruel! De quel œil il m’a congédiée?	Le Cruel! De quel œil il m’a congédiée?
Sans pitié, ſans douleur, au moins eſtudiée.	Sans pitié, sans douleur, au moins étudiée.
Ay-je veû ſes regards ſe troubler vn moment?	Ai-je vu ses regards se troubler un moment?
En ay-je pû tirer vn ſeul gemiſſement?	En ai-je pu tirer un seul gémissement?
Muet à mes ſoupirs, tranquille à mes allarmes,	Muet à mes soupirs, tranquille à mes alarmes,
Sembloit-il ſeulement qu’il euſt part à mes larmes?	Semblait-il seulement qu’il eût part à mes larmes?
Et ie le plains encore? Et pour comble d’ennuy	Et je le plains encore? Et pour comble d’ennui
Mon cœur, mon laſche cœur s’intereſſe pour luy?	Mon cœur, mon lâche cœur s’intéresse pour lui?
Ie tremble au ſeul penſer du coup qui le menaſſe?	Je tremble au seul penser du coup qui le menace?
Et preſte à me vanger ie luy fais déja grace?	Et prête à me venger je lui fais déjà grâce?
Non, ne reuoquons point l’arreſt de mon courroux.	Non, ne révoquons point l’arrêt de mon courroux.
Qu’il periſſe. Auſſi bien il ne vit plus pour nous.	Qu’il périsse. Aussi bien il ne vit plus pour nous.
Le Perfide triomphe, & ſe rit de ma rage.	Le Perfide triomphe, et se rit de ma rage.
Il penſe voir en pleurs diſſiper cét orage.	Il pense voir en pleurs dissiper cet orage.
Il croit que touſiours foible, & d’vn cœur incertain,	Il croit que toujours faible, et d’un cœur incertain,
Ie pareray d’vn bras les coups de l’autre main.	Je parerai d’un bras les coups de l’autre main.
Il juge encor de moy par mes bontez paſſées.	Il juge encor de moi par mes bontés passées.
Mais plûtoſt le Perfide a bien d’autres penſées.	Mais plutôt le Perfide a bien d’autres pensées.
Triomphant dans le Temple, il ne s’informe pas	Triomphant dans le Temple, il ne s’informe pas
Si l’on ſouhaite ailleurs ſa vie, ou ſon treſpas.	Si l’on souhaite ailleurs sa vie, ou son trépas.
Il me laiſſe, l’Ingrat! cét embarras funeſte.	Il me laisse, l’Ingrat! cet embarras funeste.
Non, non, encore vn coup, laiſſons agir Oreſte.	Non, non encore un coup, laissons agir Oreste.
Qu’il meure, puis qu’enfin il a dû le preuoir,	Qu’il meure, puisqu’enfin il a dû le prévoir,
Et puis qu’il m’a forcée enfin à le vouloir.	Et puisqu’il m’a forcée enfin à le vouloir.
A le vouloir? Hé quoy? C’eſt donc moy qui l’ordonne?	À le vouloir? Hé quoi? C’est donc moi qui l’ordonne?
Sa Mort ſera l’effet de l’amour d’Hermionne?	Sa Mort sera l’effet de l’amour d’Hermione?
Ce Prince, dont mon cœur ſe faiſoit autrefois,	Ce Prince, dont mon cœur se faisait autrefois,
Auec tant de plaiſir, redire les Exploits,	Avec tant de plaisir, redire les Exploits,
A qui meſme en ſecret ie m’eſtois deſtinée,	À qui même en secret je m’étais destinée,
Auant qu’on euſt conclu ce fatal hymenée,	Avant qu’on eût conclu ce fatal hyménée,
Ie n’ay donc trauerſé tant de mers, tant d’Eſtats,	Je n’ai donc traversé tant de mers, tant d’États,
Que pour venir ſi loin preparer ſon treſpas,	Que pour venir si loin préparer son trépas,
L’aſſaſſiner, le perdre? Ah deuant qu’il expire…	L’assassiner, le perdre? Ah devant qu’il expire...
AH! qu’ay-je fait, Cleonne? Et que viens-tu me dire?	Ah! qu’ai-je fait, Cléone? Et que viens-tu me dire?
Que fait Pyrrhus?	Que fait Pyrrhus?
Il eſt au comble de ſes vœux,	Il est au comble de ses vœux,
Le plus fier des Mortels, & le plus amoureux.	Le plus fier des Mortels, et le plus amoureux.
Ie l’ay veû vers le Temple, où ſon hymen s’apreſte,	Je l’ai vu vers le Temple, où son hymen s’apprête,
Mener en Conquerant ſa nouuelle Conqueſte,	Mener en Conquérant sa nouvelle Conquête,
Et d’vn œil qui déja deuoroit ſon eſpoir,	Et d’un œil qui déjà dévorait son espoir ,
S’enyurer, en marchant, du plaiſir de la voir.	S’enivrer, en marchant, du plaisir de la voir.
Andromaque, au trauers de mille cris de joye,	Andromaque, au travers de mille cris de joie,
Porte iuſqu’aux Autels le ſouuenir de Troye,	Porte jusqu’aux Autels le souvenir de Troie,
Incapable touſiours d’aimer, & de haïr,	Incapable toujours d’aimer, et de haïr,
Sans joye, & ſans murmure elle ſemble obeïr.	Sans joie, et sans murmure elle semble obéir.
Et l’Ingrat? Iuſqu’au bout il a pouſſé l’outrage?	Et l’Ingrat? Jusqu’au bout il a poussé l’outrage?
Mais as-tu bien, Cleonne, obſerué ſon viſage?	Mais as-tu bien, Cléone, observé son visage?
Gouſte-t’il des plaiſirs tranquilles & parfaits?	Goûte-t-il des plaisirs tranquilles et parfaits?
N’a-t’il point détourné ſes yeux vers le Palais?	N’a-t-il point détourné ses yeux vers le Palais?
Dy-moy, ne t’es-tu point preſentée à ſa veuë?	Dis-moi, ne t’es-tu point présentée à sa vue?
L’Ingrat a-t’il rougy, lors qu’il t’a reconnuë?	L’Ingrat a-t-il rougi, lorsqu’il t’a reconnue?
Son trouble auoüoit-il ſon infidelité?	Son trouble avouait-il son infidélité?
A-t’il iuſqu’à la fin ſoûtenu ſa fierté?	A-t-il jusqu’à la fin soutenu sa fierté?
Madame, il ne voit rien. Son ſalut, & ſa gloire	Madame, il ne voit rien. Son salut, et sa gloire
Semblent eſtre auec vous ſortis de ſa memoire.	Semblent être avec vous sortis de sa mémoire.
Sans ſonger qui le ſuit, Ennemis, ou Sujets,	Sans songer qui le suit, Ennemis, ou Sujets,
Il pourſuit ſeulement ſes amoureux projets.	Il poursuit seulement ses amoureux projets.
Autour du Fils d’Hector il a rangé ſa Garde,	Autour du Fils d’Hector il a rangé sa Garde,
Et croit que c’eſt luy ſeul que le peril regarde.	Et croit que c’est lui seul que le péril regarde.
Phœnix meſme en reſpond, qui l’a conduit exprés	Phœnix même en répond, qui l’a conduit exprès
Dans vn Fort éloigné du Temple, & du Palais.	Dans un Fort éloigné du Temple et du Palais.
Voila, dans ſes transports, le ſeul ſoin qui luy reſte.	Voilà, dans ses transports, le seul soin qui lui reste.
Le Perfide! Il mourra. Mais que t’a dit Oreſte?	Le Perfide! Il mourra. Mais que t’a dit Oreste?
Oreſte, auec ſes Grecs, dans le Temple eſt entré.	Oreste, avec ses Grecs, dans le Temple est entré.
Hé bien? A me vanger n’eſt-il pas preparé?	Hé bien? À me venger n’est-il pas préparé?
Ie ne ſçay.	Je ne sais.
Tu ne ſçais? Quoy donc Oreſte encore,	Tu ne sais? Quoi donc Oreste encore,
Oreſte me trahit?	Oreste me trahit?
Oreſte vous adore.	Oreste vous adore.
Mais de mille remords ſon eſprit combattu	Mais de mille remords son esprit combattu
Croit tantoſt ſon amour, & tantoſt ſa vertu.	Croit tantôt son amour, et tantôt sa vertu.
Il reſpecte en Pyrrhus l’honneur du diadéme.	Il respecte en Pyrrhus l’honneur du diadème.
Il reſpecte en Pyrrhus Achille, & Pyrrhus meſme.	Il respecte en Pyrrhus Achille, et Pyrrhus même.
Il craint les Grecs, il craint l’Vniuers en courroux.	Il craint les Grecs , il craint l’Univers en courroux.
Mais il ſe craint, dit-il, ſoy-meſme plus que tous.	Mais il se craint, dit-il, soi-même plus que tous.
Il voudroit en Vainqueur vous apporter ſa teſte.	Il voudrait en Vainqueur vous apporter sa tête.
Le ſeul nom d’Aſſaſſin l’épouuante & l’arreſte.	Le seul nom d’Assassin l’épouvante et l’arrête.
Enfin il eſt entré, ſans ſçauoir dans ſon cœur,	Enfin il est entré, sans savoir dans son cœur,
S’il en deuoit ſortir Coupable, ou Spectateur.	S’il en devait sortir Coupable, ou Spectateur.
Non, non, il les verra triompher ſans obſtacle,	Non, non, il les verra triompher sans obstacle,
Il ſe gardera bien de troubler ce ſpectacle.	Il se gardera bien de troubler ce spectacle.
Ie ſçay de quels remords ſon courage eſt atteint.	Je sais de quels remords son courage est atteint.
Le laſche craint la mort, & c’eſt tout ce qu’il craint.	Le lâche craint la mort, et c’est tout ce qu’il craint.
Quoy? ſans qu’elle employaſt vne ſeule priere,	Quoi? sans qu’elle employât une seule prière,
Ma Mere en ſa faueur arma la Grece entiere?	Ma Mère en sa faveur arma la Grèce entière?
Ses yeux pour leur querelle, en dix ans de combats,	Ses yeux pour leur querelle, en dix ans de combats,
Virent perir vingt Rois, qu’ils ne connoiſſoient pas?	Virent périr vingt Rois, qu’ils ne connaissaient pas?
Et moy je ne prétens que la mort d’vn Parjure,	Et moi je ne prétends que la mort d’un Parjure,
Et ie charge vn Amant du ſoin de mon injure,	Et je charge un Amant du soin de mon injure,
Il peut me conquerir à ce prix, ſans danger,	Il peut me conquérir à ce prix, sans danger,
Ie me liure moy-meſme, & ne puis me vanger?	Je me livre moi-même, et ne puis me venger?
Allons. C’eſt à moy ſeule, à me rendre juſtice.	Allons. C’est à moi seule, à me rendre justice.
Que de cris de douleur le Temple retentiſſe.	Que de cris de douleur le Temple retentisse.
De leur hymen fatal troublons l’euenement,	De leur hymen fatal troublons l’événement,
Et qu’ils ne ſoient vnis, s’il ſe peut, qu’vn moment.	Et qu’ils ne soient unis, s’il se peut, qu’un moment.
Ie ne choisiray point dans ce deſordre extréme.	Je ne choisirai point dans ce désordre extrême.
Tout me ſera Pyrrhus, fuſt-ce Oreſte luy-meſme.	Tout me sera Pyrrhus, fût-ce Oreste lui-même.
Ie mourray. Mais au moins ma mort me vangera,	Je mourrai. Mais au moins ma mort me vengera,
Ie ne mourray pas ſeule, & quelqu’vn me ſuiura.	Je ne mourrai pas seule, et quelqu’un me suivra.
MAdame, c’en eſt fait. Partons en diligence.	Madame, c’en est fait. Partons en diligence.
Venez dans mes vaiſſeaux goûter voſtre vangeance.	Venez dans mes vaisseaux goûter votre vengeance.
Voyez cette Captiue. Elle peut mieux que moy	Voyez cette Captive. Elle peut mieux que moi
Vous apprendre qu’Oreſte a dégagé ſa foy.	Vous apprendre qu’Oreste a dégagé sa foi.
O Dieux! C’eſt Andromaque?	Ô Dieux! C’est Andromaque?
Oüy, c’est cette Princeſſe	Oui, c’est cette Princesse
Deux fois Veuue, & deux fois l’Eſclaue de la Grece;	Deux fois Veuve, et deux fois l’Esclave de la Grèce;
Mais qui juſque dans Sparte ira vous brauer tous,	Mais qui jusques dans Sparte ira vous braver tous,
Puis qu’elle voit ſon Fils à couuert de vos coups.	Puisqu’elle voit son Fils à couvert de vos coups.
Du crime de Pyrrhus complice manifeſte,	Du crime de Pyrrhus complice manifeste,
I’attens ſon chaſtiment. Car je voy bien qu’Oreſte	J’attends son châtiment. Car je vois bien qu’Oreste
Engagé par voſtre ordre à cét aſſaſſinat,	Engagé par votre ordre à cet assassinat,
Vient de ce triſte exploit vous ceder tout l’éclat.	Vient de ce triste exploit vous céder tout l’éclat.
Ie ne m’attendois pas que le Ciel en colere	Je ne m’attendais pas que le Ciel en colère
Puſt, ſans perdre mon Fils, accroiſtre ma miſere,	Pût, sans perdre mon Fils, accroître ma misère,
Et gardaſt à mes yeux quelque ſpectacle encor,	Et gardât à mes yeux quelque spectacle encor,
Qui fiſt couler mes pleurs pour vn autre qu’Hector.	Qui fît couler mes pleurs pour un autre qu’Hector.
Vous auez trouué ſeule vne ſanglante voye	Vous avez trouvé seule une sanglante voie
De ſuſpendre en mon cœur le ſouvenir de Troye.	De suspendre en mon cœur le souvenir de Troie.
Plus barbare aujourd’huy qu’Achille & que ſon Fils,	Plus barbare aujourd’hui qu’Achille et que son Fils,
Vous me faites pleurer mes plus grands Ennemis;	Vous me faites pleurer mes plus grands Ennemis;
Et ce que n’auoient pû promeſſe, ny menaſſe,	Et ce que n’avaient pu promesse, ni menace,
Pyrrhus de mon Hector ſemble auoir pris la place.	Pyrrhus de mon Hector semble avoir pris la place.
Ie n’ay que trop, Madame, éprouué ſon courroux,	Je n’ai que trop, Madame, éprouvé son courroux,
I’auois plus de ſujet de m’en plaindre que vous.	J’avais plus de sujet de m’en plaindre que vous.
Pour derniere rigueur, ton amitié cruelle,	Pour dernière rigueur, ton amitié cruelle,
Pyrrhus, à mon Epoux me rendoit infidelle.	Pyrrhus, à mon Époux me rendait infidèle.
Ie t’en allois punir. Mais le Ciel m’eſt témoin,	Je t’en allais punir. Mais le Ciel m’est témoin,
Que je ne pouſſois pas ma vangeance ſi loin,	Que je ne poussais pas ma vengeance si loin,
Et ſans verſer ton ſang, ny cauſer tant d’allarmes,	Et sans verser ton sang, ni causer tant d’alarmes,
Il ne t’en euſt couſté peut-eſtre que des larmes.	Il ne t’en eût coûté peut-être que des larmes.
Quoy? Pyrrhus eſt donc mort!	Quoi? Pyrrhus est donc mort!
Oüy, nos Grecs irritez	Oui, nos Grecs irrités
Ont laué dans ſon sang ſes infidelitez.	Ont lavé dans son sang ses infidélités.
Ie vous l’auois promis. Et quoy que mon courage	Je vous l’avais promis. Et quoique mon courage
Se fiſt de ce complot vne funeſte image,	Se fît de ce complot une funeste image,
I’ay couru vers le Temple, où nos Grecs diſperſez	J’ai couru vers le Temple, où nos Grecs dispersés
Se ſont juſqu’à l’Autel dans la foule gliſſez.	Se sont jusqu’à l’Autel dans la foule glissés.
Pyrrhus m’a reconnu. Mais ſans changer de face,	Pyrrhus m’a reconnu. Mais sans changer de face,
Il ſembloit que ma veuë excitaſt ſon audace,	Il semblait que ma vue excitât son audace,
Que tous les Grecs brauez en leur Ambaſſadeur	Que tous les Grecs bravés en leur Ambassadeur
Deuſſent de ſon Hymen releuer la ſplendeur.	Dussent de son Hymen relever la splendeur.
Enfin auec tranſport prenant ſon diadéme,	Enfin avec transport prenant son diadème,
Sur le front d’Andromaque il l’a poſé luy-meſme.	Sur le front d’Andromaque il l’a posé lui-même.
Ie vous donne, a-t’il dit, ma Couronne, & ma Foy;	Je vous donne, a-t-il dit, ma Couronne, et ma Foi;
Andromaque, regnez ſur l’Epire & ſur moy.	Andromaque, régnez sur l’Épire et sur moi.
Ie voüe à voſtre Fils vne amitié de Pere,	Je voue à votre Fils une amitié de Père,
I’en atteſte les Dieux, je le jure à ſa Mere.	J’en atteste les Dieux, je le jure à sa Mère.
Pour tous mes Ennemis je declare les ſiens,	Pour tous mes Ennemis je déclare les siens,
Et je le reconnoy pour le Roy des Troyens.	Et je le reconnais pour le Roi des Troyens.
A ces mots, qui du Peuple attiroient le ſuffrage,	À ces mots, qui du Peuple attiraient le suffrage,
Nos Grecs n’ont répondu que par vn cry de rage,	Nos Grecs n’ont répondu que par un cri de rage,
L’Infidelle s’eſt vû par tout enuelopper,	L’Infidèle s’est vu partout envelopper,
Et je n’ay pû trouuer de place pour frapper.	Et je n’ai pu trouver de place pour frapper.
Chacun ſe diſputoit la gloire de l’abbatre.	Chacun se disputait la gloire de l’abattre.
Ie l’ay veû dans leurs mains quelque temps ſe debattre,	Je l’ai vu dans leurs mains quelque temps se débattre,
Tout ſanglant à leurs coups vouloir ſe dérober,	Tout sanglant à leurs coups vouloir se dérober,
Mais enfin à l’Autel il eſt allé tomber.	Mais enfin à l’Autel il est allé tomber.
Le Troyen eſt ſauué. Mais partons, le temps preſſe.	Le Troyen est sauvé. Mais partons, le temps presse.
L’Epire toſt ou tard ſatisfera la Grece:	L’Épire tôt ou tard satisfera la Grèce:
Cependant j’ay voulu qu’Andromaque aujour-d’huy	Cependant j’ai voulu qu’Andromaque aujourd’hui
Honnoraſt mon triomphe, & répondit de luy.	Honorât mon triomphe, et répondît de lui.
Du Peuple épouuanté la foule fugitiue	Du Peuple épouvanté la foule fugitive
M’a laiſſé ſans obstacle enleuer ma Captiue,	M’a laissé sans obstacle enlever ma Captive ,
Et regagner ces lieux, où bien-toſt nos Amis	Et regagner ces lieux , où bientôt nos Amis
Viendront couuerts du ſang, que je vous ay promis.	Viendront couverts du sang, que je vous ai promis.
Qu’ont-ils fait!	Qu’ont-ils fait!
Pardonnez à leur impatience,	Pardonnez à leur impatience.
Ils ont, je le voy bien, trahy voſtre vangeance.	Ils ont, je le vois bien, trahi votre vengeance.
Vous vouliez que ma main portaſt les premiers coups,	Vous vouliez que ma main portât les premiers coups,
Qu’il ſentiſt en mourant qu’il expiroit pour vous.	Qu’il sentît en mourant qu’il expirait pour vous.
Mais c’eſt moy, dont l’ardeur leur a ſeruy d’exemple,	Mais c’est moi, dont l’ardeur leur a servi d’exemple,
Ie les ay pour vous ſeule entraînez dans le Temple,	Je les ai pour vous seule entraînés dans le Temple,
Madame, & vous pouuez juſtement vous flatter	Madame, et vous pouvez justement vous flatter
D’vne mort, que les Grecs n’ont fait qu’executer.	D’une mort, que les Grecs n’ont fait qu’exécuter.
Vous ſeule auez pouſſé les coups…	Vous seule avez poussé les coups...
Tay-toy, Perfide,	Tais-toi, Perfide,
Et n’impute qu’à toy ton laſche Parricide.	Et n’impute qu’à toi ton lâche Parricide.
Va faire chez tes Grecs admirer ta fureur,	Va faire chez tes Grecs admirer ta fureur,
Va, je la deſauouë, & tu me fais horreur.	Va, je la désavoue, et tu me fais horreur.
Barbare qu’as-tu fait? auec quelle furie	Barbare qu’as-tu fait? avec quelle furie
As-tu tranché le cours d’vne ſi belle vie?	As-tu tranché le cours d’une si belle vie?
Auez-vous pû, Cruels, l’immoler aujourd’huy,	Avez-vous pu, Cruels, l’immoler aujourd’hui,
Sans que tout voſtre ſang ſe ſoûleuaſt pour luy?	Sans que tout votre sang se soulevât pour lui?
Mais parle. De ſon sort qui t’a rendu l’arbitre?	Mais parle. De son sort qui t’a rendu l’arbitre?
Pourquoy l’aſſaſſiner? Qu’a-t'il fait? A quel titre?	Pourquoi l’assassiner? Qu’a-t-il fait? À quel titre?
Qui te l’a dit?	Qui te l’a dit?
O Dieux! Quoy ne m’auez-vous pas	Ô dieux! Quoi ne m’avez-vous pas
Vous-meſme, icy, tantoſt, ordonné ſon trépas?	Vous-même, ici, tantôt, ordonné son trépas?
Ah! Falloit-il en croire vne Amante inſenſée?	Ah! Fallait-il en croire une Amante insensée?
Ne deuois-tu pas lire au fonds de ma penſée?	Ne devais-tu pas lire au fond de ma pensée?
Et ne voyois-tu pas, dans mes emportemens,	Et ne voyais-tu pas dans mes emportements,
Que mon cœur démentoit ma bouche à tous momens?	Que mon cœur démentait ma bouche à tous moments?
Quand je l’aurois voulu, falloit-il y ſouſcrire?	Quand je l’aurais voulu, fallait-il y souscrire?
N’as-tu pas dû cent fois te le faire redire,	N’as-tu pas dû cent fois te le faire redire,
Toy-meſme auant le coup me venir conſulter,	Toi-même avant le coup me venir consulter,
Y reuenir encore, ou plûtoſt m’éuiter?	Y revenir encore, ou plutôt m’éviter?
Que ne me laiſſois-tu le ſoin de ma vangeance?	Que ne me laissais-tu le soin de ma vengeance?
Qui t’ameine en des lieux, où l’on fuit ta preſence?	Qui t’amène en des lieux, où l’on fuit ta présence?
Voila de ton amour le deteſtable fruit.	Voilà de ton amour le détestable fruit.
Tu m’apportois, Cruel, le malheur qui te ſuit.	Tu m’apportais, Cruel, le malheur qui te suit.
C’eſt toy, dont l’Ambaſſade à tous les deux fatale,	C’est toi, dont l’Ambassade à tous les deux fatale,
L’a fait pour ſon malheur pancher vers ma Riuale;	L’a fait pour son malheur pencher vers ma Rivale;
Nous le verrions encor nous partager ſes ſoins,	Nous le verrions encor nous partager ses soins,
Il m’aimeroit peut-eſtre, il le feindroit du moins.	Il m’aimerait peut-être, il le feindrait du moins.
Adieu. Tu peux partir. Ie demeure en Epire,	Adieu. Tu peux partir. Je demeure en Épire,
Ie renonce à la Grece, à Sparte, à ſon Empire,	Je renonce à la Grèce, à Sparte, à son Empire,
A toute ma Famille. Et c’eſt aſſez pour moy,	À toute ma Famille. Et c’est assez pour moi,
Traiſtre, qu’elle ait produit vn monstre comme toy.	Traître, qu’elle ait produit un monstre comme toi.
Allons, Madame, allons. C’eſt moy qui vous déliure.	Allons, Madame, allons. C’est moi qui vous délivre.
Pyrrhus ainſi l’ordonne, & vous pouuez me ſuiure.	Pyrrhus ainsi l’ordonne, et vous pouvez me suivre.
De nos derniers deuoirs allons nous dégager.	De nos derniers devoirs allons nous dégager.
Montrons qui de nous deux ſçaura mieux le vanger.	Montrons qui de nous deux saura mieux le venger.
QVe voy-je? Eſt-ce Hermionne? Et que viens-je d’entendre?	Que vois-je? Est-ce Hermione? Et que viens-je d’entendre?
Pour qui coule le ſang que ie viens de répandre?	Pour qui coule le sang que je viens de répandre?
Ie ſuis, ſi ie l’en crois, vn Traiſtre, vn Aſſaſſin.	Je suis, si je l’en crois, un Traître, un Assassin.
Eſt-ce Pyrrhus qui meurt? & ſuis-je Oreſte enfin?	Est-ce Pyrrhus qui meurt? et suis-je Oreste enfin?
Quoy? j’étouffe en mon cœur la raiſon qui m’éclaire.	Quoi? j’étouffe en mon cœur la raison qui m’éclaire.
I’aſſaſſine à regret vn Roy que je reuere.	J’assassine à regret un Roi que je révère.
Ie viole en vn jour les droits des Souuerains,	Je viole en un jour les droits des Souverains,
Ceux des Ambaſſadeurs, & tous ceux des Humains,	Ceux des Ambassadeurs, et tous ceux des Humains;
Ceux meſme des Autels, où ma fureur l’aſſiege.	Ceux même des Autels, où ma fureur l’assiège.
Ie deuiens Parricide, Aſſaſſin, Sacrilege.	Je deviens Parricide, Assassin, Sacrilège.
Pour qui? Pour vne Ingrate, à qui ie le promets,	Pour qui? Pour une Ingrate, à qui je le promets,
Qui meſme, s’il ne meurt, ne me verra jamais,	Qui même, s’il ne meurt, ne me verra jamais,
Dont j’épouſe la rage. Et quand ie l’ay ſeruie,	Dont j’épouse la rage. Et quand je l’ai servie,
Elle me redemande & ſon ſang & ſa vie!	Elle me redemande et son sang et sa vie!
Elle l’aime! & ie ſuis un monſtre furieux!	Elle l’aime! et je suis un monstre furieux!
Ie la voy pour jamais s’éloigner de mes yeux,	Je la vois pour jamais s’éloigner de mes yeux,
Et l’Ingrate, en fuyant, me laiſſe pour ſalaire	Et l’Ingrate, en fuyant, me laisse pour salaire
Tous les noms odieux que j’ay pris pour luy plaire	Tous les noms odieux que j’ai pris pour lui plaire!
IL faut partir, Seigneur. Sortons de ce Palais,	Il faut partir, Seigneur. Sortons de ce Palais,
Ou bien reſoluons nous de n’en ſortir jamais.	Ou bien résolvons-nous de n’en sortir jamais.
Nos Grecs pour vn moment en défendent la Porte.	Nos Grecs pour un moment en défendent la Porte.
Tout le Peuple aſſemblé nous pourſuit à main forte.	Tout le Peuple assemblé nous poursuit à main forte.
Aux ordres d’Andromaque icy tout eſt ſoûmis,	Aux ordres d’Andromaque ici tout est soumis,
Ils la traitent en Reyne, & nous comme Ennemis.	Ils la traitent en Reine, et nous comme Ennemis.
Andromaque elle meſme à Pyrrhus ſi rebelle,	Andromaque elle-même à Pyrrhus si rebelle,
Luy rend tous les deuoirs d’vne Veuve fidelle,	Lui rend tous les devoirs d’une Veuve fidèle,
Commande qu’on le vange. Et peut-eſtre qu’encor,	Commande qu’on le venge. Et peut-être qu’encore,
Elle pourſuit ſur nous la vangeance d’Hector.	Elle poursuit sur nous la vengeance d’Hector.
Allons. N’attendons pas que l’on nous enuiron-ne,	Allons. N’attendons pas que l’on nous environne,
Nos Grecs nous rejoindront. Et tandis qu’Hermionne	Nos Grecs nous rejoindront. Et tandis qu’Hermione
Tient encore le Peuple autour d’elle arreſté,	Tient encore le Peuple autour d’elle arrêté,
Voila noſtre chemin, ſortons en ſeureté.	Voilà notre chemin, sortons en sûreté.
Non, non, c’eſt Hermionne, Amis, que ie veux ſuivre,	Non, non, c’est Hermione, Amis, que je veux suivre,
A ſon dernier courroux, ie ne puis plus ſuruiure:	À son dernier courroux, je ne puis plus survivre:
Partez, j’ay fait le crime, & ie vais l’expier.	Partez, j’ai fait le crime, et je vais l’expier.
Hermionne, Seigneur? Il la faut oublier.	Hermione, Seigneur? Il la faut oublier.
Quoy touſiours l’inſtrument, & l’objet de ſa rage,	Quoi toujours l’instrument, et l’objet de sa rage,
Cherchez-vous chez les Morts quelque nouuel outrage?	Cherchez-vous chez les Morts quelque nouvel outrage?
Et parce qu’elle meurt, faut-il que vous mouriez?	Et parce qu’elle meurt, faut-il que vous mouriez?
Elle meurt? Dieux. Qu’entens-je!	Elle meurt? Dieux. Qu’entends-je!
Hé quoy? vous l’ignoriez?	Hé quoi? vous l’ignoriez?
En rentrant dans ces lieux nous l’auons rencontrée,	En rentrant dans ces lieux nous l’avons rencontrée,
Qui couroit vers le Temple, inquiete, égarée.	Qui courait vers le Temple, inquiète, égarée.
Elle a trouué Pyrrhus porté ſur des Soldats,	Elle a trouvé Pyrrhus, porté sur des Soldats,
Que ſon ſang excitoit à vanger ſon trépas.	Que son sang excitait à venger son trépas.
Sans doute, à cét objet ſa rage s’eſt émuë.	Sans doute, à cet objet sa rage s’est émue.
Mais du haut de la porte enfin nous l’auons veuë,	Mais du haut de la porte enfin nous l’avons vue,
Vn poignard à la main, ſur Pyrrhus ſe courber,	Un poignard à la main, sur Pyrrhus se courber,
Leuer les yeux au Ciel, ſe frapper, & tomber.	Lever les yeux au Ciel, se frapper, et tomber.
Grace aux Dieux! Mon mal-heur paſſe mon eſperance.	Grâce aux Dieux! Mon malheur passe mon espérance.
Oüy, ie te louë, ô Ciel! de ta perſeuerance.	Oui, je te loue, ô Ciel! de ta persévérance.
Appliqué ſans relaſche au ſoin de me punir,	Appliqué sans relâche au soin de me punir,
Au comble des douleurs tu m’as fait parue-nir.	Au comble des douleurs tu m’as fait parvenir.
Ta haine a pris plaiſir à former ma miſere,	Ta haine a pris plaisir à former ma misère,
I’eſtois né, pour seruir d’exemple à ta colere,	J’étais né, pour servir d’exemple à ta colère,
Pour eſtre du Mal-heur vn modelle accomply;	Pour être du Malheur un modèle accompli;
Hé bien, ie meurs content, & mon ſort eſt remply.	Hé bien, je meurs content, et mon sort est rempli.
Où ſont ces deux Amans? Pour couronner ma joye,	Où sont ces deux Amants? Pour couronner ma joie,
Dans leur ſang, dans le mien, il faut que ie me noye:	Dans leur sang, dans le mien, il faut que je me noie:
L’vn & l’autre en mourant, ie les veux regarder.	L’un et l’autre en mourant, je les veux regarder.
Réüniſſons trois cœurs, qui n’ont pû s’accorder,	Réunissons trois cœurs, qui n’ont pu s’accorder,
Mais quelle épaiſſe nuit tout à coup m’enuironne?	Mais quelle épaisse nuit tout à coup m’environne?
De quel coſté ſortir? D’où vient que ie friſſonne?	De quel côté sortir? D’où vient que je frissonne?
Quelle horeur me ſaiſit? Grace au Ciel, j’entreuoy.	Quelle horreur me saisit? Grâce au Ciel, j’entrevois.
Dieux! Quels ruiſſeaux de ſang coulent autour de moy!	Dieux! Quels ruisseaux de sang coulent autour de moi!
Ah! Seigneur!	Ah Seigneur!
Quoy, Pyrrhus, ie te rencontre encore?	Quoi, Pyrrhus, je te rencontre encore?
Trouueray-je partout vn Riual que j’abhorre?	Trouverai-je partout un Rival que j’abhorre?
Percé de tant de coups comment t’es-tu ſauué?	Percé de tant de coups comment t’es-tu sauvé?
Tiens, tiens, voila le coup que ie t’ay reſerué.	Tiens, tiens, voilà le coup que je t’ai réservé.
Mais que vois-je? A mes yeux Hermionne l’em-braſſe?	Mais que vois-je? À mes yeux Hermione l’embrasse?
Elle vient l’arracher au coup qui le menaſſe?	Elle vient l’arracher au coup qui le menace?
Dieux, quels affreux regards elle jette ſur moy!	Dieux, quels affreux regards elle jette sur moi!
Quels Démons, quels ſerpens traiſne-t’elle apres ſoy?	Quels Démons, quels serpents traîne-t-elle après soi?
Hé bien, Filles d’Enfer, vos mains ſont-elles preſtes?	Hé bien, Filles d’Enfer, vos mains sont-elles prêtes?
Pour qui ſont ces Serpens qui ſifflent ſur vos teſtes?	Pour qui sont ces Serpents qui sifflent sur vos têtes?
A qui deſtinez-vous l’appareil qui vous ſuit?	À qui destinez-vous l’appareil qui vous suit?
Venez-vous m’enleuer dans l’eternelle Nuit?	Venez-vous m’enlever dans l’éternelle Nuit?
Venez, à vos fureurs Oreſte s’abandonne.	Venez, à vos fureurs Oreste s’abandonne.
Mais non, retirez-vous, laiſſez faire Hermionne;	Mais non, retirez-vous, laissez faire Hermione;
L’Ingrate mieux que vous ſçaura me déchirer,	L’Ingrate mieux que vous saura me déchirer,
Et ie luy porte enfin mon cœur à deuorer.	Et je lui porte enfin mon cœur à dévorer.
Il perd le ſentiment. Amis, le temps nous preſſe,	Il perd le sentiment. Amis, le temps nous presse,
Ménageons les momens que ce tranſport nous laiſſe.	Ménageons les moments que ce transport nous laisse.
Sauuons-le. Nos efforts deuiendroient impuiſſans,	Sauvons-le. Nos efforts deviendraient impuissants,
S’il reprenoit icy ſa rage auec ſes ſens.	S’il reprenait ici sa rage avec ses sens.
