MA foy, ſur l’auenir, bien fou qui ſe fiëra.	Ma foi, sur l’avenir, bien fou qui se fiera.
Tel qui rit Vendredy, Dimãche pleurera.	Tel qui rit Vendredi, Dimanche pleurera.
Vn Iuge, l’an paſſé, me prit à ſon ſeruice,	Un Juge, l’an passé, me prit à son service,
Il m’auoit fait venir d’Amiens pour eſtreSuiſſe.	Il m’avait fait venir d’Amiens pour être Suisse.
Tous ces Normans vouloient ſe diuertir de nous,	Tous ces Normands voulaient se divertir de nous,
On apprend à hurler, dit l’autre, auec les Loups.	On apprend à hurler, dit l’autre, avec les loups.
Tout Picard que i’eſtois, i’eſtois vn bon Apoſtre,	Tout Picard que j’étais, j’étais un bon apôtre,
Et ie faiſois claquer mon foüet tout comme vn autre.	Et je faisais claquer mon fouet tout comme un autre.
Tous les plus gros Mõſieurs me parloiẽt chapeau bas.	Tous les plus gros Monsieurs me parlaient chapeau bas.
Monſieur de Petit Iean! ah, gros comme le bras.	Monsieur de Petit-Jean! ah, gros comme le bras.
Mais ſans argent, l’honneur n’eſt qu’vne maladie;	Mais sans argent, l’honneur n’est qu’une maladie;
Ma foy, i’eſtois vn franc Portier de Comedie.	Ma foi j’étais un franc Portier de Comédie.
On auoit beau heurter & m’oſter ſon chapeau,	On avait beau heurter et m’ôter son chapeau,
On n’entroit point chez nous ſans graiſſer le marteau.	On n’entrait point chez nous sans graisser le marteau.
Point d’argẽt, point de Suiſſe, & ma porte eſtoit cloſe.	Point d’argent, point de Suisse, et ma porte était close.
Il eſt vray qu’à Monſieur i’en rendois quelque choſe.	Il est vrai qu’à Monsieur j’en rendais quelque chose.
Nous contions quelquefois. On me donnoit le ſoin	Nous comptions quelquefois. On me donnait le soin
De fournir la maiſon de chandelle & de foin,	De fournir la maison de chandelle et de foin,
Mais ie n’y perdois rien. Enfin vaille que vaille,	Mais je n’y perdais rien. Enfin vaille que vaille,
I’aurois ſur le marché fort bien fourny la paille.	J’aurais sur le marché fort bien fourni la paille.
C’eſt dommage. Il auoit le cœur trop au meſtier,	C’est dommage. Il avait le coeur trop au métier,
Tous les jours le premier aux Plaids, & le dernier,	Tous les jours le premier aux plaids, et le dernier,
Et bien ſouuent tout ſeul; ſi l’on l’euſt voulu croire,	Et bien souvent tout seul; si l’on l’eût voulu croire,
Il y ſeroit couché ſans manger & ſans boire.	Il y serait couché sans manger et sans boire.
Ie luy diſois parfois; Monſieur Perrin Dandin,	Je lui disais parfois; Monsieur Perrin Dandin,
Tout franc, vous vous leuez tous les jours trop matin.	Tout franc, vous vous levez tous les jours trop matin.
Qui veut voyager loin, ménage ſa monture;	Qui veut voyager loin, ménage sa monture;
Beuuez, mangez, dormez, & faiſons feu qui dure.	Buvez, mangez, dormez, et faisons feu qui dure.
Il n’en a tenu conte. Il a ſi bien veillé,	Il n’en a tenu compte. Il a si bien veillé,
Et ſi bien fait, qu’on dit que ſon timbre eſt broüillé.	Et si bien fait, qu’on dit que son timbre est brouillé.
Il nous veut tous juger les vns apres les autres.	Il nous veut tous juger les uns après les autres.
Il marmote toujours certaines Patenoſtres	Il marmotte toujours certaines Patenôtres
Où ie ne comprens rien. Il veut bongré, malgré,	Où je ne comprends rien. Il veut bon gré, mal gré,
Ne ſe coucher qu’en Robbe, & qu’en Bonnet carré.	Ne se coucher qu’en Robe, et qu’en Bonnet carré.
Il fit couper la teſte à ſon Coq de colere,	Il fit couper la tête à son Coq de colère,
Pour l’auoir éueillé plus tard qu’à l’ordinaire:	Pour l’avoir éveillé plus tard qu’à l’ordinaire:
Il diſoit qu’vn Plaideur, dont l’affaire alloit mal,	Il disait qu’un Plaideur, dont l’affaire allait mal,
Auoit graiſſé la patte à ce pauure animal.	Avait graissé la patte à ce pauvre animal.
Depuis ce bel Arreſt, le pauure homme a beau faire,	Depuis ce bel Arrêt, le pauvre homme a beau faire,
Son Fils ne ſouffre plus qu’on luy parle d’affaire,	Son Fils ne souffre plus qu’on lui parle d’affaire,
Il nous le fait garder, jour & nuit, & de prés.	Il nous le fait garder, jour et nuit, et de près.
Autrement ſeruiteur, & mon homme eſt aux Plaids.	Autrement serviteur, et mon homme est aux Plaids.
Pour s’échapper de nous, Dieu ſçait s’il eſt allaigre.	Pour s’échapper de nous, Dieu sait s’il est allègre.
Pour moy, ie ne dors plus. Auſſi ie deuiens maigre,	Pour moi, je ne dors plus. Aussi je deviens maigre,
C’eſt pitié. Ie m’étens, & ne fais que baailler.	C’est pitié. Je m’étends, et ne fais que bâiller.
Mais veille qui voudra, voicy mon oreiller;	Mais veille qui voudra, voici mon oreiller;
Ma foy, pour cette nuit, il faut que ie m’en donne,	Ma foi, pour cette nuit, il faut que je m’en donne,
Pour dormir dans la ruë, on n’offenſe perſonne.	Pour dormir dans la rue, on n’offense personne.
Dormons.	Dormons.
AY, Petit Iean, Petit Iean.	Ay, Petit-Jean, Petit-Jean.
L’Intimé.	L’Intimé.
Il a déja bien peur de me voir enrumé.	Il a déjà bien peur de me voir enrhumé.
Que Diable! ſi matin que fais-tu dans la ruë?	Que Diable! si matin que fais-tu dans la rue?
Es-ce qu’il faut toujours faire le pied de gruë,	Est-ce qu’il faut toujours faire le pied de grue,
Garder toûjours vn homme, & l’entendre crier?	Garder toujours un homme, et l’entendre crier?
Quelle gueule! Pour moy, ie croy qu’il eſt ſorcier.	Quelle gueule! Pour moi, je crois qu’il est sorcier.
Bon!	Bon!
Ie luy diſois donc, en me gratant la teſte,	Je lui disait donc, en me grattant la tête,
Que ie voulois dormir. Préſente ta Requeſte	Que je voulais dormir. Présente ta Requête
Comme tu veux dormir, m’a-t’il dit grauement.	Comme tu veux dormir, m’a-t-il dit gravement.
Ie dors en te contant la choſe ſeulement.	Je dors en te contant la chose seulement.
Bonſoir.	Bonsoir.
Comment bonſoir? Que le Diable m’emporte	Comment bonsoir? Que le Diable m’emporte
Si.... Mais i’entens du bruit au deſſus de la porte.	Si… Mais j’entends du bruit au dessus de la porte.
PEtit Iean. L’Intimé.	PEtit-Jean. L’Intimé.
Paix.	Paix.
Ie ſuis ſeul icy.	Je suis seul ici.
Voila mes Guichetiers en defaut, Dieu Mercy.	Voilà mes Guichetiers en défaut, Dieu Merci.
Si ie leur donne temps, ils pourront compareſtre.	Si je leur donne temps, ils pourront comparaître.
Cà, pour nous élargir, ſautons par la feneſtre.	Çà, pour nous élargir, sautons par la fenêtre.
Hors de Cour.	Hors de cour.
Comme il ſaute.	Comme il saute.
Ho, Monſieur, ie vous tien.	Ho, Monsieur, je vous tiens.
Au voleur, au voleur.	Au voleur, au voleur.
Ho, nous vous tenons bien.	Ho, nous vous tenons bien.
Vous auez beau crier.	Vous avez beau crier.
Main forte. L’on me tuë.	Main-forte. L’on me tue.
VIſte, vn flambeau. I’entens mon Pere dans la ruë.	Vite, un flambeau. J’entends mon Père dans la rue.
Mon Pere, ſi matin qui vous fait déloger?	Mon Père, si matin qui vous fait déloger?
Où courez-vous, la nuit?	Où courez-vous, la nuit?
Ie veux aller juger.	Je veux aller juger.
Et qui juger? Tout dort.	Et qui juger? Tout dort.
Ma foy, ie ne dors gueres.	Ma foi, je ne dors guère.
Que de ſacs! Il en a juſques aux jarretieres.	Que de sacs! Il en a jusques aux jarretières.
Ie ne veux de trois mois rentrer dans la maiſon.	Je ne veux de trois mois rentrer dans la maison.
De ſacs & de procez i’ay fait prouiſion.	De sacs et de procès j’ai fait provision.
Et qui vous nourira?	Et qui vous nourrira?
Le Buuetier, ie penſe.	Le Buvetier, je pense.
Mais où dormirez-vous, mon Pere?	Mais où dormirez-vous, mon Père?
A l’Audiance.	À l’audience.
Non, mon Pere, il vaut mieux que vous ne ſortiez pas.	Non, mon Père, il vaut mieux que vous ne sortiez pas.
Dormez chez vous. Chez vous faites tous vos repas.	Dormez chez vous. Chez vous faites tous vos repas.
Souffrez que la raiſon enfin vous perſuade;	Souffrez que la raison enfin vous persuade;
Et pour voſtre ſanté.....	Et pour votre santé…
Ie veux eſtre malade.	Je veux être malade.
Vous ne l’eſtes que trop. Donnez vous du repos.	Vous ne l’êtes que trop. Donnez-vous du repos.
Vous n’auez tantoſt plus que la peau ſur les os.	Vous n’avez tantôt plus que la peau sur les os.
Du repos? Ah, ſur toy tu veux regler ton Pere.	Du repos? Ah, sur toi tu veux régler ton Père.
Crois-tu qu’vn Iuge n’ait qu’à faire bonne chere,	Crois-tu qu’un Juge n’ait qu’à faire bonne chère,
Qu'à battre le paué comme vn tas de Galans,	Qu’à battre le pavé comme un tas de Galants,
Courir le Bal la nuit, & le jour les Brelans?	Courir le Bal la nuit, et le jour les Brelans?
L’argent ne nous vient pas ſi viſte que l’on penſe.	L’argent ne nous vient pas si vite que l’on pense.
Chacun de tes rubans me couſte vne Sentence.	Chacun de tes rubans me coûte une Sentence.
Ma Robbe vous fait honte. Vn Fils de Iuge? Ah, fy.	Ma Robe vous fait honte. Un fils de Juge! Ah, fi.
Tu fais le Gentilhomme. Hé, Dandin, mon amy,	Tu fais le Gentilhomme. Hé, Dandin, mon ami,
Regarde dans ma chambre, & dans ma garderobbe,	Regarde dans ma chambre, et dans ma garde-robe,
Les portraits des Dandins. Tous ont porté la Robbe,	Les portraits des Dandins. Tous ont porté la Robe,
Et c’eſt le bon party. Compare prix pour prix	Et c’est le bon parti. Compare prix pour prix
Les eſtrennes d’vn Iuge, à celles d’vn Marquis;	Les étrennes d’un Juge, à celles d’un Marquis;
Attens que nous ſoyons à la fin de Decembre.	Attends que nous soyons à la fin de Décembre.
Qu'es-ce qu’vn Gentilhõme? Vn pillier d’antichãbre.	Qu’est-ce qu’un Gentilhomme? Un pilier d’antichambre.
Combien en as-tu veûs, ie dis des plus hupez,	Combien en as-tu vu, je dis des plus huppés,
A ſouffler dans leurs doits dans ma cour occupez,	À souffler dans leurs doigts dans ma cour occupés,
Le manteau ſur le nez, ou la main dans la poche,	La manteau sur le nez, ou la main dans la poche,
Enfin, pour ſe chauffer, venir tourner ma broche.	Enfin, pour se chauffer, venir tourner ma broche.
Voila comme on les traitte. Hé, mon pauure garçon,	Voilà comme on les traite. Hé, mon pauvre garçon,
De ta defunte Mere es-ce-là la leçon?	De ta défunte mère est-ce là la leçon?
La pauure Babonnette! Helas, lors que i’y penſe,	La pauvre Babonnette! Hélas, lorsque j’y pense,
Elle ne manquoit pas vne ſeule Audiance,	Elle ne manquait pas une seule Audience,
Iamais, au grand iamais, elle ne me quitta,	Jamais, au grand jamais, elle ne me quitta,
Et Dieu ſcait bien ſouuent ce qu’elle en rapporta;	Et Dieu sait bien souvent ce qu’elle en rapporta;
Elle euſt du Buuetier emporté les ſeruiettes,	Elle eût du buvetier emporté les serviettes,
Plutoſt que de rentrer au logis les mains nettes.	Plutôt que de rentrer au logis les mains nettes.
Et voila comme on fait les bonnes maiſons. Va,	Et voilà comme on fait les bonnes maisons. Va,
Tu ne ſeras qu’vn ſot.	Tu ne seras qu’un sot.
Vous vous morfondez là,	Vous vous morfondez là,
Mon Pere. Petit Iean, remenez voſtre Maiſtre,	Mon Père. Petit-Jean, ramenez votre Maître,
Couchez-le dans ſon lit, fermez porte, feneſtre,	Couchez-le dans son lit, fermez porte, fenêtre,
Qu'on barricade tout, afin qu’il ait plus chaud.	Qu’on barricade tout, afin qu’il ait plus chaud.
Faites donc mettre au moins des gardefoux là-haut.	Faites donc mettre au moins des garde-fous là-haut.
Quoy, l’on me menera coucher ſans autre forme?	Quoi, l’on me mènera coucher sans autre forme?
Obtenez vn Arreſt comme il faut que ie dorme.	Obtenez un Arrêt comme il faut que je dorme.
Hé, par prouiſion, mon Pere, couchez-vous.	Hé, par provision, mon Père, couchez-vous.
I’iray, mais ie m’en vais vous faire enrager tous,	J’irai, mais je m’en vais vous faire enrager tous.
Ie ne dormiray point.	Je ne dormirai point.
Hé bien, à la bonne heure.	Hé bien, à la bonne heure.
Qu'on ne le quitte point. Toy, l’Intimé, demeure.	Qu’on ne le quitte pas. Toi, l’Intimé, demeure.
IE veux t’entretenir vn moment ſans témoin.	Je veux t’entretenir un moment sans témoin.
Quoy, faut-il vous garder?	Quoi, vous faut-il garder?
I’en aurois bien beſoin.	J’en aurais bon besoin.
I’ay ma folie, helas, auſſi bien que mon Pere.	J’ai ma folie, hélas, aussi bien que mon Père.
Ho! vous voulez juger.	Ho! Vous voulez juger.
Laiſſons-là le myſtere.	Laissons là le mystère.
Tu connois ce Logis.	Tu connais ce logis.
Ie vous entens enfin;	Je vous entends enfin;
Diantre, l’amour vous tient au cœur de bon matin.	Diantre, l’amour vous tient au coeur de bon matin.
Vous me voulez parler ſans doute d’Iſabelle.	Vous me voulez parler sans doute d’Isabelle.
Ie vous l’ay dit cent fois, elle eſt ſage, elle eſt belle;	Je vous l’ai dit cent fois, elle est sage, elle est belle;
Mais vous deuez ſonger que Monſieur Chicanneau,	Mais vous devez songer que Monsieur Chicanneau,
De ſon bien, en procez conſume le plus beau.	De son bien, en procès consume le plus beau.
A qui n’en veut-il point? le croy qu’à l’Audiance	À qui n’en veut-il point? Je crois qu’à l’Audience
Il fera, s’il ne meurt, venir toute la France.	Il fera, s’il ne meurt, venir toute la France.
Tout aupres de ſon Iuge il s’eſt venu loger.	Tout auprès de son Juge il s’est venu loger.
L’vn veut plaider toûjours, l’autre toûjours juger;	L’un veut plaider toujours, l’autre toujours juger;
Et c’eſt vn grand hazard s’il conclud voſtre affaire,	Et c’est un grand hasard s’il conclut votre affaire,
Sans plaider le Curé, le Gendre, & le Notaire.	Sans plaider le Curé, le Gendre, et le Notaire.
Ie le ſçay comme toy. Mais malgré tout cela,	Je le sais comme toi. Mais malgré tout cela,
Ie meurs pour Iſabelle.	Je meurs pour Isabelle.
Hé bien, épouſez-là,	Hé bien, épousez-la,
Vous n’auez qu’à parler, c’eſt vne affaire preſte.	Vous n’avez qu’à parler, c’est une affaire prête.
Hé, cela ne va pas ſi viſte que ta teſte.	Hé, cela ne va pas si vite que ta tête.
Son Pere eſt vn ſauuage, à qui ie ferois peur,	Son Père est un sauvage, à qui je ferais peur,
A moins que d’eſtre Huiſſier, Sergent, ou Procureur;	À moins que d’être Huissier, Sergent, ou Procureur;
On ne voit point ſa Fille. Et la pauure Iſabelle,	On ne voit point sa Fille. Et la pauvre Isabelle,
Inuiſible & dolente, eſt en priſon chez elle,	Invisible et dolente, est en prison chez elle,
Elle voit diſſiper ſa jeuneſſe en regrets,	Elle voit dissiper sa jeunesse en regrets,
Mon amour en fumée, & ſon bien en procez.	Mon amour en fumée, et son bien en procès.
Il la ruinera, ſi l’on le laiſſe faire.	Il la ruinera, si l’on le laisse faire.
Ne connoiſtrois-tu point quelque honneſte Fauſſaire,	Ne connaîtrais-tu point quelque honnête Faussaire,
Qui ſeruiſt ſes amis, en le payant s’entend,	Qui servît ses amis, en le payant s’entend,
Quelque Sergent zelé.	Quelque Sergent zélé.
Bon, l’on en trouue tant.	Bon, l’on en trouve tant.
Mais encor.	Mais encor.
Ah, Monſieur, ſi feu mon pauure Pere	Ah, Monsieur, si feu mon pauvre Père
Eſtoit encor viuant, c’eſtoit bien voſtre affaire.	Était encor vivant, c’était bien votre affaire.
Il gagnoit en vn jour plus qu’vn autre en ſix mois.	Il gagnait en un jour plus qu’un autre en six mois.
Ses rides ſur ſon front grauoient tous ſes Explois.	Ses rides sur son front gravaient tous ses Exploits.
Il vous euſt arreſté le Carroſſe d’vn Prince,	Il vous eût arrêté le Carrosse d’un Prince,
Il vous l’euſt pris luy-meſme; & ſi dans la Prouince	Il vous l’eût pris lui-même; et si dans la Province
Il ſe donnoit en tout vingt coups de nerfs de bœuf,	Il se donnait en tout vingt coups de nerfs de bœuf,
Mon Pere pour ſa part en embourſoit dix-neuf.	Mon Père pour sa part en emboursait dix-neuf.
Mais dequoy s’agit-il? Suis-je pas fils de maiſtre?	Mais de quoi s’agit-il? Suis-je pas fils de maître?
Ie vous ſeruiray.	Je vous servirai.
Toy?	Toi?
Mieux qu’vn Sergent, peut-eſtre.	Mieux qu’un Sergent peut-être.
Tu porterois au Pere vn faux Exploit?	Tu porterais au Père un faux Exploit?
Quoy donc?	Quoi donc?
Tu rendrois à la Fille vn Billet?	Tu rendrais à la Fille un Billet?
Pourquoy non?	Pourquoi non?
Ie ſuis des deux meſtiers.	Je suis des deux métiers.
Vien, ie l’entens qui crie,	Viens, je l'entends qui crie,
Allons à ce deſſein reſver ailleurs.	Allons à ce dessein rêver ailleurs.
LA Brie,	La Brie,
Qu’on garde la maiſon, ie reuiendray bientoſt.	Qu’on garde la maison, je reviendrai bientôt.
Qu’on ne laiſſe monter aucune ame là-haut.	Qu’on ne laisse monter aucune âme là-haut.
Fais porter cette lettre à la Poſte du Maine.	Fais porter cette lettre à la Poste du Maine.
Prens-moy dans ce Clapier trois Lapins de garenne,	Prends-moi dans mon Clapier trois lapins de garenne,
Et chez mon Procureur porte les ce matin.	Et chez mon Procureur porte-les ce matin.
Si ſon Clerc vient ceans, fais luy gouſter mon vin.	Si son Clerc vient céans, fais lui goûter mon vin.
Ah! Donne luy ce ſac qui pend a ma feneſtre.	Ah! Donne-lui ce sac qui pend à ma fenêtre.
Es-ce tout? Il viendra me demander, peut-eſtre,	Est-ce tout? Il viendra me demander, peut-être,
Vn grand homme ſec, là, qui me ſert de témoin,	Un grand homme sec, là, qui me sert de témoin,
Et qui jure pour moy lors que i’en ay beſoin.	Et qui jure pour moi lorsque j’en ai besoin.
Qu'il m’attende. le crains que mon Iuge ne ſorte,	Qu’il m’attende. Je crains que mon Juge ne sorte,
Quatre heures vont ſonner. Mais frappons à ſa porte.	Quatre heures vont sonner. Mais frappons à sa porte.
Qui va là?	Qui va là?
Peut-on voir Monſieur?	Peut-on voir Monsieur?
Non.	Non.
Pourroit-on	Pourrait-on
Dire vn mot à Monſieur ſon Secretaire?	Dire un mot à Monsieur son Secrétaire?
Non.	Non.
Et Monſieur ſon Portier?	Et Monsieur son Portier?
C’eſt moy-meſme.	C’est moi-même.
De grace,	De grâce,
Beuuez à ma ſanté, Monſieur.	Buvez à ma santé, Monsieur.
Graid bien vous faſſe.	Grand bien vous fasse.
Mais reuenez demain.	Mais revenez demain.
Hé rendez donc l’argent.	Hé rendez donc l’argent.
Le Monde eſt deuenu, ſans mentir, bien meſchant.	Le Monde est devenu, sans mentir, bien méchant.
I’ay veû que les procez ne donnoient point de peine,	J’ai vu que les procès ne donnaient point de peine,
Six eſcus en gagnoient vne demy-douzaine.	Six écus en gagnaient une demi-douzaine.
Mais aujourd’huy ie croy que tout mon bien entier	Mais aujourd’hui, je crois que tout mon bien entier
Ne me ſuffiroit pas pour gagner vn Portier.	Ne me suffirait pas pour gagner un Portier.
Mais i’apperçoy venir Madame la Comteſſe	Mais j’aperçois venir Madame la Comtesse
De Pimbeſche. Elle vient pour affaire qui preſſe.	De Pimbesche. Elle vient pour affaire qui presse.
MAdame, on n’entre plus.	Madame, on n’entre plus.
Hé bien, l’ay-je pas dit.	Hé bien, l’ai-je pas dit.
Sans mentir, mes valets me font perdre l’eſprit.	Sans mentir, mes valets me font perdre l’esprit.
Pour les faire leuer, c’eſt en vain que ie gronde,	Pour les faire lever, c’est en vain que je gronde,
Il faut que tous les jours i’éueille tout mon monde.	Il faut que tous les jours j’éveille tout mon monde.
Il faut abſolument qu’il ſe faſſe celer.	Il faut absolument qu’il se fasse celer.
Pour moy, depuis deux jours, ie ne luy puis parler.	Pour moi, depuis deux jours, je ne lui puis parler.
Ma Partie eſt puiſſante, & i’ay lieu de tout craindre.	Ma Partie est puissante, et j’ai lieu de tout craindre.
Apres ce qu’on m’a fait, il ne faut plus ſe plaindre.	Après ce qu’on m’a fait, il ne faut plus se plaindre.
Si pourtant i’ay bon droit.	Si pourtant j’ai bon droit.
Ah, Monſieur, quel Arreſt!	Ah, Monsieur, quel Arrêt!
Ie m’en rapporte à vous. Ecoutez, s’il vous plaiſt.	Je m’en rapporte à vous. Écoutez, s’il vous plaît.
Il faut que vous ſçachiez, Monſieur, la perfidie.	Il faut que vous sachiez, Monsieur, la perfidie.
Ce n’eſt rien dans le fonds.	Ce n’est rien dans le fond.
Monſieur, que ie vous die....	Monsieur, que je vous die…
Voicy le fait. Depuis quinze ou vingt ans en ça,	Voici le fait. Depuis quinze ou vingt ans en çà,
Au trauers d’vn mien pré, certain Aſnon paſſa,	Au travers d’un mien pré, certain Ânon passa,
S’y veautra, non ſans faire vn notable dommage	S’y vautra, non sans faire un notable dommage
Dont, ie formay ma plainte au Iuge du village.	Dont, je formai ma plainte au Juge du village.
Ie fais ſaiſir l’Aſnon. Vn Expert eſt nommé.	Je fais saisir l’Ânon. Un Expert est nommé.
A deux bottes de foin le degaſt eſtimé:	À deux bottes de foin le dégât estimé:
Enfin au bout d’vn an Sentence, par laquelle	Enfin au bout d’un an Sentence par laquelle
Nous ſommes renuoyez hors de Cour. I’en appelle.	Nous sommes renvoyés hors de Cour. J’en appelle.
Pendant qu’à l’Audiance on pourſuit vn Arreſt,	Pendant qu’à l’Audience on poursuit un Arrêt,
Remarquez bien cecy, Madame, s’il vous plaiſt,	Remarquez bien ceci, Madame, s’il vous plaît,
Noſtre amy Drolichon, qui n’eſt pas vne beſte,	Notre ami Drolichon, qui n’est pas une bête,
Obtient pour quelque argent, vn Arreſt ſur requeſte,	Obtient pour quelque argent, un Arrêt sur requête,
Et ie gagne ma cauſe. A cela que fait-on?	Et je gagne ma cause. À cela que fait-on?
Mon Chicaneur s’oppoſe à l’execution.	Mon Chicaneur s’oppose à l’exécution.
Autre incident. Tandis qu’au procez on trauaille,	Autre incident. Tandis qu’au procès on travaille,
Ma Partie en mon pré laiſſe aller ſa volaille,	Ma Partie en mon pré laisse aller sa volaille,
Ordonné qu’il ſera fait rapport à la Cour	Ordonné qu’il sera fait rapport à la Cour
Du foin que peut manger vne poulle en vn jour.	Du foin que peut manger une poule en un jour.
Le tout joint au procez enfin, & toute choſe	Le tout joint au procès enfin, et toute chose
Demeurant en eſtat, on appointe la cauſe	Demeurant en état, on appointe la cause
Le cinquiéme ou ſixiéme Avril cinquante-ſix.	Le cinquième ou sixième Avril cinquante-six.
I’écris ſur nouueaux frais. Ie produis, ie fournis	J’écris sur nouveaux frais. Je produis, je fournis
De Dits, de Contredits, Enqueſtes, Compulſoires,	De dits, de Contredits, Enquêtes, Compulsoires,
Rapports d’Experts, Tranſports, trois Interlocutoires,	Rapports d’Experts, Transports, trois Interlocutoires,
Griefs & Faits nouueaux, Baux & Procez verbaux.	Griefs et Faits nouveaux, Baux, et Procès verbaux.
I’obtiens Lettres Royaux, & ie m’inſcris en Faux.	J’obtiens Lettres Royaux, et je m’inscris en Faux.
Quatorze Apointemens, trente Exploits, ſix Inſtances,	Quatorze Appointements, trente exploits, six Instances,
Six-vingt Productions, vingt Arreſts de Défenſes,	Six-vingt Productions, vingt Arrêts de Défenses,
Arreſt enfin. Ie pers ma cauſe auec deſpens,	Arrêt enfin. Je perds ma cause avec dépens,
Eſtimez enuiron cinq à ſix mille francs.	Estimés environ cinq à six mille francs.
Es-ce là faire droit? Es-ce là comme on juge?	Est-ce là faire droit? Est-ce là comme on juge?
Apres quinze ou vingt ans? Il me reſte vn refuge,	Après quinze ou vingt ans? Il me reste un refuge,
La Requeſte ciuile eſt ouuerte pour moy,	La Requête civile est ouverte pour moi,
Ie ne ſuis pas rendu. Mais vous, comme ie voy,	Je ne suis pas rendu. Mais vous, comme je vois,
Vous plaidez.	Vous plaidez.
Pluſt à Dieu.	Plût à Dieu.
I’y brûleray mes Liures.	J’y brûlerai mes livres.
Ie.....	Je…
Deux bottes de foin cinq à ſix mille liures!	Deux bottes de foin cinq à six mille livres!
Monſieur, tous mes procez alloient eſtre finis.	Monsieur, tous mes procès allaient être finis.
Il ne m’en reſtoit plus que quatre ou cinq petits,	Il ne m’en restait plus que quatre ou cinq petits,
L’vn contre mon Mary, l’autre contre mon Pere,	L’un contre mon Mari, l’autre contre mon Père,
Et contre mes Enfans. Ah, Monſieur, la miſere!	Et contre mes Enfants. Ah, Monsieur, la misère!
Ie ne ſçay quel biais ils ont imaginé,	Je ne sais quel biais ils ont imaginé,
Ny tout ce qu’ils ont fait. Mais on leur a donné	Ni tout ce qu’ils ont fait. Mais on leur a donné
Vn Arreſt, par lequel moy veſtuë & nourrie,	Un Arrêt, par lequel moi vêtue et nourrie,
On me defend, Monſieur, de plaider de ma vie.	On me défend, Monsieur, de plaider de ma vie.
De plaider!	De plaider!
De plaider.	De plaider.
Certes, le trait eſt noir,	Certes, le trait est noir,
I’en ſuis ſurpris.	J’en suis surpris.
Monſieur, i’en ſuis au deſeſpoir.	Monsieur, j’en suis au désespoir.
Comment? Lier les mains aux gens de voſtre ſorte?	Comment? Lier les mains aux gens de votre sorte?
Mais cette penſion, Madame, eſt-elle forte?	Mais cette pension, Madame, est-elle forte?
Ie n’en viurois, Monſieur, que trop honneſtement.	Je n’en vivrais, Monsieur, que trop honnêtement.
Mais viure ſans plaider, es-ce contentement!	Mais vivre sans plaider, est-ce contentement!
Des Chicaneurs viendrõt nous manger juſqu’à l’ame,	Des Chicaneurs viendront nous manger jusqu’à l’âme,
Et nous ne dirons mot? Mais, s’il vous plaiſt, Madame,	Et nous ne dirons mot? Mais s’il vous plaît, Madame,
Depuis quand plaidez-vous?	Depuis quand plaidez-vous?
Il ne m’en ſouuient pas.	Il ne m’en souvient pas.
Depuis trente ans au plus.	Depuis trente ans au plus.
Ce n’eſt pas trop.	Ce n’est pas trop.
Helas!	Hélas!
Et quel âge auez-vous? Vous auez bon viſage.	Et quel âge avez-vous? Vous avez bon visage.
Hé quelques ſoixante ans.	Hé, quelque soixante ans.
Comment, c’eſt le bel âge	Comment, c’est le bel âge
Pour plaider.	Pour plaider.
Laiſſez faire, ils ne ſont pas au bout.	Laissez faire, ils ne sont pas au bout.
I’y vendray ma chemiſe, & ie veux rien, ou tout.	J’y vendrai ma chemise, et je veux rien, ou tout.
Madame, écoutez moy. Voicy ce qu’il faut faire.	Madame, écoutez-moi. Voici ce qu’il faut faire.
Oüy Monſieur, ie vous croy comme mon propre Pere.	Oui Monsieur, je vous crois comme mon propre Père.
I’irois trouuer mon Iuge.	J’irais trouver mon Juge.
Oh, oüy, Monſieur, i’iray.	Oh, oui, Monsieur, j’irai.
Me jetter à ſes pieds.	Me jeter à ses pieds.
Oüy, ie m’y jetteray.	Oui, je m’y jetterai.
Ie l’ay bien reſolu.	Je l’ai bien résolu.
Mais daignez donc m’entendre.	Mais daignez donc m’entendre.
Oüy, vous prenez la choſe, ainſi qu’il la faut prendre.	Oui, vous prenez la chose, ainsi qu’il la faut prendre.
Auez-vous dit, Madame?	Avez-vous dit, Madame?
Oüy, Monſieur.	Oui, Monsieur.
I’irois donc	J'irais donc
Trouuer mon Iuge.	Trouver mon Juge.
Helas, que ce Monſieur eſt bon!	Hélas, que ce Monsieur est bon!
Si vous parlez toûjours, il faut que ie me taiſe.	Si vous parlez toujours, il faut que je me taise.
Ah que vous m’obligez! ie ne me ſens pas d’aiſe.	Ah que vous m’obligez! je ne me sens pas d’aise.
I’irois trouuer mon Iuge, & luy dirois....	J’irais trouver mon Juge, et lui dirais…
Oüy.	Oui.
Voy.	Vois
Et luy dirois, Monſieur....	Et lui dirais, Monsieur…
Oüy, Monſieur.	Oui, Monsieur.
Liez moy.	Liez-moi.
Monſieur, ie ne veux point eſtre liée.	Monsieur, je ne veux point être liée.
A l’autre.	À l’autre.
Ie ne la ſeray point.	Je ne la serai point.
Quelle humeur eſt la voſtre!	Quelle humeur est la vôtre!
Non.	Non.
Vous ne ſçauez pas, Madame, où ie viendray.	Vous ne savez pas, Madame, où je viendrai.
Ie plaideray, Monſieur, ou bien ie ne pourray.	Je plaiderai, Monsieur, ou bien je ne pourrai.
Mais....	Mais…
Mais ie ne veux point, Monſieur, que l’on me lie.	Mais je ne veux point, Monsieur que l’on me lie.
Enfin quand vne femme en teſte à ſa folie....	Enfin quand une femme en tête a sa folie…
Fou, vous-meſme.	Fou, vous-même.
Madame!	Madame!
Et pourquoy me lier?	Et pourquoi me lier?
Madame....	Madame…
Voyez-vous, il ſe rend familier.	Voyez-vous, il se rend familier.
Mais Madame....	Mais, Madame…
Vn craſſeux qui n’a que ſa chicane,	Un crasseux qui n’a que sa chicane,
Veut donner des auis.	Veut donner des avis.
Madame!	Madame!
Auec ſon Aſne.	Avec son Âne.
Vous me pouſſez.	Vous me poussez.
Bon homme, allez garder vos foins.	Bonhomme, allez garder vos foins.
Vous m’excedez.	Vous m’excédez.
Le ſot.	Le sot.
Que n’ay-je des témoins!	Que n’ai-je des témoins!
VOyez le beau ſabbat qu’ils font à noſtre porte.	VOyez le beau sabbat qu’ils font à notre porte.
Meſſieurs, allez plus loin tempeſter de la ſorte.	Messieurs, allez plus loin tempêter de la sorte.
Monſieur, ſoyez témoin....	Monsieur, soyez témoin…
Que Monſieur eſt vn ſot.	Que monsieur est un sot.
Monſieur, vous l’entendez, retenez bien ce mot.	Monsieur, vous l’entendez, retenez bien ce mot.
Ah, vous ne deuiez pas lâcher cette parolle.	Ah, vous ne deviez pas lâcher cette parole.
Vrayment c’eſt bien à luy de me traitter de folle.	Vraiment c’est bien à lui de me traiter de folle.
Folle? Vous auez tort. Pourquoy l’injurier?	Folle? Vous avez tort. Pourquoi l’injurier?
On la conſeille.	On la conseille.
Oh.	Oh.
Oüy, de me faire lier.	Oui, de me faire lier.
Oh, Monſieur.	Oh, Monsieur.
Iuſqu’au bout que ne m’écoute-t’elle?	Jusqu’au bout que ne m’écoute-t-elle?
Oh, Madame.	Oh, Madame.
Qui moy, ſouffrir qu’on me querelle?	Qui moi, souffrir qu’on me querelle?
Vne crieuſe.	Une crieuse.
Hé paix.	Hé paix.
Vn chicaneur.	Un chicaneur.
Hola!	Holà!
Qui n’oſe plus plaider.	Qui n’ose plus plaider.
Que t’importe cela?	Que t’importe cela?
Qu'es-ce qui t’en reuient, fauſſaire abominable?	Qu’est-ce qui t’en revient, faussaire abominable?
Broüillon, voleur.	Brouillon, voleur.
Et bon, & bon, de par le diable,	Et bon, et bon, de par le diable,
Vn Sergent, vn Sergent.	Un Sergent, un Sergent!
Vn Huiſſier, vn Huiſſier.	Un Huissier, un Huissier.
Ma foy, Iuge, & Plaideurs, il faudroit tout lier.	Ma foi, Juge, et Plaideurs, il faudrait tout lier.
MOnsievr, encore vn coup, ie ne puis pas tout faire;	MOnsieur encore un coup, je ne puis pas tout faire;
Puis que ie fais l’Huiſſier, faites le Commiſſaire,	Puisque je fais l’Huissier, faites le Commissaire,
En robbe ſur mes pas il ne faut que venir,	En robe sur mes pas il ne faut que venir,
Vous aurez tout moyen de vous entretenir.	Vous aurez tout moyen de vous entretenir.
Changez en cheueux noirs voſtre perruque blonde.	Changez en cheveux noirs votre perruque blonde.
Ces Plaideurs ſongent-ils que vous ſoyez au monde?	Ces Plaideurs songent-ils que vous soyez au monde?
Hé! Lors qu’à voſtre Pere ils vont faire leur cour,	Hé! Lorsqu’à votre Père ils vont faire leur cour,
A peine ſeulement ſçauez-vous s’il eſt jour.	À peine seulement savez-vous s’il est jour.
Mais n’admirez-vous pas cette bonne Comteſſe	Mais n’admirez-vous pas cette bonne Comtesse
Qu'auec tant de bonheur la fortune m’adreſſe,	Qu’avec tant de bonheur la fortune m’adresse,
Qui dés qu’elle me voit donnant dans le panneau,	Qui dès qu’elle me voit donnant dans le panneau,
Me charge d’vn Exploit pour Monſieur Chicanneau,	Me charge d’un Exploit pour Monsieur Chicanneau,
Et le fait aſſigner pour certaine parolle,	Et le fait assigner pour certaine parole,
Diſant qu’il la voudroit faire paſſer pour folle,	Disant qu’il la voudrait faire passer pour folle,
Ie dy folle à lier, & pour d’autres excez	Je dis folle à lier, et pour d’autres excès
Et blaſphemes, toûjours l’ornement des procez?	Et blasphèmes, toujours l’ornement des procès?
Mais vous ne dites rien de tout mon équipage?	Mais vous ne dites rien de tout mon équipage?
Ay-je bien d’vn Sergent le port & le viſage?	Ai-je bien d’un Sergent le port et le visage?
Ah fort bien.	Ah fort bien.
Ie ne ſçay. Mais ie me ſens enfin	Je ne sais. Mais je me sens enfin
L’ame & le dos ſix fois plus durs que ce matin.	L’âme et le dos six fois plus durs que ce matin.
Quoy qu’il en ſoit, voicy l’Exploit, & voſtre Lettre.	Quoi qu’il en soit, voici l’Exploit, et votre lettre.
Iſabelle l’aura, i’oſe vous le promettre.	Isabelle l’aura, j’ose vous le promettre.
Mais pour faire ſigner le Contract que voicy,	Mais pour faire signer le Contrat que voici,
Il faut que ſur mes pas vous vous rendiez icy.	Il faut que sur mes pas vous vous rendiez ici.
Vous feindrez d’informer ſur toute cette affaire,	Vous feindrez d’informer sur toute cette affaire,
Et vous ferez l’amour en préſence du Pere.	Et vous ferez l’amour en présence du Père.
Mais ne va pas donner l’Exploit pour le Billet.	Mais ne va pas donner l’Exploit pour le Billet.
Le Pere aura l’Exploit, la Fille le Poulet.	Le Père aura l’Exploit, la Fille le Poulet.
Rentrez.	Rentrez.
QVi frappe?	Qui frappe?
Amy. C’eſt la voix d'Iſabelle.	Ami. C’est la voix d’Isabelle.
Demandez-vous quelqu’vn, Monſieur?	Demandez-vous quelqu’un, Monsieur?
Mademoiſelle,	Mademoiselle,
C’eſt vn petit Exploit, que i’oſe vous prier	C’est un petit Exploit, que j’ose vous prier
De m’accorder l’honneur de vous ſignifier.	De m’accorder l’honneur de vous signifier.
Monſieur, excuſez moy, ie n’y puis rien comprendre.	Monsieur, excusez-moi, je n’y puis rien comprendre.
Mon Pere va venir, qui pourra vous entendre.	Mon Père va venir, qui pourra vous entendre.
Il m’eſt donc pas icy, Mademoiſelle?	Il n’est donc pas ici, Mademoiselle?
Non.	Non.
L’Exploit, Mademoiſelle, eſt mis ſous voſtre nom.	L’Exploit, Mademoiselle, est mis sous votre nom.
Monſieur, vous me prenez pour vne autre ſans doute;	Monsieur, vous me prenez pour une autre sans doute;
Sans auoir de procez, ie ſçay ce qu’il en couſte;	Sans avoir de procès, je sais ce qu’il en coûte;
Et ſi l’on n’aimoit pas à plaider plus que moy,	Et si l’on n’aimait pas à plaider plus que moi,
Vos pareils pourroient bien chercher vn autre employ.	Vos pareils pourraient bien chercher un autre emploi.
Adieu.	Adieu.
Mais permettez....	Mais permettez…
Ie ne veux rien permettre.	Je ne veux rien permettre.
Ce n’eſt pas vn Exploit.	Ce n’est pas un Exploit.
Chanſon.	Chanson.
C’eſt vne Lettre.	C'est une Lettre.
Encor moins.	Encor moins.
Mais liſez.	Mais lisez.
Vous ne m’y tenez pas.	Vous ne m'y tenez pas.
C’eſt de Monſieur....	C’est de Monsieur…
Adieu.	Adieu.
Leandre.	Léandre.
Parlez bas.	Parlez bas.
C’eſt de Monſieur?	C’est de Monsieur?
Que diable, on a bien de la peine	Que diable, on a bien de la peine
A ſe faire écouter, ie ſuis tout hors d’haleine.	À se faire écouter, je suis tout hors d’haleine.
Ah, l’Intimé, pardonne à mes ſens étonnez.	Ah, l’Intimé, pardonne à mes sens étonnés.
Donne.	Donne.
Vous me deuiez fermer la porte au nez.	Vous me deviez fermer la porte au nez.
Et qui t’auroit connu déguiſé de la ſorte?	Et qui t’aurait connu déguisé de la sorte?
Mais donne.	Mais donne.
Aux gens de bien ouure-t’on voſtre porte?	Aux gens de bien ouvre-t-on votre porte?
Hé, donne donc?	Hé, donne donc?
La peſte...	La peste…
Oh, ne donnez donc pas.	Oh, ne donnez donc pas.
Auec voſtre Billet, retournez ſur vos pas.	Avec votre Billet, retournez sur vos pas.
Tenez. Vne autre fois ne ſoyez pas ſi pronte.	Tenez. Une autre fois ne soyez pas si prompte.
OVy? le ſuis donc vn ſot, vn voleur, à ſon conte?	OUi? Je suis donc un sot, un voleur, à son compte?
Vn Sergent s’eſt chargé dé la remercier,	Un Sergent s’est chargé de la remercier,
Et ie luy vais ſeruir vn plat de mon meſtier.	Et je lui vais servir un plat de mon métier.
Ie ſerois bien faſché que ce fuſt à refaire,	Je serais bien fâché que ce fût à refaire,
Ny qu’elle m’enuoyaſt aſſigner la premiere.	Ni qu’elle m’envoyât assigner la première.
Mais vn homme icy parle a ma Fille. Comment?	Mais un homme ici parle à ma Fille. Comment?
Elle lit vn Billet? Ah, c’eſt de quelque Amant.	Elle lit un Billet? Ah, c’est de quelque Amant.
Approchons.	Approchons.
Tout de bon, ton Maiſtre eſt-il ſincere?	Tout de bon, ton Maître est-il sincère?
Le croiray-je?	Le croirai-je?
Il ne dort non plus que voſtre Pere,	Il ne dort non plus que votre Père,
Il ſe tourmente. Il vous.... fera voir aujourd’huy	Il se tourmente. Il vous… fera voir aujourd’hui
Que l’on ne gaigne guere à plaider contre luy.	Que l’on ne gagne guère à plaider contre lui.
C’eſt mon Pere. Vraymẽt, vous leur pouuez apprendre,	C’est mon Père. Vraiment, vous leur pouvez apprendre,
Que ſi l’on nous pourſuit, nous ſçaurõs nous défendre.	Que si l’on nous poursuit, nous saurons nous défendre.
Tenez, voila le cas qu’on fait de voſtre Exploit.	Tenez, voilà le cas qu’on fait de votre Exploit.
Comment? C’eſt vn Exploit que ma Fille liſoit?	Comment? C’est un Exploit que ma Fille lisait?
Ah, tu ſeras vn jour l’honneur de ta famille.	Ah, tu seras un jour l’honneur de ta famille.
Tu défendras ton bien. Vien mon ſang, vien ma Fille,	Tu défendras ton bien. Viens, mon sang, viens, ma Fille.
Va, ie t’acheteray le Praticien François.	Va, je t’achèterai Le Praticien Français.
Mais diantre, il ne faut pas déchirer les Exploits.	Mais diantre, il ne faut pas déchirer les Exploits.
Au moins dites leur bien que ie ne les crains guere,	Au moins dites-leur bien que je ne les crains guère,
Ils me feront plaiſir, ie les mets à pis faire.	Ils me feront plaisir, je les mets à pis faire.
Hé! ne te faſche point.	Hé! ne te fâche point.
Adieu, Monſieur.	Adieu, Monsieur.
Or ça.	Or ça.
Verbalizons.	Verbalisons.
Monſieur, de grace, excuſez la.	Monsieur, de grâce, excusez-la.
Elle n’eſt pas inſtruite. Et puis, ſi bon vous ſemble,	Elle n’est pas instruite. Et puis, si bon vous semble,
En voicy les morceaux que ie vais mettre enſemble.	En voici les morceaux que je vais mettre ensemble.
Non.	Non.
Ie le liray bien.	Je le lirai bien.
Ie ne ſuis pas meſchant,	Je ne suis pas méchant,
I'en ay ſur moy copie.	J’en ai sur moi copie.
Ah! le trait eſt touchant.	Ah! le trait est touchant.
Mais ie ne ſçay pourquoy, plus ie vous enuiſage,	Mais je ne sais pourquoi, plus je vous envisage,
Et moins ie me remets, Monſieur, voſtre viſage.	Et moins je me remets, Monsieur, votre visage.
Ie connoy force Huiſſiers.	Je connais force huissiers.
Informez vous de moy,	Informez-vous de moi,
Ie m’acquitte aſſez bien de mon petit employ.	Je m’acquitte assez bien de mon petit emploi.
Soit. Pour qui venez vous?	Soit. Pour qui venez-vous?
Pour vne braue Dame,	Pour une brave Dame,
Monſieur, qui vous honnore, & de toute ſon ame	Monsieur, qui vous honore, et de toute son âme
Voudroit que vous vinſſiez à ma ſommation	Voudrait que vous vinssiez à ma sommation
Luy faire vn petit mot de reparation.	Lui faire un petit mot de réparation.
De reparation? Ie n’ay bleſſé perſonne.	De réparation? Je n’ai blessé personne.
Ie le croy, vous auez, Monſieur, l’ame trop bonne.	Je le crois, vous avez, Monsieur, l’âme trop bonne.
Que demandez-vous donc?	Que demandez-vous donc?
Elle voudroit, Monſieur,	Elle voudrait, Monsieur,
Que deuant des témoins vous luy fiſſiez l’honneur	Que devant des témoins vous lui fissiez l’honneur
De l’auoüer pour ſage, & point extrauagante.	De l’avouer pour sage, et point extravagante.
Parbleu c’eſt ma Comteſſe.	Parbleu, c’est ma Comtesse.
Elle eſt voſtre ſeruante.	Elle est votre servante.
Ie ſuis ſon ſeruiteur.	Je suis son serviteur.
Vous eſtes obligeant,	Vous êtes obligeant,
Monſieur.	Monsieur.
Oüy, vous pouuez l’aſſurer qu’vn Sergent	Oui, vous pouvez l’assurer qu’un Sergent
Luy doit porter pour moy tout ce qu’elle demande.	Lui doit porter pour moi tout ce qu’elle demande.
Hé quoy donc? Les battus, ma foy, payront l'amende.	Hé quoi donc? Les battus, ma foi, paieront l’amende.
Voyons ce qu’elle chante. Hon.... Sixiéme Ianuier,	Voyons ce qu’elle chante. Hon… Sixième Janvier.
Pour auoir fauſſement dit qu'il falloit lier,	Pour avoir faussement dit, qu’il fallait lier,
Eſtant à ce porté par eſprit de chicane,	Étant à ce porté par esprit de chicane,
Haute & puiſſante Dame Yolande Cudaſne,	Haute et puissante Dame Yolande Cudasne,
Comteſſe de Pimbeſche, Orbeſche; & cœtera.	Comtesse de Pimbesche, Orbesche; et cetera.
Il ſoit dit que ſur l'heure il ſe tranſportera	Il soit dit que sur l’heure il se transportera
Au logis de la Dame, & là d’vne voix claire,	Au logis de la Dame, et là d’une voix claire,
Deuant quatre témoins aſſiſtez d'vn Notaire,	Devant quatre témoins assistés d’un Notaire,
Zeſte, ledit Hieroſme auoüera hautement	Zeste, ledit Hiérome avouera hautement
Qu'il la tient pour ſenſée & de bon jugement.	Qu’il la tient pour sensée et de bon jugement.
Le Bon. C’eſt donc le nom de voſtre Seigneurie?	Le Bon. C’est donc le nom de votre Seigneurie?
Pour vous ſeruir. Il faut payer d’effronterie.	Pour vous servir. Il faut payer d’effronterie.
Le Bon? Iamais Exploit ne fut ſigné le Bon.	Le Bon? Jamais Exploit ne fut signé le Bon.
Monſieur le Bon.	Monsieur le Bon.
Monſieur.	Monsieur.
Vous eſtes vn frippon.	Vous êtes un fripon.
Monſieur, pardõnez moy, ie ſuis fort hõneſte homme.	Monsieur, pardonnez-moi, je suis fort honnête homme.
Mais frippon le plus franc qui ſoit de Caen à Rome.	Mais fripon le plus franc qui soit de Caen à Rome.
Monſieur, ie ne ſuis pas pour vous deſauoüer.	Monsieur, je ne suis pas pour vous désavouer.
Vous aurez la bonté de me le bien payer.	Vous aurez la bonté de me le bien payer.
Moy payer? En ſoufflets.	Moi payer? En soufflets.
Vous eſtes trop honneſte,	Vous êtes trop honnête,
Vous me le payerez bien.	Vous me le paierez bien.
Oh, tu me romps la teſte.	Oh, tu me romps la tête.
Tien, voila ton payement.	Tiens, voilà ton paiement.
Vn ſoufflet! Eſcriuons.	Un soufflet! Écrivons.
Lequel Hieroſme, apres pluſieurs rebellions,	Lequel Hiérome, après plusieurs rébellions,
Auroit atteint, frappé; moy Sergent, à la jouë,	Aurait atteint, frappé; moi Sergent, à la joue,
Et fait tomber du coup, mon chapeau dans la bouë.	Et fait tomber du coup, mon chapeau dans la boue.
Ajouſte cela.	Ajoute cela.
Bon, c’eſt de l’argent contant,	Bon, c’est de l’argent comptant,
I’en auois bien beſoin. Et de ce non contant,	J’en avais bien besoin. Et de ce non content,
Auroit auec le pied reiteré. Courage.	Aurait avec le pied réitéré. Courage.
Outre plus. Le ſuſdit ſeroit venu de rage,	Outre plus. Le susdit serait venu de rage,
Pour lacerer le dit préſent Procez verbal.	Pour lacérer ledit présent Procès-verbal. »
Allons, mon cher Monſieur, cela ne va pas mal.	Allons, mon cher Monsieur, cela ne va pas mal.
Ne vous relaſchez point.	Ne vous relâchez point.
Coquin.	Coquin.
Ne vous déplaiſe,	Ne vous déplaise,
Quelques coups de baſton, & ie ſuis à mon aiſe.	Quelques coups de bâton, et je suis à mon aise.
Ouy-da. Ie verray bien s’il eſt Sergent.	Oui-dà. Je verrai bien s’il est Sergent.
Toſt donc,	Tôt donc,
Frappez. I’ay quatre Enfans à nourrir.	Frappez. J’ai quatre enfants à nourrir.
Ah, pardon.	Ah, pardon.
Monſieur, pour vn Sergent ie ne pouuois vous prẽdre;	Monsieur, pour un Sergent je ne pouvais vous prendre;
Mais le plus habile homme enfin peut ſe méprendre,	Mais le plus habile homme enfin peut se méprendre,
Ie ſçauray reparer ce ſoupçon outrageant.	Je saurai réparer ce soupçon outrageant.
Oüy, vous eſtes Sergent, Monſieur, & tres-Sergent.	Oui, vous êtes Sergent, Monsieur, et très Sergent.
Touchez là. Vos pareils ſont gens que ie reuere,	Touchez là. Vos pareils sont gens que je révère,
Et i’ay toujours eſté nourry par feu mon Pere,	Et j’ai toujours été nourri par feu mon Père,
Dans la crainte de Dieu, Monſieur, & des Sergens.	Dans le crainte de Dieu, Monsieur, et des Sergents.
Non, à ſi bon marché l’on ne bat point les gens.	Non, à si bon marché l’on ne bat point les gens.
Monſieur, point de procez.	Monsieur, point de procès.
Seruiteur. Coutumace,	Serviteur. Contumace,
Baſton leué, ſoufflet, coup de pied. Ah!	Bâton levé, soufflet, coup de pied. Ah!
De grace,	De grâce,
Rendez les moy plûtoſt.	Rendez-les moi plutôt.
Suffit qu’ils ſoient receûs,	Suffit qu’ils soient reçus,
Ie ne les voudrois pas donner pour mille eſcus.	Je ne les voudrais pas donner pour mille écus.
VOicy fort à propos Monſieur le Commiſſaire.	VOici fort à propos Monsieur le Commissaire.
Monſieur, voſtre préſence eſt icy neceſſaire.	Monsieur, votre présence est ici nécessaire.
Tel que vous me voyez, Monſieur icy préſent	Tel que vous me voyez, Monsieur ici présent
M’a d’vn fort grand ſoufflet fait vn petit préſent.	M’a d’un fort grand soufflet fait un petit présent.
A vous, Monſieur?	À vous, Monsieur?
A moy, parlant à ma perſonne.	À moi, parlant à ma personne.
Item, vn coup de pied; plus, les noms qu’il me donne.	Item, un coup de pied; plus, les noms qu’il me donne.
Auez-vous des témoins?	Avez-vous des témoins?
Monſieur, taſtez plûtoſt,	Monsieur, tâtez plutôt,
Le ſoufflet ſur ma jouë eſt encore tout chaud.	Le soufflet sur ma joue est encore tout chaud.
Pris en flagrant delit. Affaire criminelle.	Pris en flagrant délit. Affaire criminelle.
Foin de moy.	Foin de moi.
Plus, ſa Fille, au moins ſoy diſant telle,	Plus, sa Fille, au moins soi-disant telle,
A mis vn mien papier en morceaux, proteſtant	A mis un mien papier en morceaux, protestant
Qu'on luy feroit plaiſir, & que d’vn œil content	Qu’on lui ferait plaisir, et que d’un œil content
Elle nous défioit.	Elle nous défiait.
Faites venir la Fille.	Faites venir la Fille.
L’eſprit de coutumace eſt dans cette famille.	L’esprit de contumace est dans cette famille.
Il faut abſolument qu’on m’ait enſorcelé;	Il faut absolument qu’on m’ait ensorcelé;
Si i’en connoy pas-vn, ie veux eſtre étranglé.	Si j’en connais pas un, je veux être étranglé.
Comment, battre vn Huiſſier? Mais voicy la Rebelle.	Comment, battre un Huissier? Mais voici la Rebelle.
Vous le reconnoiſſez.	Vous le reconnaissez.
Hé bien, Mademoiſelle,	Hé bien, Mademoiselle,
C’eſt donc vous qui tantoſt brauiez noſtre Officier,	C’est donc vous qui tantôt braviez notre Officier,
Et qui ſi hautement oſez nous défier?	Et qui si hautement osez nous défier?
Voſtre nom?	Votre nom?
Iſabelle.	Isabelle.
Ecriuez. Et voſtre âge?	Écrivez. Et votre âge?
Dix-huit ans.	Dix-huit ans.
Elle en a quelque peu dauantage,	Elle en a quelque peu davantage,
Mais n’importe.	Mais n’importe.
Eſtes-vous en pouuoir de Mary?	Êtes-vous en pouvoir de Mari?
Non, Monſieur.	Non, Monsieur.
Vous riez? Ecriuez qu’elle a ry.	Vous riez? Écrivez qu’elle a ri.
Monſieur, ne parlons point de Marys à des Filles;	Monsieur, ne parlons point de Maris à des Filles;
Voyez-vous, ce ſont là des ſecrets de familles.	Voyez-vous, ce sont là des secrets de familles.
Mettez qu’il interromp.	Mettez qu’il interrompt.
Hé ie n’y penſois pas.	Hé je n’y pensais pas.
Prens bien garde, ma Fille, à ce que tu diras.	Prends bien garde, ma Fille, à ce que tu diras.
Là, ne vous troublez point. Répondez à voſtre aiſe,	Là, ne vous troublez point. Répondez à votre aise,
On ne veut pas rien faire icy qui vous déplaiſe.	On ne veut pas rien faire ici qui vous déplaise.
N’auez-vous pas reçeû de l’Huiſſier que voila	N’avez-vous pas reçu de l’Huissier que voilà
Certain papier tantoſt?	Certain papier tantôt?
Oüy, Monſieur.	Oui, Monsieur.
Bon cela.	Bon cela.
Auez-vous déchiré ce papier ſans le lire?	Avez-vous déchiré ce papier sans le lire?
Monſieur, ie l’ay leû.	Monsieur, je l’ai lu.
Bon.	Bon.
Continuez d’écrire.	Continuez d’écrire.
Et pourquoy l’auez-vous déchiré?	Et pourquoi l’avez-vous déchiré?
I’auois peur	J'avais peur
Que mon Pere ne priſt l’affaire trop à cœur,	Que mon Père ne prît l’affaire trop à coeur,
Et qu’il ne s’échauffaſt le ſang à ſa lecture.	Et qu’il ne s’échauffât le sang à sa lecture.
Et tu fuis les procez? c’eſt meſchanceté pure.	Et tu fuis les procès? c’est méchanceté pure.
Vous ne l’auez donc pas déchiré par dépit,	Vous ne l’avez donc pas déchiré par dépit,
Ou par mépris de ceux qui vous l’auoient écrit?	Ou par mépris de ceux qui vous l’avaient écrit?
Monſieur, ie n’ay pour eux ny mépris, ny colere.	Monsieur, je n’ai pour eux ni mépris, ni colère.
Ecriuez.	Écrivez.
Je vous dis qu’elle tient de son père	Je vous dis qu’elle tient de son père
Elle répond fort bien.	Elle répond fort bien.
Vous montrez cependant	Vous montrez cependant
Pour tous les gens de robbe vn mépris éuident.	Pour tous les gens de robe un mépris évident.
Vne robbe toûjours m’auoit choqué la veuë;	Une robe toujours m’avait choqué la vue;
Mais cette auerſion à preſent diminuë.	Mais cette aversion à présent diminue.
La pauure Enfant! Va, va, ie te mariëray bien	La pauvre Enfant! Va, va, je te marierai bien
Dés que ie le pourray, s’il ne m’en couſte rien.	Dès que je le pourrai, s’il ne m’en coûte rien.
A la Iuſtice donc vous voulez ſatisfaire?	À la Justice donc vous voulez satisfaire?
Monſieur, ie feray tout, pour ne vous pas déplaire.	Monsieur, je ferai tout, pour ne vous pas déplaire.
Monſieur, faites ſigner.	Monsieur, faites signer.
Dans les occaſions	Dans les occasions
Soûtiendrez-vous au moins vos dépoſitions?	Soutiendrez-vous aux moins vos dépositions?
Monſieur, aſſurez-vous qu’Iſabelle eſt conſtante.	Monsieur, assurez-vous qu’Isabelle est constante.
Signez. Cela va bien, la Iuſtice eſt contente.	Signez. Cela va bien, la Justice est contente.
Ca, ne ſignez-vous pas, Monſieur?	Ça, ne signez-vous pas, Monsieur?
Oüy-dà, gayement,	Oui-dà, gaiement,
A tout ce qu’elle a dit, ie ſigne aueuglement.	À tout ce qu’elle a dit, je signe aveuglément.
Tout va bien. A mes vœux le ſuccés eſt conforme,	Tout va bien. À mes voeux le succès est conforme,
Il ſigne vn bon Contract écrit en bonne forme,	Il signe un bon Contrat écrit en bonne forme,
Et ſera condamné tantoſt ſur ſon écrit.	Et sera condamné tantôt sur son écrit.
Que luy dit-il? Il eſt charmé de ſon eſprit.	Que lui dit-il? Il est charmé de son esprit.
Adieu. Soyez toûjours auſſi ſage que belle,	Adieu. Soyez toujours aussi sage que belle,
Tout ira bien. Huiſſier, remenez-la chez elle.	Tout ira bien. Huissier, ramenez-la chez elle.
Et vous, Monſieur, marchez.	Et vous, Monsieur, marchez.
Où, Monſieur?	Où Monsieur?
Suiuez moy.	Suivez-moi.
Où donc?	Où donc?
Vous le ſçaurez. Marchez, de par le Roy.	Vous le saurez. Marchez, de par le Roi.
Comment?	Comment?
HOlà, quelqu’vn n’a-t’il point veu mon Maiſtre?	HOlà, quelqu’un n’a-t-il point vu mon Maître?
Quel chemin a-t’il pris? la porte, ou la feneſtre?	Quel chemin a-t-il pris, la porte ou la fenêtre?
A l’autre.	À l’autre.
Ie ne ſçay qu’eſt deuenu ſon Fils.	Je ne sais qu’est devenu son Fils.
Et pour le Pere, il eſt où le Diable l’a mis.	Et pour le Père, il est où le Diable l’a mis.
Il me redemandoit ſans ceſſe ſes Epices,	Il me redemandait sans cesse ses Épices,
Et i’ay tout bonnement couru dans les Offices	Et j’ai tout bonnement couru dans les Offices
Chercher la boëtte au poivre. Et luy pendant cela	Chercher la boîte au poivre. Et lui pendant cela
Eſt diſparu.	Est disparu.
PAix, paix, que l’on ſe taiſe là.	PAix, paix, que l’on se taise là.
Hé grand Dieu.	Hé grand Dieu.
Le voila, ma foy, dans les gouttieres.	Le voilà, ma foi, dans les gouttières.
Quelles gens eſtes-vous? Quelles ſont vos affaires?	Quelles gens êtes-vous? Quelles sont vos affaires?
Qui ſont ces gens en robbe? Eſtes-vous Auocats?	Qui sont ces gens en robe? Êtes-vous Avocats?
Ca, parlez.	Çà, parlez.
Vous verrez qu’il va juger les Chats.	Vous verrez qu’il va juger les Chats.
Auez-vous eû le ſoin de voir mon Secretaire?	Avez-vous eu le soin de voir mon Secrétaire?
Allez luy demander ſi ie ſçay voſtre affaire?	Allez-lui demander si je sais votre affaire?
Il faut bien que ie l’aille arracher de ces lieux.	Il faut bien que je l’aille arracher de ces lieux.
Sur voſtre Priſonnier, Huiſſier, ayez les yeux.	Sur votre Prisonnier, Huissier, ayez les yeux.
Ho, ho, Monſieur.	Ho, ho, Monsieur.
Tay-toy ſur les yeux de ta teſte,	Tais-toi sur les yeux de ta tête;
Et ſuy moy.	Et suis-moi.
DEpeſchez. Donnez voſtre Requeſte.	DÉpêchez. Donnez votre requête.
Monſieur, ſans voſtre aueu, l’on me fait priſonnier.	Monsieur, sans votre aveu, l’on me fait prisonnier.
Hé mon Dieu, i’aperçoy Monſieur dans ſon grenier!	Hé mon Dieu, j’aperçois Monsieur dans son grenier!
Que fait-il là?	Que fait-il là?
Madame, il y donne Audiance,	Madame, il y donne Audience,
Le champ vous eſt ouuert.	Le champ vous est ouvert.
On me fait violence,	On me fait violence,
Monſieur, on m’injurie, & ie venois icy	Monsieur, on m’injurie, et je venais ici
Me plaindre à vous.	Me plaindre à vous.
Monſieur, ie viens me plaindre auſſy.	Monsieur, je viens me plaindre aussi.
Vous voyez deuant vous mon aduerſe Partie.	Vous voyez devant vous mon adverse Partie.
Parbleu, ie me veux mettre auſſi de la partie.	Parbleu, je me veux mettre aussi de la partie.
Monſieur, ie viens icy pour vn petit Exploit.	Monsieur je viens ici pour un petit Exploit.
Hé, Meſſieurs, tour à tour, expoſons noſtre droit.	Hé, Messieurs, tour à tour, exposons notre droit.
Son droit? Tout ce qu’il dit ſont autant d’impoſtures.	Son droit? Tout ce qu’il dit sont autant d’impostures.
Qu'es-ce qu’on vous a fait?	Qu’est-ce qu’on vous a fait?
On m’a dit des injures.	On m’a dit des injures.
Outre vn ſoufflet, Mõſieur que i’ay reçeû plus qu’eux.	Outre un soufflet, Monsieur, que j’ai reçu plus qu’eux.
Monſieur, ie ſuis Couſin de l’vn de vos Neveux.	Monsieur, je suis Cousin de l’un de vos Neveux.
Monſieur, Pere Cordon vous dira mon affaire.	Monsieur, Père Cordon vous dira mon affaire.
Monſieur, ie ſuis baſtard de voſtre Apotiquaire.	Monsieur, je suis bâtard de votre Apothicaire.
Vos qualitez?	Vos qualités?
Ie ſuis Comteſſe.	Je suis Comtesse.
Huiſſier.	Huissier.
Bourgeois.	Bourgeois.
Meſſieurs....	Messieurs…
Parlez toûjours, ie vous entens tous trois.	Parlez toujours, je vous entends tous trois.
Monſieur....	Monsieur…
Bon, le voila qui fauſſe compagnie.	Bon, le voilà qui fausse compagnie.
Hélas!	Hélas!
Hé quoy, déja l'Audiance eſt finie;	Hé quoi! déjà l’Audience est finie;
Ie n’ay pas eu le temps de luy dire deux mots.	Je n’ai pas eu le temps de lui dire deux mots.
MEſſieurs, voulez-vous bien nous laiſſer en repos?	Messieurs, voulez-vous bien nous laisser en repos?
Monſieur, peut-on entrer?	Monsieur, peut-on entrer?
Non, Monſieur, ou ie meure.	Non, Monsieur, ou je meure.
Hé pourquoy? i’auray fait en vne petite heure,	Hé pourquoi? j’aurai fait en une petite heure,
En deux heures au plus.	En deux heures au plus.
On n’entre point, Monſieur.	On n’entre point, Monsieur.
C’eſt bien fait, de fermer la porte à ce crieur.	C’est bien fait, de fermer la porte à ce crieur.
Mais moy....	Mais moi…
L’on n’entre point, Madame, ie vous jure.	L’on n’entre point, Madame, je vous jure.
Ho, Monſieur, i’entreray.	Ho, Monsieur, j’entrerai.
Peut-eſtre.	Peut-être.
I’en ſuis ſeûre.	J’en suis sûre.
Par la feneſtre donc.	Par la fenêtre donc.
Par la porte.	Par la porte.
Il faut voir.	Il faut voir.
Quand ie deurois icy demeurer juſqu’au ſoir.	Quand je devrais ici demeurer jusqu’au soir.
ON ne l’entendra pas, quelque choſe qu'il faſſe.	ON ne l’entendra pas, quelque chose qu’il fasse.
Parbleu, ie l'ay fourré dans noſtre ſalle baſſe,	Parbleu, je l’ai fourré dans notre salle basse,
Tout auprés de la caue.	Tout auprès de la cave.
En vn mot, comme en cent,	En un mot, comme en cent,
On ne voit point mon Pere.	On ne voit point mon Père.
Hé bien donc. Si pourtant	Hé bien donc. Si pourtant
Sur toute cette affaire il faut que ie le voye.	Sur toute cette affaire il faut que je le voie.
Mais que vois-je? Ah, c'eſt luy que le Ciel nous rẽuoye.	Mais que vois-je? Ah, c’est lui que le Ciel nous renvoie.
Quoy par le ſoupirail?	Quoi par le soupirail?
Il a le Diable au corps.	Il a le diable au corps.
Monſieur....	Monsieur…
L’impertinent, ſans luy i’eſtois dehors.	L’impertinent, sans lui j’étais dehors.
Monſieur....	Monsieur…
Retirez-vous, vous eſtes vne beſte.	Retirez-vous, vous êtes une bête.
Monſieur, vous voulez bien....	Monsieur, voulez-vous bien…
Vous me rompez la teſte.	Vous me rompez la tête.
Monſieur, i’ay commandé....	Monsieur, j’ai commandé…
Taiſez-vous, vous dit-on.	Taisez-vous, vous dit-on.
Que l’on portaſt chez vous....	Que l’on portât chez vous…
Qu’on le meine en priſon.	Qu’on le mène en prison.
Certain cartaut de vin.	Certain quartaut de vin.
Hé ie n’en ay que faire.	Hé je n’en ai que faire.
C’eſt de tres-bon muſcat.	C’est de très bon muscat.
Redites voſtre affaire.	Redites votre affaire.
Il faut les entourer icy de tous coſtez.	Il faut les entourer ici de tous côtés.
Monſieur, il vous va dire autant de fauſſetez.	Monsieur, il vous va dire autant de faussetés.
Monſieur, ie vous dy vray.	Monsieur, je vous dis vrai.
Mon Dieu, laiſſez-la dire.	Mon Dieu, laissez-la dire.
Monſieur, écoutez-moy.	Monsieur, écoutez-moi.
Souffrez que ie reſpire.	Souffrez que je respire.
Monſieur....	Monsieur…
Vous m’étranglez.	Vous m’étranglez.
Tournez les yeux vers moy.	Tournez les yeux vers moi.
Elle m’étrangle. Ay. ay.	Elle m’étrangle. Ay. ay.
Vous m’entraiſnez, ma foy.	Vous m’entraînez, ma foi.
Prenez garde, ie tombe.	Prenez garde, je tombe.
Ils ſont, ſur ma parole,	Ils sont sur ma parole,
L'vn & l’autre encauez.	L’un et l’autre encavés.
Viſte, que l'on y vole,	Vite, que l’on y vole,
Courez à leur ſecours. Mais au moins ie prétens	Courez à leur secours. Mais au moins je prétends
Que Monſieur Chicanneau, puis qu’il eſt là-dedans,	Que Monsieur Chicanneau, puisqu’il est là-dedans,
N’en ſorte d’aujourd’huy. L’Intimé, prens-y garde.	N’en sorte d’aujourd’hui. L’Intimé, prends-y garde.
Gardez le ſoupirail.	Gardez le soupirail.
Va viſte, ie le garde.	Va vite, je le garde.
Miſerable! il s’en va luy préuenir l'eſprit.	Misérable! il s’en va lui prévenir l’esprit.
Monſieur, ne croyez rien de tout ce qu’il vous dit.	Monsieur, ne croyez rien de tout ce qu’il vous dit.
Il n’a point de témoins. C’eſt vn menteur.	Il n’a point de témoins. C’est un menteur.
Madame,	Madame,
Que leur contez-vous là? Peut-eſtre ils rendent l'ame.	Que leur contez-vous là? Peut-être ils rendent l’âme.
Il luy fera, Monſieur, croire ce qu’il voudra.	Il lui fera, Monsieur, croire ce qu’il voudra.
Souffrez que i’entre.	Souffrez que j’entre.
Oh non, perſonne n’entrera.	Oh non, personne n’entrera.
Ie le voy bien, Monſieur, le vin muſcat opere	Je le vois bien, Monsieur, le vin muscat opère
Auſſi bien ſur le Fils que ſur l’eſprit du Pere.	Aussi bien sur le Fils que sur l’esprit du Père.
Patience, le vais proteſter comme il faut,	Patience. Je vais protester comme il faut,
Contre Monſieur le Iuge, & contre le cartaut.	Contre Monsieur le Juge, et contre le quartaut.
Allez donc, & ceſſez de nous rompre la teſte.	Allez donc, et cessez de nous rompre la tête.
Que de fous! le ne fus iamais à telle feſte.	Que de fous! Je ne fus jamais à telle fête.
MOnſieur, où courez-vous? C'eſt vous mettre en danger,	Monsieur, où courez-vous? C’est vous mettre en danger,
Et vous boittez tout bas.	Et vous boitez tout bas.
Ie veux aller juger.	Je veux aller juger.
Cõment, mon Pere, allõs, permettez qu’on vous penſe.	Comment, mon Père, allons, permettez qu’on vous panse.
Viſte, vn Chirurgien.	Vite, un Chirurgien.
Qu'il vienne à l'Audiance.	Qu’il vienne à l’Audience.
Hé, mon Pere, arreſtez.....	Hé, mon Père, arrêtez…
Ho! ie voy ce que c’eſt,	Ho! je vois ce que c’est,
Tu prétens faire icy de moy ce qui te plaiſt.	Tu prétends faire ici de moi ce qui te plaît.
Tu ne gardes pour moy reſpect, ny complaiſance.	Tu ne gardes pour moi respect, ni complaisance.
Ie ne puis prononcer vne ſeule Sentence.	Je ne puis prononcer une seule Sentence.
Acheue, prens ce ſac, prens viſte.	Achève, prends ce sac, prends vite.
Hé doucement,	Hé doucement,
Mon Pere. Il faut trouuer quelque accommodement.	Mon Père. Il faut trouver quelque accommodement.
Si pour vous, ſans juger, la vie eſt vn ſupplice,	Si pour vous, sans juger, la vie est un supplice,
Si vous eſtes preſſé de rendre la Iuſtice,	Si vous êtes pressé de rendre la Justice,
Il ne faut point ſortir pour cela de chez vous,	Il ne faut point sortir pour cela de chez vous,
Exercez le talent, & jugez parmy nous.	Exercez le talent, et jugez parmi nous.
Ne raillons point icy de la Magiſtrature.	Ne raillons point ici de la magistrature.
Vois-tu. Ie ne veux point eſtre vn Iuge en peinture.	Vois-tu. Je ne veux point être un Juge en peinture.
Vous ſerez au contraire vn Iuge ſans appel,	Vous serez, au contraire un Juge sans appel,
Et Iuge du Ciuil, comme du Criminel.	Et Juge du Civil comme du Criminel.
Vous pourrez tous les jours tenir deux Audiances,	Vous pourrez tous les jours tenir deux Audiences,
Tout vous ſera chez vous matiere de Sentences.	Tout vous sera chez vous matière de Sentences.
Vn valet manque-t’il de rendre vn verre net?	Un valet manque-t-il de rendre un verre net?
Condamnez-le à l’amande, ou s’il le caſſe, au foüet.	Condamnez-le à l’amende, ou s’il le casse, au fouet.
C’eſt quelque choſe. Encor paſſe quand on raiſonne.	C’est quelque chose. Encor passe quand on raisonne.
Et mes vacations qui les payera? Perſonne.	Et mes vacations, qui les paiera? Personne.
Leurs gages vous tiendront lieu de nantiſſement.	Leurs gages vous tiendront lieu de nantissement.
Il parle, ce me ſemble, aſſez pertinemment.	Il parle, ce me semble, assez pertinemment.
Contre vn de nos Voiſins....	Contre un de vos Voisins…
ARreſte, arreſte, attrape.	Arrête, arrête, attrape.
Ah, c’eſt mon Priſonnier ſans cloute qui s’échape.	Ah, C’est mon Prisonnier sans doute qui s’échappe.
Non, non, ne craignez rien.	Non, non, ne craignez rien.
Tout eſt perdu.... Citron....	Tout est perdu… Citron…
Voſtre Chien.... vient là-bas de manger vn Chapon.	Votre Chien… vient là-bas de manger un Chapon,
Rien n’eſt ſeûr deuãt luy. Ce qu’il trouue, il l'emporte.	Rien n’est sûr devant lui. Ce qu’il trouve, il l’emporte.
Bon, voila pour mon Pere vne cauſe. Main forte.	Bon, voilà pour mon Père une cause. Main forte.
Qu'on ſe mette apres luy. Courez tous.	Qu’on se mette après lui. Courez tous.
Point de bruit,	Point de bruit,
Tout doux. Vn Amené ſans ſcandale ſuffit.	Tout doux. Un Amené sans scandale suffit.
Cà, mon Pere, il faut faire vn exemple authentique.	Çà, mon Père, il faut faire un exemple authentique.
Iugez ſeuerement ce voleur domeſtique.	Jugez sévèrement ce voleur domestique.
Mais ie veux faire au moins la choſe auec éclat;	Mais je veux faire au moins la chose avec éclat;
Il faut de part & d’autre auoir vn Auocat.	Il faut de part et d’autre avoir un Avocat.
Nous n’en auons pas-vn.	Nous n’en avons pas un.
Hé bien, il en faut faire,	Hé bien, il en faut faire,
Voila voſtre Portier, & voſtre Secretaire,	Voilà votre Portier, et votre Secrétaire,
Vous en ferez, ie croy, d’excellens Auocats,	Vous en ferez, je crois, d’excellents Avocats,
Ils ſont fort ignorans.	Ils sont fort ignorants.
Non pas, Monſieur, non pas.	Non pas, Monsieur, non pas.
I'endormiray Monſieur tout auſſi bien qu’vn autre.	J’endormirai Monsieur tout aussi bien qu’un autre.
Pour moy, ie ne ſçay rien. N’attendez rien du noſtre.	Pour moi, je ne sais rien. N’attendez rien du nôtre.
C’eſt ta premiere cauſe, & l’on te la fera.	C’est ta première cause, et l’on te la fera.
Mais ie ne ſçay pas lire.	Mais je ne sais pas lire.
Hé l’on le ſoufflera.	Hé l’on le soufflera.
Ie vous entens. Oüy, mais d’vne premiere cauſe,	Je vous entends. Oui, mais d’une première cause,
Monſieur, a l’Auocat reuient-il quelque choſe?	Monsieur, à l’Avocat revient-il quelque chose?
Ah fy. Garde-toy bien d’en vouloir rien toucher.	Ah fi. Garde toi bien d’en vouloir rien toucher.
C’eſt la cauſe d'honneur, on l'achete bien cher.	C’est la cause d’honneur, on l’achète bien cher.
On ſeme des billets par toute la famille;	On ferme des billets par toute le famille;
Et le petit Garçon, & la petite Fille,	Et le petit Garçon, et la petite Fille,
Oncle, Tante, Couſins, tout vient, juſques au Chat,	Oncle, Tante, Cousins, tout vient, jusqu’au Chat
Dormir au Plaidoyé de Monſieur l'Auocat.	Dormir au Plaidoyer de Monsieur l’Avocat.
Allons nous préparer. Cà, Meſſieurs, point d’intrigue.	Allons nous préparer. Çà, Messieurs point d’intrigue.
Fermons l'œil aux préſens, & l'oreille à la brigue.	Fermons l’oeil aux présents, et l’oreille à la brigue.
Vous, Maiſtre Petit Iean, ſerez le demandeur.	Vous, Maître Petit-Jean, serez le demandeur.
Vous, Maiſtre l'intimé, ſoyez le défendeur.	Vous, Maître l’Intimé, soyez le défendeur.
OVy, Monſieur, c'eſt ainſi qu’ils ont con¬duit l’affaire.	OUi, Monsieur, c’est ainsi qu’il ont conduit l’affaire.
L'Huiſſier m’eſt inconnu, comme le Commiſſaire.	L’Huissier m’est inconnu, comme le Commissaire.
Ie ne ments pas d'vn mot.	Je ne mens pas d’un mot.
Oüy, ie croy tout cela.	Oui, je crois tout cela.
Mais ſi vous m’en croyez, vous les laiſſerez là.	Mais si vous m’en croyez, vous les laisserez là.
En vain vous prétendez les pouſſer l'vn & l’autre,	En vain vous prétendez les pousser l’un et l’autre,
Vous troublerez bien moins leur repos que le voſtre.	Vous troublerez bien moins leur repos que le vôtre.
Les trois quarts de vos biens ſont déja dépenſez	Les trois quarts de vos biens sont déjà dépensés
A faire enfler des ſacs l'vn ſur l'autre entaſſez;	À faire enfler des sacs l’un sur l’autre entassés;
Et dans vne pourſuite à vous-meſme funeſte,	Et dans une poursuite à vous-même funeste,
Vous en voulez encore abſorber tout le reſte.	Vous en voulez encore absorber tout le reste.
Ne vaudroit-il pas mieux, ſans soucis, ſans chagrins,	Ne vaudrait-il pas mieux, sans soucis, sans chagrins,
Et de vos reuenus regalant vos voiſins,	Et de vos revenus régalant vos voisins,
Viure en Pere jaloux du bien de ſa famille,	Vivre en Père jaloux du bien de sa famille,
Pour en laiſſer vn jour le fonds à voſtre Fille;	Pour en laisser un jour le fonds à votre Fille;
Que de nourrir vn tas d’Officiers affamez,	Que de nourrir un tas d’Officiers affamés,
Qui moiſſonnent les champs que vous auez ſemez,	Qui moissonnent les champs que vous avez semés,
Dont la main toûjours pleine, & toûjours indigente,	Dont la main toujours pleine, et toujours indigente,
S’engraiſſe impunément de vos Chapons de rente?	S’engraisse impunément de vos Chapons de rente?
Le beau plaiſir d’aller tout mourant de ſommeil,	Le beau plaisir d’aller tout mourant de sommeil,
A la porte d’vn Iuge, attendre ſon reſveil,	À la porte d’un Juge, attendre son réveil,
Et d’eſſuyer le vent qui vous ſouffle aux oreilles,	Et d’essuyer le vent qui vous souffle vos oreilles,
Tandis que Monſieur dort, & cuue vos bouteilles;	Tandis que Monsieur dort, et cuve vos bouteilles;
Ou bien ſi vous entrez, de paſſer tout vn jour	Ou bien si vous entrez, de passer tout un jour
A conter, en grondant, les carreaux de ſa cour!	À conter, en grondant, les carreaux de sa cour!
Hé, Monſieur, croyez-moy, quittez cette miſere.	Hé, Monsieur, croyez-moi, quittez cette misère.
Vrayment, vous me donnez vn conſeil ſalutaire,	Vraiment, vous me donnez un conseil salutaire,
Et deuant qu'il ſoit peu, ie veux en profiter.	Et devant qu’il soit peu, je veux en profiter.
Mais ie vous prie au moins de bien ſolliciter.	Mais je vous prie au moins de bien solliciter.
Puis que Monſieur Dandin va donner audiance,	Puisque Monsieur Dandin va donner audience,
Ie vais faire venir ma Fille en diligence.	Je vais faire venir ma Fille en diligence.
On peut l’interroger, elle eſt de bonne foy,	On peut l’interroger, elle est de bonne foi,
Et meſme elle ſçaura mieux répondre que moy.	Et même elle saura mieux répondre que moi.
Allez, & reuenez, l'on vous fera juſtice.	Allez et revenez, l’on vous fera justice.
Quel homme!	Quel homme!
Ie me ſers d’vn étrange artifice.	Je me sers d’un étrange artifice.
Mais mon Pere eſt vn homme à ſe deſeſperer,	Mais mon Père est un homme à se désespérer,
Et d’vne cauſe en l'air il le faut bien leurrer.	Et d’une cause en l’air il le faut bien leurrer.
D'ailleurs i’ay mon deſſein,& ie veux qu’il condane	D’ailleurs j’ai mon dessein, et je veux qu’il condamne
Ce fou qui reduit tout au pied de la chicane.	Ce fou qui réduit tout au pied de la chicane.
Mais voicy tous nos gens qui marchent ſur nos pas.	Mais voici tous nos gens qui marchent sur nos pas.
CA, qu’eſtes-vous icy?	Çà, qu’êtes-vous ici?
Ce ſont les Auocats.	Ce sont les Avocats.
Vous?	Vous?
Ie viens ſecourir leur memoire troublée.	Je viens secourir leur mémoire troublée.
Ie vous entens. Et vous?	Je vous entends. Et vous?
Moy? Ie ſuis l'aſſemblée.	Moi? Je suis l’assemblée.
Commencez donc.	Commencez donc.
Meſſieurs....	Messieurs…
Ho, prenez-le plus bas;	Ho, prenez le plus bas;
Si vous ſoufflez ſi haut, l’on ne m’entendra pas.	Si vous soufflez si haut, l’on ne m’entendra pas.
Meſſieurs....	Messieurs…
Couurez-vous.	Couvrez-vous.
Oh! Meſ....	Oh! Mes…
Couurez-vous, vous dis-je.	Couvrez-vous, vous dis-je.
Oh, Monſieur, ie ſçay bien à quoy l'honneur m’oblige.	Oh, Monsieur, je sais bien à quoi l’honneur m’oblige.
Ne te couure donc pas.	Ne te couvre donc pas.
Meſſieurs.... Vous doucement;	Messieurs… Vous doucement;
Ce que ie ſçay le mieux, c’eſt mon commencement.	Ce que je sais le mieux, c’est mon commencement.
Meſſieurs, quand ie regarde auec exactitude,	Messieurs, quand je regarde avec exactitude,
L'inconſtance du monde, & ſa viciſſitude;	L’inconstance du monde, et sa vicissitude;
Lors que ie voy parmy tant d’Hommes differens.	Lorsque je vois parmi tant d’Hommes différents.
Pas-vne Eſtoile fixe, & tant d’Aſtres errans;	Pas une Étoile fixe, et tant d’Astres errants;
Quand ie voy les Céſars, quand ie voy leur fortune,	Quand je vois les Césars, quand je vois leur fortune,
Quand ie voy le Soleil, & quand ie voy la Lune;	Quand je vois le Soleil, et quand je vois la Lune;
Quand ie voy les Eſtats des  Babiboniens	Quand je vois les États des Babiboniens
Transferé des  Serpens, aux  Nacedoniens;	Transférés des Serpents, aux Nacédoniens;
Quand ie voy les  Lorrains de l’Eſtat  Dépotique	Quand je vois les Lorrains de l’État Dépotique
Paſſer au  Démocrite, & puis au Monarchique;	Passer au Démocrite, et puis au Monarchique;
Quand ie voy le Iapon....	Quand je vois le Japon…
Quand aura-t’il tout veû?	Quand aura-t-il tout vu?
Oh pourquoy celuy-là m’a-t’il interrompu?	Oh pourquoi celui-là m’a-t-il interrompu?
Ie ne diray plus rien.	Je ne dirai plus rien.
Auocat incommode,	Avocat incommode,
Que ne luy laiſſez-vous finir ſa période?	Que ne lui laissez-vous finir sa période?
Ie ſuois ſang & eau, pour voir ſi du Iapon	Je suais sang et eau pour voir si du Japon
Il viendroit à bon port au fait de ſon Chapon,	Il viendrait à bon port au fait de son Chapon,
Et vous l'interrompez par vn diſcours friuole.	Et vous l’interrompez par un discours frivole.
Parlez donc, Auocat.	Parlez donc, Avocat.
I'ay perdu la parole.	J’ai perdu la parole.
Acheue, Petit Iean, c’eſt fort bien débutté.	Achève, Petit-Jean, c’est fort bien débuté.
Mais que font là tes bras pendans à ton coſté?	Mais que font là tes bras pendants à ton côté?
Te voila ſur tes pieds droit comme vne Statuë,	Te voilà sur tes pieds droit comme une Statue,
Dégourdy-toy, Courage; Allons, qu’on s’éuertuë.	Dégourdis-toi. Courage; Allons, qu’on s’évertue.
Quand... ie voy... Quand... ie voy...	Quand… je vois… Quand… je vois…
Dy donc ce que tu vois.	Dis donc ce que tu vois.
Oh dame, on ne court pas deux Lievres à la fois.	Oh dame, on ne court pas deux Lièvres à la fois.
On lit...	On lit…
On lit...	On lit…
Dans la...	Dans la…
Dans la...	Dans la… 
Metamorphoſe.	Métamorphose.
Comment?	Comment?
Que la Metem...	Que la Métem…
Que la Metan...	Que la Métan…
pſycoſe.	psycose.
Pſycofe.	Psycose.
Hé le cheual!	Hé le cheval!
Et le cheual.	Hé le cheval.
Encor!	Encor!
Encor.	Encor.
Le chien!	Le chien!
Le chien.	Le chien.
Le butor!	Le butor!
Le butor.	Le butor.
Peſte de l'Auocat!	Peste de l’avocat!
Ah peſte de toy-meſme!	Ah peste de toi-même!
Voyez cet autre auec ſa Face de Careſme.	Voyez cet autre avec sa Face de Carême.
Va-t'en au diable.	Va-t’en au diable.
Et vous, venez au fait. Vn mot	Et vous, venez au fait. Un mot
Du fait.	Du fait.
Eh faut-il tant tourner autour du pot?	Eh faut-il tant tourner autour du pot?
Ils me font dire auſſi des mots longs d'vne toiſe,	Il me font dire aussi des mots longs d’une toise,
De grãds mots qui tiendroient d'icy juſqu’à Pontoiſe	De grands mots qui tiendraient d’ici jusqu’à Pontoise.
Pour moy, ie ne ſçay point tant faire de façon,	Pour moi, je ne sais point tant faire de façon,
Pour dire qu’vn Maſtin vient de prendre vu Chapon.	Pour dire qu’un Mâtin vient de prendre un Chapon.
Tant y a qu'il n’eſt rien que voſtre Chien ne prenne,	Tant y a qu’il n’est rien que votre Chien ne prenne,
Qu'il a mangé là-bas vn bon Chapon du Maine;	Qu’il a mangé là-bas un bon Chapon du Maine;
Que la premiere fois que ie l'y trouueray,	Que la première fois que je l’y trouverai,
Son procez eſt tout fait, & ie l'aſſommeray.	Son procès est tout fait, et je l’assommerai.
Belle concluſion, & digne de l'exorde!	Belle conclusion, et digne de l’exorde!
On l'entẽd bien toûjours. Qui voudra mordre, y morde.	On l’entend bien toujours. Qui voudra mordre, y morde.
Appellez les témoins.	Appelez les témoins.
C’eſt bien dit, s'il le peut.	C’est bien dit, s’il le peut.
Les témoins ſont fort chers, & n’en a pas qui veut.	Les témoins sont fort chers, et n’en a pas qui veut.
Nous en auons pourtant, & qui ſont ſans reproche.	Nous en avons pourtant, et qui sont sans reproche.
Faites les donc venir.	Faites-les donc venir.
Ie les ay dans ma poche.	Je les ai dans ma poche.
Tenez, voila la teſte, & les pieds du Chapon.	Tenez, voilà la tête, et les pieds du Chapon.
Voyez les, & jugez.	Voyez-les, et jugez.
Ie les récuſe.	Je les récuse.
Bon!	Bon!
Pourquoy les récuſer?	Pourquoi les récuser?
Monſieur, ils ſont du Maine.	Monsieur, ils sont du Maine.
Il eſt vray que du Mans il en vient par douzaine.	Il est vrai que du Mans il en vient par douzaine.
Meſſieurs....	Messieurs…
Serez-vous long, Auocat? dites-moy.	Serez-vous long, Avocat ? dites-moi.
Ie ne répons de rien.	Je ne réponds de rien.
Il eſt de bonne foy.	Il est de bonne foi.
Meſſieurs. Tout ce qui peut étonner vn coupable,	Messieurs. Tout ce qui peut étonner un coupable,
Tout ce que les mortels ont de plus redoutable,	Tout ce que les mortels ont de plus redoutable,
Semble s’eſtre aſſemblé contre nous par hazar,	Semble s’être assemblé contre nous par hasard,
Ie veux dire la brigue, & l’éloquence. Car	Je veux dire la brigue, et l’éloquence. Car
D'vn coſté le credit du deffunt m’épouuante,	D’un côté le crédit du défunt m’épouvante,
Et de l'autre coſté l'éloquence éclatante	Et de l’autre côté l’éloquence éclatante
De Maiſtre Petit Iean m’ébloüit.	De Maître Petit-Jean m’éblouit.
Auocat,	Avocat,
De voſtre ton vous-meſme adouciſſez l'éclat.	De votre ton vous-mêmes adoucissez l’éclat.
Ouy-da, i’en ay pluſieurs.	Oui-dà, j’en ai plusieurs.
Mais quelque défiance	Mais quelque défiance
Que nous doiue donner la ſuſdite éloquence,	Que nous doive donner la susdite éloquence,
Et le ſuſdit crédit: Ce neanmoins, Meſſieurs,	Et le susdit crédit: Ce néanmoins, Messieurs,
L’ancre de vos bontez nous raſſure d'allieurs.	L’ancre de vos bontés nous rassure d’ailleurs.
Deuant le grand Dandin l’innocence eſt hardie;	Devant le grand Dandin l’innocence est hardie;
Oüy deuant ce Caton de baſſe Normandie,	Oui, devant ce Caton de Basse-Normandie,
Ce Soleil d’équité qui n’eſt iamais terni,	Ce Soleil d’équité qui n’est jamais terni,
Victrix cauſa dijs placuit, ſed victa Cantoni.	Victrix causa diis placuit, sed victa Catoni.
Vrayment, il plaide bien.	Vraiment il plaide bien.
Sans craindre aucune choſe,	Sans craindre aucune chose,
Ie prens donc la parole, & ie viens à ma cauſe.	Je prends donc la parole, et je viens à ma cause.
Ariſtote, primo peri Politicon,	Aristote, primo, peri Politicon,
Dit fort bien....	Dit fort bien…
Auocat, il s’agit d’vn Chapon,	Avocat, il s’agit d’un Chapon,
Et non point d’Ariſtote, & de ſa Politique.	Et non point d’Aristote, et de sa Politique.
Oüy mais. L’authorité du Peripatétique	Oui, mais. L’autorité du Péripatétique
Prouueroit que le bien & le mal....	Prouverait que le bien et le mal…
Ie prétens	Je prétends
Qu’Ariſtote n’a point d’autorité céans.	Qu’Aristote n’a point d’autorité céans.
Au fait.	Au fait.
Pauſanias en ſes Corinthiaques...	Pausanias en ses Corinthiaques…
Au fait.	Au fait.
Rebuffe...	Rebuffe…
Au fait, vous dis-je.	Au fait, vous dis-je.
Le grand Iacques...	Le grand Jacques…
Au fait, au fait, au fait.	Au fait, au fait, au fait!
Armen Pul en ſom Promt...	Armen Pul en som Prompt
Ho, ie te vais juger.	Ho, Je te vais juger.
Ho, vous eſtes ſi promt.	Ho, vous êtes si prompt.
Voicy le fait.  Vn Chien vient dans vne cuiſine,	Voici le fait. Un chien vient dans une cuisine,
Il y trouue vn Chapon, lequel a bonne mine.	Il y trouve un Chapon, lequel a bonne mine.
Or celuy pour lequel ie parle eſt affamé.	Or celui pour lequel je parle est affamé.
Celuy contre lequel ie parle autem plumé.	Celui contre lequel je parle autem plumé.
Et celuy pour lequel ie ſuis, prend en cachette	Et celui pour lequel je suis, prend en cachette
Celuy contre lequel ie parle. L’on decrete.	Celui contre lequel je parle. L’on décrète.
On le prend. Auocat pour & contre appellé.	On le prend. Avocat pour et contre appelé.
Iour pris. Ie doy parler, ie parle, i'ay parlé.	Jour pris. Je dois parler, je parle, j’ai parlé.
Ta, ta, ta, ta. Voila bien inſtruire vne affaire.	Ta, ta, ta, ta. Voilà bien instruire une affaire.
Il dit fort poſément ce dont on n'a que faire,	Il dit fort posément ce dont on n’a que faire,
Et court le grand galop quand il eſt à ſon fait.	Et court le grand galop quand il est à son fait.
Mais le premier, Monſieur, c’eſt le beau.	Mais le premier, Monsieur, c’est le beau.
C'eſt le laid.	C'est le laid
A-t-on iamais plaidé d’vne telle methode?	A-t-on jamais plaidé d’une telle méthode?
Mais qu'en dit l’aſſemblée?	Mais qu’en dit l’assemblée?
Il eſt fort à la mode.	Il est fort à la mode.
Qu'arriue-t'il, Meſſieurs? On vient. Cõment vient-on?	Qu’arrive-t-il, Messieurs? On vient. Comment vient-on?
On pourſuit ma Partie. On force vne maiſon.	On poursuit ma Partie. On force une maison.
Quelle maiſon? Maiſon de noſtre propre Iuge.	Quelle maison? Maison de notre propre Juge.
On briſe le ſellier qui nous ſert de refuge.	On brise le cellier qui nous sert de refuge.
De vol, de brigandage, on nous declare auteurs.	De vol, de brigandage, on nous déclare auteurs.
On nous traiſne. On nous liure à nos accuſateurs.	On nous traîne. On nous livre à nos accusateurs.
A Maiſtre Petit Iean, Meiſſeurs. Ie vous atteſte	À Maître Petit-Jean, Messieurs. Je vous atteste
Qui ne ſçait que la Loy Si quis Canis, Digeſte	Qui ne sait que la Loi Si quis canis, Digeste
De vi, Paragraphe, Meſſieurs, Caponibus	De vi, Paragrapho, Messieurs, Caponibus
Eſt manifeſtement contraire à cet abus?	Est manifestement contraire à cet abus?
Et quand il ſeroit vray, que Citron ma Partie	Et quand il serait vrai que Citron ma Partie
Auroit mangé Meſſieurs, le tout, ou bien partie	Aurait mangé, Messieurs, le tout, ou bien partie
Dudit Chapon. Qu'on mette en compenſation	Dudit Chapon. Qu’on mette en compensation
Ce que nous auons fait auant cette action.	Ce que nous avons fait avant cette action.
Quand ma Partie a-t'elle eſté réprimandée?	Quand ma Partie a-t-elle été réprimandée?
Par qui voſtre maiſon a-t'elle eſté gardée?	Par qui votre maison a-t-elle été gardée?
Quand auons-nous manqué d’abboyer au larron?	Quand avons-nous manqué d’aboyer au larron?
Témoin trois Procureurs dont iceluy Citron	Témoin trois Procureurs dont icelui Citron
A déchiré la robbe. On en verra les pieces.	A déchiré la robe. On en verra les pièces.
Pour nous juſtifier, voulez-vous d'autres Pieces?	Pour nous justifier, voulez-vous d’autres Pièces?
Maiſtre Adam....	Maître Adam…
Laiſſez-nous.	Laissez-nous.
L'Intimé...	L’Intimé…
Laiſſez-nous.	Laissez-nous.
S’enrouë.	S’enroue.
Hé laiſſez. nous, Euh. Euh.	Hé laissez-nous. Euh, Euh.
Repoſez-vous.	Reposez-vous.
Et concluez.	Et concluez.
Puis donc, qu’on nous, permet, de prendre,	Puis donc, qu’on nous, permet, de prendre,
Haleine, & que l'on nous, defend, de nous, eſtendre,	Haleine, et que l’on nous, défend, de nous, étendre,
Ie vais, ſans rien obmettre, & ſans préuariquer,	Je vais, sans rien omettre, et sans prévariquer,
Compendieuſement énoncer, expliquer,	Compendieusement énoncer, expliquer,
Expoſer, à vos yeux, l’idée vniuerſelle	Exposer à vos yeux, l’idée universelle
De ma cauſe, & des faits, renfermez, en icelle.	De ma cause, et des faits, renfermez, en icelle.
Il auroit plûtoſt fait de dire tout vingt fois,	Il aurait plutôt fait de dire tout vingt fois,
Que de l'abbreger vne. Homme, ou qui que tu ſois,	Que de l’abréger une. Homme, ou qui que tu sois,
Diable, conclus, ou bien que le Ciel te confonde.	Diable, conclus, ou bien que le Ciel te confonde.
Ie finis.	Je finis.
Ah!	Ah!
Auant la naiſſance du Monde....	Avant la naissance du Monde…
Auocat, ah paſſons au Déluge.	Avocat, ah passons au Déluge.
Auant donc,	Avant donc,
La naiſſance du Monde, & ſa création.	La naissance du Monde, et sa création.
Le Monde, l'Vniuers, Tout, la Nature entiere	Le Monde, l’Univers, Tout, la Nature entière
Eſtoit enſeuelie au fonds de la matiere,	Était ensevelie au fond de la matière.
Les elemens, le feu, l'air, & la terre, & l'eau,	Les éléments, le feu, l’air, et la terre, et l’eau,
Enfoncez, entaſſez, ne faiſoient qu'vn monceau,	Enfoncés, entassés, ne faisaient qu’un monceau,
Vne confuſion, vne maſſe ſans forme,	Une confusion, une masse sans forme,
Vn deſordre, vn cahos, vne cohuë énorme.	Un désordre, un chaos, une cohue énorme.
Vnus erat loto Naturæ vultus in orbe	Unus erat toto naturæ vultus in orbe
Quem Græci dixere cahos, rudis indigeſtaque moles....	Quem Græci dixere chaos, rudis indigestaque moles…
Quelle chute! Mon Pere!	Quelle chute! Mon Père!
Ay, Monſieur! Comme il dort.	Ay, Monsieur! Comme il dort.
Mon Pere, éueillez-vous.	Mon Père, éveillez-vous.
Monſieur, eſtes-vous mort?	Monsieur, êtes-vous mort?
Mon Pere.	Mon Père.
Hé biẽ, hé biẽ. Quoy? Qu'es-ce? Ah! Ah quel hõme!	Hé bien, hé bien. Quoi? Qu’est-ce? Ah! Ah quel homme!
Certes, ie n'ay iamais dormy d’vn ſi bon ſomme.	Certes, je n’ai jamais dormi d’un si bon somme.
Mon Pere, il faut juger.	Mon Père, il faut juger.
Aux Galleres.	Aux Galères.
Vn Chien	Un Chien
Aux Galleres!	Aux Galères!
Ma foy, ie n’y conçoy plus rien.	Ma foi, je n’y conçois plus rien.
De Monde, de cahos, i’ay la teſte troublée.	De Monde, de chaos, j’ai la tête troublée.
Hé concluez.	Hé concluez.
Venez, famille deſolée.	Venez, famille désolée.
Venez, pauures enfans, qu'on veut rendre orphelins,	Venez, pauvres enfants, qu’on veut rendre orphelins,
Venez faire parler vos ſoûpirs enfantins.	Venez faire parler vos soupirs enfantins.
Oüy, Meſſieurs, vous voyez icy noſtre miſere.	Oui, Messieurs, vous voyez ici notre misère.
Nous ſommes orphelins. Rendez-nous noſtre Pere,	Nous sommes orphelins. Rendez-nous notre Père,
Noſtre Pere par qui nous fuſmes engendrez,	Notre Père par qui nous fûmes engendrés,
Noſtre Pere qui nous....	Notre Père qui nous…
Tirez, tirez, tirez.	Tirez, tirez, tirez.
Noſtre Pere, Meſſieurs....	Notre Père, Messieurs…
Tirez donc. Quels vacarmes!	Tirez donc. Quels vacarmes!
Ils ont piſſé par tout.	Ils ont pissé partout.
Monſieur, ce ſont leurs larmes.	Monsieur, ce sont leurs larmes.
Ouf. Ie me ſens déja pris de compaſſion.	Ouf. Je me sens déjà pris de compassion.
Ce que c'eſt qu'à propos toucher la paſſion!	Ce que c’est qu’à propos toucher la passion!
Ie ſuis bien empeſché. La verité me preſſe.	Je suis bien empêché. La vérité me presse.
Le crime eſt aueré, luy-meſme il le confeſſe.	Le crime est avéré, lui-même il le confesse.
Mais s'il eſt condamné, l’embarras eſt égal,	Mais s’il est condamné, l’embarras est égal,
Voila bien des enfans reduits à l’Hoſpital.	Voilà bien des enfants réduits à l’Hôpital.
Mais ie ſuis occupé, ie ne veux voir perſonne.	Mais je suis occupé, je ne veux voir personne.
Monſieur....	Monsieur…
Oüy, pour vous ſeul l’Audiance ſe donne.	Oui, pour vous seuls l’Audience se donne.
Adieu. Mais, s'il vous plaiſt, quel eft cet enfant là?	Adieu. Mais, s’il vous plaît, quel est cet enfant-là?
C'eſt ma Fille, Monſieur.	C’est ma Fille, Monsieur.
Hé toſt, rappellez-la.	Hé tôt, rappelez-la.
Vous eſtes occupé.	Vous êtes occupé.
Moy? ie n’ay point d’affaire.	Moi? je n’ai point d’affaire.
Que ne me diſiez-vous que vous eſtiez ſon Pere?	Que ne me disiez-vous que vous étiez son Père?
Monſieur....	Monsieur…
Elle ſçait mieux voſtre affaire que vous.	Elle sait mieux votre affaire que vous.
Dites. Qu’elle eſt jolie, & qu'elle a les yeux doux!	Dites. Qu’elle est jolie, et qu’elle a les yeux doux!
Ce n’eſt pas tout, ma Fille, il faut de la fageſſe.	Ce n’est pas tout, ma Fille, il faut de la sagesse.
Ie fuis tout réjoüy de voir cette jeuneſſe.	Je suis tout réjoui de voir cette jeunesse.
Sçauez-vous que i'eſtois vn Compere autrefois?	Savez-vous que j’étais un Compère autrefois?
On a parlé de nous.	On a parlé de nous.
Ah, Monſieur, ie vous crois.	Ah, Monsieur, je vous crois.
Dy-nous, a qui veux-tu faire perdre la cauſe?	Dis-nous, à qui veux-tu faire perdre la cause?
A perſonne.	À personne.
Pour toy ie feray toute choſe.	Pour toi je ferai toute chose.
Parle donc.	Parle donc.
Ie vous ay trop d’obligation.	Je vous ai trop d’obligation.
N'auez-vous iamais veû donner la Queſtion?	N’avez-vous jamais vu donner la Question?
Non, & ne le verray, que ie croy, de ma vie.	Non, et ne le verrai, que je crois, de ma vie.
Venez, ie vous en veux faire paſſer l’enuie.	Venez, je vous en veux faire passer l’envie.
Hé, Monſieur, peut-on voir ſouffrir des malheureux?	Hé, Monsieur, peut-on voir souffrir des malheureux?
Bon, cela fait toûjours paſſer vne heure, ou deux.	Bon, cela fait toujours passer une heure, ou deux.
Monſieur, ie viens icy pour vous dire....	Monsieur, je viens ici pour vous dire…
Mon Pere,	Mon Père,
Ie vous vais en deux mots dire toute l'affaire.	Je vous vais en deux mots dire toute l’affaire.
C’eſt pour vn mariage, & vous ſçaurez d'abord	C’est pour un mariage, et vous saurez d’abord
Qu’il ne tient plus qu’à vous, & que tout eſt d'accord.	Qu’il ne tient plus qu’à vous, et que tout est d’accord.
La Fille le veut bien. Son Amant le reſpire;	Le Fille le veut bien. Son Amant le respire;
Ce que la Fille veut, le Pere le deſire.	Ce que la Fille veut, le Père le désire.
C’eſt à vous de juger.	C’est à vous de juger.
Mariez au plûtoſt.	Mariez au plus tôt
Dés demain, ſi l'on veut; aujourd’huy, s’il le faut.	Dès demain, si l’on veut; aujourd’hui, s’il le faut.
Mademoiſelle, allons, voila voſtre Beaupere,	Mademoiselle, allons, voilà votre Beau-père,
Saluez-le.	Saluez-le.
Comment?	Comment?
Quel eſt donc ce myſtere?	Quel est donc ce mystère?
Ce que vous auez dit, ſe fait de point en point.	Ce que vous avez dit, se fait de point en point.
Puis que ie l'ay jugé, ie n'en reuiendray point.	Puisque je l’ai jugé, je n’en reviendrai point.
Mais on ne donne pas vne Fille ſans elle.	Mais on ne donne pas une Fille sans elle.
Sans doute, & i’en croiray la charmante Iſabelle.	Sans doute, et j’en croirai la charmante Isabelle.
Es-tu muette? Allons, C’eſt à toy de parler.	Es-tu muette? Allons. C’est à toi de parler.
Parle.	Parle.
Ie n’oſe pas, mon Pere, en appeller.	Je n'ose pas, mon Père, en appeler.
Mais i'en appelle moy.	Mais j’en appelle moi.
Voyez cette écriture,	Voyez cette écriture,
Vous n’appellerez pas de voſtre ſignature.	Vous n’appellerez pas de votre signature.
Plaiſt-il?	Plaît-il?
C’eſt vn Contract en fort bonne façon.	C’est un Contrat en fort bonne façon.
Ie voy qu’on m'a ſurpris, mais i'en auray raiſon.	Je vois qu’on m’a surpris, mais j’en aurai raison.
De plus de vingt procez cecy ſera la ſource;	De plus de vingt procès ceci sera la source;
On a la Fille, ſoit. On n’aura pas la bource.	On a la Fille, soit. On n’aura pas la bourse.
Hé, Monſieur, qui vous dit qu’on vous demande rien?	Hé, Monsieur, qui vous dit qu’on vous demande rien?
Laiſſez-nous voſtre Fille, & gardez voſtre bien.	Laissez-nous votre Fille, et gardez votre bien.
Ah!	Ah!
Mon Pere, eſtes-vous content de l'Audiance?	Mon Père, êtes-vous content de l’Audience?
Oüy-da, que les procez viennent en abondance,	Oui-dà, que les procès viennent en abondance,
Et ie paſſe auec vous le reſte de mes jours.	Et je passe avec vous le reste de mes jours.
Mais que les Auocats ſoient deſormais plus courts.	Mais que les Avocats soient désormais plus courts.
Et noſtre criminel?	Et notre criminel?
Ne parlons que de joye;	Ne parlons que de joie;
Grace, grace, mon Pere.	Grâce, grâce, mon Père.
Hé bien, qu’on le renuoye.	Hé bien, qu’on le renvoie.
C'eſt en voſtre faneur, ma Bru, ce que i'en fais.	C’est en votre faveur, ma Bru, ce que j’en fais.
Allons-nous délaſſer voir d’autres Procez.	Allons nous délasser à voir d’autres Procès.
