ARTICLE PREMIER	ARTICLE PREMIER
Les Ministres n’ont Mission ni du peuple ni des princes séculiers	Les Ministres n’ont Mission ni du peuple ni des princes séculiers
Premierement, Messieurs, vos devanciers et vous aussy aves faict une faute inexcusable, quand vous prestates l’oreille a ceux qui s’estoyent separés de l’Eglise, car ce n’estoyent des personnes qualifiëes comm’il falloit pour praecher.	Premièrement, Messieurs, vos devanciers et vous aussi avez fait une faute inexcusable, quand vous prêtâtes l’oreille à ceux qui s'étaient séparés de l’Église, car ce n’étaient des personnes qualifiées comme il fallait pour prêcher.
Ilz portoyent parole, a ce qu’ilz disoyent, de la part de Dieu, contre l’Eglise ;	Ils portaient parole, à ce qu’ils disaient, de la part de Dieu, contre l’Église;
ilz se vantoyent de porter le libelle de divorce de la part du Filz de Dieu a l’Eglise son Espouse ancienne, pour se marier a cette jeune assemblee refaitte et reformée.	ils se vantaient de porter le libelle de divorce de la part du Fils de Dieu à l’Église son Épouse ancienne, pour se marier à cette jeune assemblée refaite et reformée.
Mays comme pouvies vous croire ces nouvelles si tost, que sans leur faire monstrer leur charge et commission bien authentiquëe, vous commençates de premier abord a ne reconnoistre plus ceste Reyne pour vostre princesse, et a crier par tout que c’estoit un’adultere ?	Mais comme pouviez vous croire ces nouvelles si tôt, que sans leur faire montrer leur charge et commission bien authentiquée, vous commençâtes de premier abord à ne reconnaître plus cette Reine pour votre princesse, et à crier par tout que c’était un adultère?
Ilz couroyent ça et la semer ces nouvelles, mays qui les en avoit chargés ?	Ils couraient ça et là semer ces nouvelles, mais qui les en avait chargés?
On ne se peut enrooler sous aucun capitaine sans l’adveü du prince chez lequel on demeure :	On ne se peut enrôler sous aucun capitaine sans l’aveu du prince chez lequel on demeure:
et comment fustes vous si promps a vous enrooler sous ces premiers ministres, sans sçavoir si vos pasteurs qui estoyent en estre l’advoüeroient ?	et comment fûtes vous si prompts à vous enrôler sous ces premiers ministres, sans savoir si vos pasteurs qui étaient en être l’avoueraient?
mesme que vous sçavies bien qu’il vous sortoit hors de l’estat dans lequel vous esties nés et nourry.	même que vous saviez bien qu’il vous sortait hors de l’état dans lequel vous étiez nés et nourris.
Eux, donques, sont inexcusables de ce que sans l’authorité du magistrat spirituel ilz ont faicte ceste levëe de bouclier, et vous, de les avoir suyvis.	Eux, donc, sont inexcusables de ce que sans l’autorité du magistrat spirituel ils ont faite cette levée de bouclier, et vous, de les avoir suivis.
Vous voyes bien ou jvays battre ;	Vous voyez bien où je vais battre;
c’est sur la faute de mission et de vocation que Luther, Zuingle, Calvin et les autres avoyeny :	c’est sur la faute de mission et de vocation que Luther, Zwingli, Calvin et les autres avaient:
car c’est une chose certayne que quicomque veut enseigner et tenir rang de pasteur en l’Eglise, il doit estr’envoÿé.	car c’est une chose certaine que quiconque veut enseigner et tenir rang de pasteur en l’Église, il doit être envoyé.
Saint Pol :	Saint Paul:
Quomodo praedicabunt, nisi mittanbur ?	Quomodo praedicabunt, nisi mittanbur?
Comme praecheront ilz, s’ilz ne sont envoyés ?	Comme prêcheront-ils, s’ils ne sont envoyés?
Et Hieremie :	Et Jérémie:
Les prophetes prophetisent a faux, je ne les ay pas envoÿé ;	Les prophètes prophétisent à faux, je ne les ai pas envoyé;
et ailleurs :	et ailleurs:
Non mitebam prophetas et ipsi currebant :	Non mitebam prophetas et ipsi currebant:
Je ne les envoyois point, et ils couroyent.	Je ne les envoyais point, et ils couraient.
La mission est donques necessaire ;	La mission est donc nécessaire;
vous ne le nieres pas, si vous ne sçaves quelque chose plus que vos maistres.	vous ne le nierez pas, si vous ne savez quelque chose plus que vos maîtres.
Mays je vous vois venir en trois esquadrons :	Mais je vous vois venir en trois esquadrons:
car, les uns d’entre vous diront quilz ont eü vocation et mission du peuple et magistrat seculier et temporel ;	car, les uns d’entre vous diront qu'ils ont eu vocation et mission du peuple et magistrat séculier et temporel;
les autres de l’Eglise ;	les autres de l’Église;
comment cela ?	comment cela?
parce, disent ilz, que Luther, OEcolampade, Bucer, Zuingle et autres estoyent prestres de l’Eglise comme les autres ;	parce, disent ils, que Luther, Œcolampade, Bucer, Zwingli et autres étaient prêtres de l’Église comme les autres;
les autres, enfin, qui sont les plus habiles, disent quilz ont estés envoyés de Dieu mays extraordinayrement.	les autres, enfin, qui sont les plus habiles, disent qu'ils ont étés envoyés de Dieu mais extraordinairement.
Voyons que c’est du premier.	Voyons que c’est du premier.
Comme croyrons nous que le peuple, et les princes seculiers, aÿe appellés Calvin, Brence, Luther, pour enseigner la doctrine que jamais il n’avoyt ouÿe ?	Comme croirons nous que le peuple, et les princes séculiers, aient appelés Calvin, Brence, Luther, pour enseigner la doctrine que jamais il n’avait ouïe?
et devant, quand ilz commencerent a prescher et semer ceste doctrine, qui les avoist chargés de ce faire ?	et devant, quand ils commencèrent à prêcher et semer cette doctrine, qui les avait chargés de ce faire?
Vous dites que le peuple devot vous a appellés, mays quel peuple ?	Vous dites que le peuple dévot vous a appelés, mais quel peuple?
Car, ou il estoit Catholique, ou il ne l’estoit pas :	Car, ou il était Catholique, ou il ne l’était pas :
s’il estoit catholique, comme vous eut il appelé et envoÿé praecher ce quil ne croyoit pas ?	s’il était catholique, comme vous eut il appelé et envoyé prêcher ce qu'il ne croyait pas?
et ceste vocation de quelque bien petite partie du peuple lhors Catholique, comme pouvoit elle contrevenir a tout le reste qui sy opposa ?	et cette vocation de quelque bien petite partie du peuple hors Catholique, comme pouvait-elle contrevenir à tout le reste qui si opposa?
et comme vous pouvoit une partie du peuple donner authorité sur l’autre partie, affin que vous pouvies les ames de l’ancienne obeissance ?	et comme vous pouvait une partie du peuple donner autorité sur l’autre partie, afin que vous pouviez les âmes de l’ancienne obéissance?
car un peuple ne peut donner l’authorité que sur soymesme.	car un peuple ne peut donner l’autorité que sur soi-même.
Il eut donc fallu ne point prescher sinon la ou vous esties appellés du peuple, ce que si vous eussies faict, vous n’eussies pas eu tant de suite.	Il eut donc fallu ne point prêcher sinon là où vous étiez appelés du peuple, ce que si vous eussiez fait, vous n’eussiez pas eu tant de suite.
Mays disons voir, quand Luther commença, qui l’appela ?	Mais disons voir, quand Luther commença, qui l’appela?
il n’y avoit encor point de peuple qui pensast aux opinions quil a soustenües, comment donques l’eut il appelé pour les prescher ?	il n’i avait encor point de peuple qui pensât aux opinions qu'il a soutenues, comment donc l’eut il appelé pour les prêcher?
Sil n’estoit pas Catholique, qu’estoit il donq ?	s’est il ingéré et poussé de lui même à cet honneur?
Lutherien ?	Luthérien?
nompas, car je parle de la premiere fois ;	Non pas, car je parle de la première fois;
quoy donq ?	quoi donc?
Qu’on responde donq, si l’on peut.	Qu’on réponde donc, si l’on peut.
Qui a donné l’authorité aux premiers d’assembler les peuples, dresser des compagnies et bandes a part ?	Qui a donné l’autorité aux premiers d’assembler les peuples, dresser des compagnies et bandes à part?
Ce n’est pas le peuple, car ilz n’estoyent pas encor assemblés.	Ce n’est pas le peuple, car ils n’étaient pas encor assemblés.
Mays, ne seroit ce pas tout brouiller, de permettr’a chacun de dire ce que bon luy sembleroit ?	Mais, ne serait ce pas tout brouiller, de permettre à chacun de dire ce que bon lui semblerait?
a ce conte chacun seroit envoÿé ;	à ce conte chacun serait envoyé;
car il ni a si fol qui ne trouve des compaignons, tesmoins les Tritheites, Anabaptistes, Libertins, Adamites.	car il n’y à si fol qui ne trouve des compagnons, témoins les Trithéites, Anabaptistes, Libertins, Adamites.
Il se faut renger a l’Escriture, en laquelle on ne trouvera jamais que les peuples ayent pouvoir de se donner des pasteurs et praedicateurs.	Il se faut ranger à l’Écriture, en laquelle on ne trouvera jamais que les peuples aient pouvoir de se donner des pasteurs et prédicateurs.
112	112
ARTICLE II	ARTICLE II
Les Ministres n’ont pas reçu Mission des Evêques Catholiques	Les Ministres n’ont pas reçu Mission des Evêques Catholiques
Plusieurs, donques de nostre aage, voyans leur chemin couppé de costé la, ilz se sont jettés d’autre de l’autre, et disnet que les premiers maistres reformateurs, Luther, bucer, OEcolampade, ont estés envoyés par les Evesques qui les firent prestres, puys ceux cy ont envoyéspar les Evesques qui les firent prestres, puys ceux cy ont envoyés las autres suyvans, et vont ainsy enchainant leur mission a celle des Apostres.	Plusieurs, donc de notre âge, voyant leur chemin coupé de côté-la, ils se sont jetés d’autre de l’autre, et disent que les premiers maîtres réformateurs, Luther, Bucer, Œcolampade, ont étés envoyés par les Évêques qui les firent prêtres, puis ceux-ci ont envoyés par les Évêques qui les firent prêtres, puis ceux-ci ont envoyés las autres suivants, et vont ainsi enchaînant leur mission à celle des Apôtres.
Veritablement c’est parler françois et realement, que de confesser que leur mission ne peut estre coulëe des Apostres a leurs ministres, que par la succession de nos Evesques et par l’imposition de leurs mains :	Véritablement c’est parler français et réalement, que de confesser que leur mission ne peut être coulée des Apôtres à leurs ministres, que par la succession de nos Évêques et par l’imposition de leurs mains:
la chose est telle sans doute.	la chose est telle sans doute.
On ne peut pas faire sauter ceste mission si haut, que des Apostres elle soit tumbëe entre les mains des praedicateurs de ce tems, sans avoir touché par un des Anciens et de nos devanciers :	On ne peut pas faire sauter cette mission si haut, que des Apôtres elle soit tombée entre les mains des prédicateurs de ce temps, sans avoir touché par un des Anciens et de nos devanciers:
il eut fallu une bien longue sarbacane en la bouche des premiers fondateurs de l’Eglise, pour avoir appellé Luther et les autres sans que ceux qui estoyent entre deux s’en fussent apperceu, ou bien (comme dict Calvin a un’autre occasion et malapropos), que ceux cy eussent eu les oreilles bien grandes :	il eut fallu une bien longue sarbacane en la bouche des premiers fondateurs de l’Église, pour avoir appelé Luther et les autres sans que ceux qui étaient entre deux s’en fussent aperçu, ou bien (comme dit Calvin à une autre occasion et mal à propos), que ceux-ci eussent eu les oreilles bien grandes:
il failloit bien qu’elle fut conservëe entiere, si ceux cy la devoient trouver.	il fallait bien qu’elle fut conservée entière, si ceux-ci la devaient trouver.
Nous avoüons, donques, que la mission estoit riere nos Evesques, et principalement es mains de leur chef, l’Evesque Romain.	Nous avouons, donc, que la mission était riere nos Évêques, et principalement ès mains de leur chef, l’Évêque Romain.
Mays nous nions formellement que vos ministres en ayent eu aucune communication, pour praecher ce quilz ont preché, parce que :	Mais nous nions formellement que vos ministres en aient eu aucune communication, pour prêcher ce qu'ils ont prêché, parce que:
1.	1.
Ilz prechent choses contraires a l’Eglise en laquelle ilz ont estés ordonnés prestres :	Ils prêchent choses contraires à l’Église en laquelle ils ont étés ordonnés prêtres:
ou, donq, ilz errent, ou l’Eglise qui les a envoyés, et, par consequent, ou leur eglise est fausse ou celle de laquelle ilz ont pris la mission.	ou, donc, ils errent, ou l’Église qui les a envoyés, et, par conséquent, ou leur église est fausse ou celle de laquelle ils ont pris la mission.
Car dun’eglise fause ne peut sortir une vraÿe mission :	Car d’une église fausse ne peut sortir une vraie mission:
si c’est leur eglise qui est fause, moins ilz ont mission ;	si c’est leur église qui est fausse, moins ils ont mission;
car en un’eglise fause ne peut estre vraÿe mission.	car en une église fausse ne peut être vraie mission.
Comme que ce soit donques, ilz n’ont point eu demission pour precher ce quilz ont preché :	Comme que ce soit donc, ils n’ont point eu démission pour prêcher ce qu'ils ont prêché:
puysque si l’Eglise en laquelle ilz ont esté ordonnés estoit vraÿe, ilz sont haeretiques d’en estre sortis et d’avoir praeché contre sacreance ;	puisque si l’Église en laquelle ils ont été ordonnés était vraie, ils sont hérétiques d’en être sortis et d’avoir prêché contre sa créance;
et si elle n’estoit vraÿe, elle ne leur pouvoit donner mission.	et si elle n’était vraie, elle ne leur pouvait donner mission.
2.	2.
Outre cela, quoy quilz eussent eu mission en l’Eglise Romaine, ilz ne l’ont pas eu pour en sortir et distraire de son obeissance ses enfans :	Outre cela, quoi qu'ils eussent eu mission en l’Église Romaine, ils ne l’ont pas eu pour en sortir et distraire de son obéissance ses enfants:
certes, le commissaire ne doit pas exceder les bornes de sa commission, ou c’est pour neant.	certes, le commissaire ne doit pas excéder les bornes de sa commission, ou c’est pour néant.
3.	3.
Luther, OEcolampade ou Calvin n’estoyent pas evesques ;	Luther, Œcolampade ou Calvin n’étaient pas évêques;
comme donques pourvoyent ilz communiquer aucune mission a leurs successeurs de la part de l’Eglise Romaine, qui proteste en tout et par tout quil ni a que les Evesques qui puyssent envoyer, et que cela n’appartient aucunement aux simples prestres ?	comme donc pouvaient-ils communiquer aucune mission à leurs successeurs de la part de l’Église Romaine, qui proteste en tout et par tout qu'il n’y a que les Évêques qui puissent envoyer, et que cela n’appartient aucunement aux simples prêtres?
en quoy saint Hierosme mesme a mis la difference qui est entre le simple prestre et l’Evesque, en l’epistre ad Evagrium et saint Augustin et Epiphane mettent Aerius en conte avec les haeretiques par ce quil tenoit le contraire.	en quoi saint Jérôme même a mis la différence qui est entre le simple prêtre et l’Évêque, en l’épître ad Evagrium et saint Augustin et Épiphane mettent Arius  en conte avec les hérétiques parce qu'il tenait le contraire.
113	113
ARTICLE III	ARTICLE III
Les Ministres n’ont pas la Mission extraordinaire	Les Ministres n’ont pas la Mission extraordinaire
Ces raysons sont si vives, que les plus asseurés des vostres ont pris party ailleurs qu’en la mission ordinayre, et ont dict quilz estyent envoyés extraordinairement de Dieu, par ce que la mission ordinaire avoit esté gastëe et abolie, quand et quand la vraÿe Eglise, sous la tirannie de l’Antichrist.	Ces raisons sont si vives, que les plus assurés des vôtres ont pris parti ailleurs qu’en la mission ordinaire, et ont dit qu'ils étaient envoyés extraordinairement de Dieu, parce que la mission ordinaire avait été gâtée et abolie, quand et quand la vraie Église, sous la tyrannie de l’Antichrist.
Voicy leur plus assurëe retraitte, laquelle, par ce quell’est commune a toutes sortes d’heretiques, merite d’estre attaquëe a bon escient, et ruynee sans dessus dessous.	Voici leur plus assurée retraite, laquelle, parce qu’elle est commune à toutes sortes d’hérétiques, mérite d’être attaquée à bon escient, et ruinée sans dessus dessous.
Mettons donques nostre dire par ordre, pour voir si nous pourrons forcer ceste leur derniere baricade.	Mettons donc notre dire par ordre, pour voir si nous pourrons forcer cette leur dernière barricade.
Je dis, donques, 1.	Je dis, donc, 1.
que personne ne doit alleguer une mission extraordinayre qui ne la prouve par miracles.	que personne ne doit alléguer une mission extraordinaire qui ne la prouve par miracles.
1.	1.
Car, je vous prie, a quoy en serions nous , si ce praetexte de mission extraordinayre estoit recevable sans preuve ?	Car, je vous prie, à quoi en serions nous, si ce prétexte de mission extraordinaire était recevable sans preuve?
ne seroit ce pas un voile a toutes sortes de resveries ?	ne serait ce pas un voile à toutes sortes de rêveries?
Arrius, Marcion , Montanus, Massalius, ne pourroyent ilz pas estre receuz a ce grade de reformateurs en prestant le mesme serment ?	Arius, Marcion , Montanus, Massalius, ne pourraient-ils pas être reçus à ce grade de réformateurs en prêtant le même serment?
2.	2.
Jamais personne ne fut envoyé extraordinairement qui ne prit ceste lettre de creance de la divine Majesté.	Jamais personne ne fut envoyé extraordinairement qui ne prit cette lettre de créance de la divine Majesté.
Moyse fut envoÿé immédiatement de Dieu pour gouverner le peuple d’Israel ;	Moïse fut envoyé immédiatement de Dieu pour gouverner le peuple d’Israel;
il voulut sçavoir le nom de qui l’envoyoit, et quand il eut appris ce nom admirable de Dieu, il demanda des marques et patentes de sa commission :	il voulut savoir le nom de qui l’envoyait, et quand il eut appris ce nom admirable de Dieu, il demanda des marques et patentes de sa commission:
ce que nostre Dieu trouva si bon, quil luy donna la grace de trois sortes de prodiges et de merveilles, qui furent comme troys attestations, en trois divers langages, de la charge quil luy donnoit, affin que qui n’entendroit l’une entendit l’autre.	ce que notre Dieu trouva si bon, qu'il lui donna la grâce de trois sortes de prodiges et de merveilles, qui furent comme trois attestations, en trois divers langages, de la charge qu'il lui donnait, afin que qui n’entendrait l’une entendit l’autre.
Si donques ilz alleguent la mission extraordinaire, quilz nous monstrent quelques oeuvres extraordinaires, autrement nous ne sommes pas obligés de les croire.	Si donc ils allèguent la mission extraordinaire, qu'ils nous montrent quelques œuvres extraordinaires, autrement nous ne sommes pas obligés de les croire.
Vrayement Moyse monstre extraordinairement bien la necessité de ceste preuve a qui veut parler extraordinairement ;	Vraiment Moïse monstre extraordinairement bien la nécessité de cette preuve à qui veut parler extraordinairement;
car, ayant a demander le don d’eloquence a Dieu, il ne le demande qu’apres avoir le pouvoir des miracles, monstrant quil est plus necessaire d’avoir l’authorité de parler que d’en avoir la promptitude.	car, ayant à demander le don d’éloquence à Dieu, il ne le demande qu’après avoir le pouvoir des miracles, montrant qu'il est plus nécessaire d’avoir l’autorité de parler que d’en avoir la promptitude.
La mission de saint Jan Baptiste, quoiqu’elle ne fut du tout extraordinaire, ne fut elle pas authentiquëe par sa conception, sa nativité, et mesme par sa vie tant miraculeuse, a laquelle Nostre Seigneur donna si bon tesmoignage ?	La mission de saint Jan Baptiste, quoiqu’elle ne fut du tout extraordinaire, ne fut elle pas authentiquée par sa conception, sa nativité, et même par sa vie tant miraculeuse, à laquelle Notre Seigneur donna si bon témoignage?
Mays quand aux Apostres , qui ne sçait les miracles quilz faysoyent et le grand nombre d’iceux ?	Mais quand aux Apôtres, qui ne sait les miracles qu'ils faisaient et le grand nombre d’iceux?
leurs mouchoirs, leur ombre servoit a la prompte guerison des malades et a chasser le diable :	leurs mouchoirs, leur ombre servait à la prompte guérison des malades et à chasser le diable:
Par les mains des Apostres estoyent faitz beaucoup de signes et merveilles parmi le peuple (Act 5,12) et que ce fut en confirmation de leur praedication, saint Marc le dict tout ouvertement, es dernieres paroles de son Evangile, et saint Pol, aux Hebreux.	Par les mains des Apôtres étaient faits beaucoup de signes et merveilles parmi le peuple (Act 5,12) et que ce fut en confirmation de leur prédication, saint Marc le dit tout ouvertement, ès dernières paroles de son Evangile, et saint Paul, aux Hébreux.
Comment donques se voudront excuser et relever de ceste preuve pour leur mission ceux qui en nostr’aage en veulent avancer un’extraordinaire ?	Comment donc se voudront excuser et relever de cette preuve pour leur mission ceux qui en notre âge en veulent avancer une extraordinaire?
quel privilege ont ilz plus qu’Apostolique et Mosaique ?	quel privilège ont ils plus qu’Apostolique et Mosaïque?
Que diray je plus ?	Que dirai je plus?
Si nostre sauverain Maistre, consubstantiel au Pere, duquel la mission est si authentique qu’elle presuppose la communication de mesm’essence, luy mesme, dis je, qui est la source vive de toute mission ecclesiastique, n’a pas voulu s’exempter de ceste preuve de miracles, quelle rayson y a il que ces nouveaux ministres soyent crus a leur seule parole ?	Si notre souverain Maître, consubstantiel au Père, duquel la mission est si authentique qu’elle présuppose la communication de même essence, lui même, dis je, qui est la source vive de toute mission ecclésiastique, n’a pas voulu s’exempter de cette preuve de miracles, quelle raison y a-t-il que ces nouveaux ministres soient crus à leur seule parole?
Nostre Seigneur allegue fort souvent sa mission pour mettre sa parole en credit :	Notre Seigneur allègue fort souvent sa mission pour mettre sa parole en credit:
Comme mon Pere m’a envoyé, je vous envoÿe.	Comme mon Père m’a envoyé, je vous envoie.
(Jean XX, 21) Ma doctrine n’est point mienne, mays de Celuy qui m’a envoÿé (Jean VII, 16) Et vous me connoisses, et sçaves d’ou je suys, et ne suys point venu de par moy mesme.	(Jean XX, 21) Ma doctrine n’est point mienne, mais de Celui qui m’a envoyé (Jean VII, 16) Et vous me connaissez, et savez d’où je suis, et ne suis point venu de par moi même.
(28) Mays aussy, pour donner authorité a sa mission, il met en avant ses miracles, ains atteste que, s’il n’eust faict des oeuvres que nul autre n’a faict parmi les Juifz, ilz n’eussent point eu de péché de ne croire point en luy ;	(28) Mais aussi, pour donner autorité à sa mission, il met en avant ses miracles, ains atteste que, s’il n’eût fait des œuvres que nul autre n’a fait parmi les Juifs, ils n’eussent point eu de péché de ne croire point en lui;
et ailleurs il leur dict :	et ailleurs il leur dit:
Ne croyes vous pas que mon Pere est en moy et moy en mon Pere ?	Ne croyez vous pas que mon Père est en moi et moi en mon Père?
au moins croyes le par les oeuvres.	au moins croyez le par les œuvres.
(Jean XIV, 11-12) Qui sera donc si osé que de se vanter de lission extraordinayre, sans produire quand et quand des miracles, il merite d’estre tenu pour imposteur :	(Jean XIV, 11-12) Qui sera donc si osé que de se vanter de mission extraordinaire, sans produire quand et quand des miracles, il mérite d’être tenu pour imposteur:
or est il que ni vos premiers ni derniers ministres n’ont faict aucun miracle :	or est il que ni vos premiers ni derniers ministres n’ont fait aucun miracle:
ilz n’ont donq point de mission extraordinaire.	ils n’ont donc point de mission extraordinaire.
Passons outre.	Passons outre.
Je dis, secondement, que jamais aucune mission extraordinaire ne doit estre receüe, estant desadvouëe de l’authorité ordinaire qui est en l’Eglise de Nostre Seigneur.	Je dis, secondement, que jamais aucune mission extraordinaire ne doit être reçue, étant désavouée de l’autorité ordinaire qui est en l’Église de Notre Seigneur.
Car, 1.	Car, 1.
,nous sommes obligés d’obeir a nos pasteurs ordinaires sous peyne d’estre publicains et payens (Mat XVIII, 17) ;	,nous sommes obligés d’obéir à nos pasteurs ordinaires sous peine d’être publicains et païens (Mat XVIII, 17);
comment donques nous pourrions nous ranger sous autre discipline que la leur ?	comment donc nous pourrions nous ranger sous autre discipline que la leur?
les extraordinaires viendroyent pou neant, puysque nous serions obligés de ne les ouïr pas, en cas, comme j’ay dict, quilz fussent desavoüés des ordinaires.	les extraordinaires viendraient pour néant, puisque nous serions obligés de ne les ouïr pas, en cas, comme j’ai dit, qu'ils fussent désavoués des ordinaires.
2.	2.
Dieu n’est point autheur de division, mais d’union et de concorde (I Cor 14 , 33), principalement entre ses disciples et ministres ecclesiastiques, comme Nostre Seigneur monstre clairementen la sainte priere quil fit a son Pere es derniers jours de sa vie mortelle (Jean XVII,11 et 21) .	Dieu n’est point auteur de division, mais d’union et de concorde (I Cor 14 , 33), principalement entre ses disciples et ministres ecclésiastiques, comme Notre Seigneur monstre clairement en la sainte prière qu'il fit à son Père ès derniers jours de sa vie mortelle (Jean XVII,11 et 21) .
Comment donques authorizeroit il deux sortes de pasteurs, l’une extraordinaire, l’autre ordinaire ?	Comment donc autoriserait il deux sortes de pasteurs, l’une extraordinaire, l’autre ordinaire?
Quand a l’ordinaire qu’elle soit authorisëe, cela est certain ;	Quant à l’ordinaire qu’elle soit autorisée, cela est certain;
quand a l’extraordinaire, nous le praesupposons :	quant à l’extraordinaire, nous le présupposons:
ce seroyent donques deux eglises differentes, qui est contre la plus pure parole de Nostre Seigneur, qui n’a qu’une seul’espouse, qu’une seule colombe, qu’une seule parfaitte (Cant VI, 8) .	ce seraient donc deux églises différentes, qui est contre la plus pure parole de Notre Seigneur, qui n’a qu’une seule épouse, qu’une seule colombe, qu’une seule parfaite (Cant VI, 8) .
Et comme pourroit estre le trouppeau uny, conduict par deux pasteurs, incogneuz l’un a l’autre, a divers repaires, a divers huchemens et redans, et dont l’un et l’autre voudroit tout avoir ?	Et comme pourrait être le troupeau uni, conduit par deux pasteurs, inconnus l’un à l’autre, à divers repaires, à divers huchements et redans, et dont l’un et l’autre voudrait tout avoir?
Ainsy seroit l’Eglise, sous diversité de pasteurs ordinayres et extraordinaires, tirassëe ça et la en diverses sectes.	Ainsi serait l’Église, sous diversité de pasteurs ordinaires et extraordinaires, tirassée ça et là en diverses sectes.
Et quoy ?	Et quoi?
Nostre Seigneur est il divisé (1 Cor 1, 13) , ou en luy mesme ou en son cors qui est l’Eglise ?	Notre Seigneur est il divisé (1 Cor 1, 13) , ou en lui même ou en son cors qui est l’Église?
Non, pour vray, mays, au contraire, il ni a qu’un Seigneur (Eph IV, 5) lequel a bati son cors mistique (12) avec une belle variété de membres tres bien agencés (11), assemblés et serrés comtement, par toutes les joinctures de la sousministration mutuelle (16) ;	Non, pour vray, mays, au contraire, il n’y a qu’un Seigneur (Éph IV, 5) lequel a bâti son corps mystique (12) avec une belle variété de membres très bien agencés (11), assemblés et serrés comtement, par toutes les jointures de la sous-ministration mutuelle (16);
de façon que de vouloir mettr’en l’Eglise ceste division de troupes ordinairyres et extraordinaires, c’est la ruyner et perdre.	de façon que de vouloir mettre en l’Église cette division de troupes ordinaires et extraordinaires, c’est la ruiner et perdre.
Il faut donques revenir a ce que nous disions, que jamais la vocation extraordinaire n’est legitime quand ell’est desavouëe de l’ordinaire.	Il faut donc revenir à ce que nous disions, que jamais la vocation extraordinaire n’est légitime quand elle est désavouée de l’ordinaire.
3.	3.
Et de faict, ou me monstrera on jamais une vocation legitime extraordinaire qui n’aÿe esté receüe par l’authorité ordinayre ?	Et de fait, ou me montrera on jamais une vocation légitime extraordinaire qui n’aie été reçue par l’autorité ordinaire?
Saint Pol fut appellé extraordinairement (Act IX, 6), mays ne fut il pas approuvé et authorisé par l’ordinaire, une (Act IX, 7) et deux (Act XIII, 3) fois ?	Saint Paul fut appelé extraordinairement (Act IX, 6), mais ne fut il pas approuvé et autorisé par l’ordinaire, une (Act IX, 7) et deux (Act XIII, 3) fois?
et la mission receüe par l’authorité ordinaire est appellëe mission du Saint Esprit (Act XIII, 4).	et la mission reçue par l’autorité ordinaire est appelée mission du Saint Esprit (Act XIII, 4).
La mission de saint Jan Baptiste ne se peut pas bien dire extraordinaire, parce quil n’enseignoit rien contre l’eglise Mosaique, et par ce quil estoit de la race sacerdotale (Luc 1, 8) :	La mission de saint Jan Baptiste ne se peut pas bien dire extraordinaire, parce qu'il n’enseignait rien contre l’église Mosaïque, et parce qu'il était de la race sacerdotale (Luc 1, 8):
si est ce neanmoins que la rareté de sa doctrine fut avouëe par l’ordinayre magistrat de l’eglise judaique, en la belle legation qui luy fut faicte par les prestres et les levites (Jean 1, 19 et suiv), la teneur de laquelle praesuppose une grande estime et reputation en laquelle il estoit vers eux ;	si est ce néanmoins que la rareté de sa doctrine fut avouée par l’ordinaire magistrat de l’église judaïque, en la belle légation qui lui fut faite par les prêtres et les lévites (Jean 1, 19 et suiv), la teneur de laquelle présuppose une grande estime et réputation en laquelle il était vers eux;
et les Phariseens mesmes, qui estoyent assis sur la chaire de Moise, ne venoyent ilz pas communiquer a son baptesme (Mat 3, 5-7) tout ouvertement, sans scrupule ?	et les Pharisiens mêmes, qui étaient assis sur la chaire de Moise, ne venaient ils pas communiquer à son baptême (Mat 3, 5-7) tout ouvertement, sans scrupule?
c’estoit bien recevoir sa mission a bon escient.	c’était bien recevoir sa mission à bon escient.
Nostre Seigneur mesme, qui estoit le Maistre, ne voulut il pas estre receu de Simeon(Luc 2, 28 et 34) qui estoit prestre, comm’il appert en ce quil benit Nostre Dame et mesmes pour sa Passion, qui estoit l’execution principale de sa mission, ne voulut il pas avoir le tesmoignage prophetique du grand Prestre qui estoit pour lhors(Jean 11, 51) ?	Notre Seigneur même, qui était le Maître, ne voulut il pas être reçu de Simeon (Luc 2, 28 et 34) qui était prêtre, comme il appert en ce qu'il bénit Notre Dame et mêmes pour sa Passion, qui était l’exécution principale de sa mission, ne voulut il pas avoir le témoignage prophétique du grand Prêtre qui était pour lhors(Jean 11, 51)?
4.	4.
Et c’est ce que saint Pol enseigne , quand il ne veut que personne s’attribue l’honneur pastoral sinon celuy qui est appelé de Dieu, comm’Aaron (Heb 5, 4) :	Et c’est ce que saint Paul enseigne , quand il ne veut que personne s’attribue l’honneur pastoral sinon celui qui est appelé de Dieu, comm’Aaron (Heb 5, 4):
car la vocation d’Aaron fut faite par l’ordinaire, moyse, si que Dieu ne mit sa sainte parole en la bouche de’Aaron immediatement, mays Moyse, auquel Dieu fit ce commandement (Exode 4, 15) :	car la vocation d’Aaron fut faite par l’ordinaire, moïse, si que Dieu ne mit sa sainte parole en la bouche de’Aaron immédiatement, mais Moïse, auquel Dieu fit ce commandement (Exode 4, 15):
Parle a luy, et luy metz mes paroles en sa bouche ;	Parle à lui, et lui mets mes paroles en sa bouche;
et je seray en ta bouche et en la sienne.	et je serai en ta bouche et en la sienne.
Que si nous considerons les paroles de saint Pol, nous apprendrons mesme , 5.	Que si nous considérons les paroles de saint Paul, nous apprendrons même , 5.
que la vocation des pasteurs et magistratz ecclesiastiques doit estre faite visiblement ou perceptiblement, non par maniere d’enthousiasme et motion secrette :	que la vocation des pasteurs et magistrats ecclésiastiques doit être faite visiblement ou perceptiblement, non par manière d’enthousiasme et motion secrète:
car voyla deux exemples qui propose ;	car voilà deux exemples qui propose;
d’Aaron, qui fut oint et appelé visiblement (levitique 8, 12 Exode 28, 1), et puys de Nostre Seigneur et Maistre, qui, estant sauverain Pontife et Pasteur de tous les siecles, ne s’est point clarifié soy mesme (Heb 5, 5-6), c’est a dire, ne s’est point attribué l’honneur de sa sainte prestrise, comme avoit dict saint Pol au paravant, mays a esté illustré par Celuy qui luy a dict :	d’Aaron, qui fut oint et appelé visiblement (lévitique 8, 12 Exode 28, 1), et puis de Notre Seigneur et Maître, qui, étant souverain Pontife et Pasteur de tous les siècles, ne s’est point clarifié soi même (Heb 5, 5-6), c’est-à-dire, ne s’est point attribué l’honneur de sa sainte prêtrise, comme avait dit saint Paul au paravant, mais a été illustré par Celui qui lui a dit:
Tu es mon Filz, je t’ay engendré au jourdhuy, et, Tu es prestr’eternellement, selon l’ordre de Melchisedech.	Tu ès mon Fils, je t’ai engendré aujourd’hui, et, Tu es prêtre éternellement, selon l’ordre de Melchisédech.
Je vous prie, pense a ce trait.	Je vous prie, pense à ce trait.
Jesus Christ est sauverain Pontife selon l’ordre de Melchisedech :	Jesus Christ est souverain Pontife selon l’ordre de Melchisédech:
s’est il ingéré et poussé de luy mesme a cest honneur ?	s’est il ingéré et poussé de lui même à cet honneur?
non, mays y a esté appelé (Heb 5, 10) .	non, mais y a été appelé (Heb 5, 10) .
Qui l’a appelé ?	Qui l’a appelé?
son Pere eternel (5, 5).	son Père éternel (5, 5).
Et comment ?	Et comment?
immediatement et mediatement tout ensemble :	immédiatement et médiatement tout ensemble:
immediatement, en son Baptesme (Mat 3, 17) et en sa Transfiguration (Mat 17, 5) , avec ceste voix :	immédiatement, en son Baptême (Mat 3, 17) et en sa Transfiguration (Mat 17, 5) , avec cette voix:
Cestuyci est mon Filz bien aymé auquel j’ay pris mon bon plaisir, escoutes le ;	Cestui-ci est mon Fils bien aimé auquel j’ai pris mon bon plaisir, écoutez-le;
mediatement, par les Prophetes, et sur tout par David es lieux que saint Pol cite a propos des Psalmes :	médiatement, par les Prophètes, et sur tout par David ès lieux que saint Paul cite à propos des Psalmes:
Tu es mon Filz, je l’ay engendré aujourdhuy (Ps 2, 7), Tu es prestr’eternellement, selon l’ordre de Melchisedec (Ps 109, 4).	Tu ès mon Fils, je l’ai engendré aujourd’hui (Ps 2, 7), Tu es prêtre éternellement, selon l’ordre de Melchisédech (Ps 109, 4).
Et par tout la vocation est perceptible :	Et par tout la vocation est perceptible:
la parole en la nuëe fut ouÿe, et en David ouÿe et leüe ;	la parole en la nuée fut ouïe, et en David ouïe et lue;
mais saint Pol, voulant monstrer la vocation de Nostre Seigneur, apporte les passages seulz de david, par lesquelz il dit Nostre Seigneur avoir esté clarifié de son Pere, se contentant ainsy de produyre le tesmoignage perceptible, et faict par l’entremise des Escritures ordinaires et des Prophetes receuz.	mais saint Paul, voulant montrer la vocation de Notre Seigneur, apporte les passages seuls de david, par lesquels il dit Notre Seigneur avoir été clarifié de son Père, se contentant ainsi de produire le témoignage perceptible, et fait par l’entremise des Écritures ordinaires et des Prophètes reçus.
Je dis 3.	Je dis 3.
, que l’authorité de la mission extraordinaire ne destruict jamais l’ordinaire, et n’est donnee jamais pour la renverser :	, que l’autorité de la mission extraordinaire ne détruit jamais l’ordinaire, et n’est donnée jamais pour la renverser:
tesmoins tous les Prophetes, qui jamais ne firent autel contr’autel, jamais ne renverserent la prestrise d’Aaron, jamais n’abolirent les constitutions sinagogiques ;	témoins tous les Prophètes, qui jamais ne firent autel contre autel, jamais ne renversèrent la prêtrise d’Aaron, jamais n’abolirent les constitutions synagogiques;
tesmoin Nostre seigneur, qui asseure que tout royaume divisé en soymesme sera desolé, et l’une mayson tombera sur l’autre (Luc 11, 17) ;	témoin Notre seigneur, qui assure que tout royaume divisé en soi-même sera désolé, et l’une maison tombera sur l’autre (Luc 11, 17);
tesmoin le respect quil portoit a la chaire de Moyse, la doctrine de laquelle il vouloit estre gardëe (Mat 23, 2,3) .	témoin le respect qu'il portait à la chaire de Moïse, la doctrine de laquelle il voulait être gardée (Mat 23, 2,3) .
Et de vray, si l’extraordinaire devoit abolir l’ordinaire, comment sçaurions nous quand, a qui, et comment, nous nous y devrions ranger ?	Et de vrai, si l’extraordinaire devait abolir l’ordinaire, comment saurions nous quand, à qui, et comment, nous nous y devrions ranger?
Non, non, l’ordinaire est immortelle pendant que l’eglise sera ça bas au monde :	Non, non, l’ordinaire est immortelle pendant que l’église sera ça bas au monde:
Les pasteurs et docteurs quil a donnés une fois a l’eglise doivent avoir perpetuelle succession, pour la consummation des Saintz, jusques a ce que nous nous rencontrions tous en l’unité de la foy, et de la connoissance du Filz de Dieu, en homme parfaict, a la mesure de l’aage entiere de Christ ;	Les pasteurs et docteurs qu'il a donnés une fois à l’église doivent avoir perpétuelle succession, pour la consommation des Saints, jusques à ce que nous nous rencontrions tous en l’unité de la foi, et de la connaissance du Fils de Dieu, en homme parfait, à la mesure de l’âge entière de Christ;
affin que nous soyons plus enfans, flotans et demenés ça et la a tous vens de doctrin, par la piperie des hommes et par leur rusëe seduction (Ephes 4, 11-14).	affin que nous soyons plus enfants, flottants et démenés ça et là à tous vents de doctrine, par la piperie des hommes et par leur rusée séduction (Éphes 4, 11-14).
Voyla le beau discours que faict saint Pol, pour monstrer que si les docteurs et pasteurs ordinaires n’avoient perpetuelle succession, ains fussent sujetz a l’abrogation des extraordinaires, nous n’aurions aussi qu’une foy et discipline desordonnee et entrerompue a tous coupz, nous serions sujetz a estre seduitz par les hommes qui a tous propos se vanteroyent de l’extraordinaire vocation, ains, comme les Gentilz, nous cheminerions en la vanité de nos entendemens, un chacun se faysant accroire de sentir la motion extraordinaire du Saint esprit :	Voilà le beau discours que fait saint Paul, pour montrer que si les docteurs et pasteurs ordinaires n’avaient perpétuelle succession, ains fussent sujets à l’abrogation des extraordinaires, nous n’aurions aussi qu’une foi et discipline désordonnée et entrerompue à tous coups, nous serions sujets à être séduits par les hommes qui à tous propos se vanteraient de l’extraordinaire vocation, ains, comme les Gentils, nous cheminerions en la vanité de nos entendements, un chacun se faisant accroire de sentir la motion extraordinaire du Saint esprit:
dequoy nostre aage fournit tant d’exemples, que c’est une des plus fortes raysons qu’on puisse praesenter en cett’occasion ;	de quoi notre âge fournit tant d’exemples, que c’est une des plus fortes raisons qu’on puisse présenter en cette occasion;
car, si l’extraordinaire peut lever l’ordinair’administration, a qui en laisserons nous la charge ?	car, si l’extraordinaire peut lever l’ordinaire administration, à qui en laisserons nous la charge?
a calvin, ou a Luther ?	à calvin, ou à Luther?
a Luther, ou a u Pacimontain ?	à Luther, ou au Pacimontain?
au Pacimontain, ou a Blandrate, ou a Brence ?	au Pacimontain, ou à Blandrate, ou à Brence?
a Brence, ou a la Reyne d’Angleterre ?	à Brence, ou à la Reine d’Angleterre?
car chacun tirera de son costé ceste couverte de la mission extraordinaire.	car chacun tirera de son côté cette couverte de la mission extraordinaire.
Or la parole de Nostre Seigneur nous oste de toutes ces difficultés, qui a édifié son Eglise sur un si bon fondement, et avec une proportion si bien entendue, que les portes d’enfer ne praevaudront jamais contre elle (Mat 16, 18).	Or la parole de Notre Seigneur nous ôte de toutes ces difficultés, qui a édifié son Église sur un si bon fondement, et avec une proportion si bien entendue, que les portes d’enfer ne prévaudront jamais contre elle (Mat 16, 18).
Que si jamais elles n’ont praevalu ni praevaudront, la vocation extraordinaire n y est pas necessaire pour l’abolir :	Que si jamais elles n’ont prévalu ni prévaudront, la vocation extraordinaire n y est pas nécessaire pour l’abolir:
car Dieu ne hait rien de ce quil a faict, comment donq il aboliroit l’Eglis’ordinaire pour en faire d’extraordinaires ?	car Dieu ne hait rien de ce qu'il a fait, comment donc il abolirait l’Église ordinaire pour en faire d’extraordinaires?
veu que c’est luy qui a edifié l’ordinaire sur soymesme, et l’a cimentee de son sang propre.	vu que c’est lui qui a édifié l’ordinaire sur soi-même, et l’a cimentée de son sang propre.
114	114
ARTICLE IV	ARTICLE IV
Réponse aux arguments des Ministres	Réponse aux arguments des Ministres
Je n’ay encor sceu rencontrer parmy vos maistres que deux objections a ce discours que je viens de faire ;	Je n’ai encor su rencontrer parmi vos maîtres que deux objections à ce discours que je viens de faire;
dont l’une est tirëe de l’exemple de nostre seigneur et des Apostres, l’autre, de l’exemple des Prophetes.	dont l’une est tirée de l’exemple de notre seigneur et des Apôtres, l’autre, de l’exemple des Prophètes.
Mays, quand a la premiere, dites moy, je vous prie, trouves vous bon qu’on mette en comparaison la vocation de ces nouveuax ministres avec celle de Nostre Seigneur ?	Mays, quant à la première, dites-moi, je vous prie, trouvez-vous bon qu’on mette en comparaison la vocation de ces nouveaux ministres avec celle de Notre Seigneur?
Nostre Seigneur avoit il pas esté prophetisé en qualité de Messie ?	Notre Seigneur avait il pas été prophétisé en qualité de Messie?
son tems n’avoit il pas esté déterminé par Daniel (9, 24 et 26) ?	son temps n’avait il pas été déterminé par Daniel (9, 24 et 26)?
a-il faict action qui presque ne soit particulierement cottëe es Livres des Prophetes et figurëe es Patriarches ?	a-il fait action qui presque ne soit particulièrement cotée ès Livres des Prophètes et figurée ès Patriarches?
Il a faict changement de bien en mieux de la loy Mosaique, mays ce changement la n’avoit il pas esté praedit (Agg 2, 10) ?	Il a fait changement de bien en mieux de la loi Mosaïque, mais ce changement la n’avait il pas été prédit (Agg 2, 10)?
Il a changé par consequent le sacerdoce Aaronique en celuy de Melchisedech, beaucoup meilleur ;	Il a changé par conséquent le sacerdoce Aaronique en celui de Melchisédech, beaucoup meilleur;
tout cela n’est ce pas selon les tesmoignages anciens (Heb 5, 6) ?	tout cela n’est ce pas selon les témoignages anciens (Heb 5, 6)?
Vos ministres n’ont point esté prophetisés en qualité de praedicateurs de la Parole de Dieu, ni le tems de leur venue, ni pas une de leurs actions ;	Vos ministres n’ont point été prophétisés en qualité de prédicateurs de la Parole de Dieu, ni le temps de leur venue, ni pas une de leurs actions;
ils ont taict un remuement sur l’Eglise beaucoup plus grand et plus aspre que nostre Seigneur le fit sur la Sinagogue, car ilz ont tout osté sans y remettre que certaines ombres, mays de tesmoignages ilz n’en ont point a cest effect.	ils ont tait un remuement sur l’Église beaucoup plus grand et plus aspre que notre Seigneur le fit sur la Synagogue, car ils ont tout ôté sans y remettre que certaines ombres, mais de témoignages ils n’en ont point à cet effet.
Au moins ne se devroyent ilz pas exempter de prodyre des miracles sur une telle mutation, quoyque vous tiries praetexte de l’Escriture ;	Au moins ne se devraient ils pas exempter de produire des miracles sur une telle mutation, quoique vous tiriez prétexte de l’Écriture;
puysque Nostre seigneur ne s’en exempta pas, comme j’ay monstré cy dessus, encores que le changement quil faysoit fut puysé de la plus pure source des Escritures (Luc 1, 70).	puisque Notre seigneur ne s’en exempta pas, comme j’ai montré ci-dessus, encore que le changement qu'il faisait fut puisé de la plus pure source des Écritures (Luc 1, 70).
Mays ou me monstreront ilz que l’Eglise doive jamais plus recevoir un’autre forme, ou semblable reformation, que celle qu’y fit Nostre Seigneur ?	Mais ou me montreront ils que l’Église doive jamais plus recevoir une autre forme, ou semblable reformation, que celle qu’y fit Notre Seigneur?
	par les magistrats séculiers, par les Évêques, et par la voix extraordinaire;
Et quand aux Prophetes, j’envoys abusé plusieurs.	Et quant aux Prophètes, j’en vois abusé plusieurs.
1.	1.
On pense que toutes les vocations des Prophetes ayent esté extraordinayres et immediates :	On pense que toutes les vocations des Prophètes aient été extraordinaires et immédiates:
chose fause ;	chose fausse;
car il y avoit des colleges et des congregations de Prophetes reconneuz et advouêes par la Sinagogue, comme on peut recueillir de plusieurs passages de l’Escriture.	car il y avait des collèges et des congrégations de Prophètes reconnus et avouées par la Synagogue, comme on peut recueillir de plusieurs passages de l’Écriture.
Il y en avoyt en Ramatha, en Bethel, en Hiericho ou Elisëe habita, en la montagne d’Ephraim, en Samarie ;	Il y en avait en Ramatha, en Béthel, en Jéricho ou Élisée habita, en la montagne d’Éphraïm, en Samarie;
Elisëe mesme fut oint par Helie ;	Élisée même fut oint par Helie;
la vocation de samuel fut recogneûe et advouëe par le grand Prestre, et en Samuel recommença le Seigneur a s’apparoistre en Silo (voir les livres des Rois ), comme dict l’Escriture, qui faict que les Juifz tiennent samuel comme fondateur des congregations prophetiques.	la vocation de samuel fut reconnue et avouée par le grand Prêtre, et en Samuel recommença le Seigneur à s’apparaître en Silo (voir les livres des Rois), comme dit l’Écriture, qui fait que les Juifs tiennent samuel comme fondateur des congrégations prophétiques.
2.	2.
On pense que tous ceux qui prophetisoyent exerceassent la charge de la praedication :	On pense que tous ceux qui prophétisaient exerçassent la charge de la prédication:
ce qui n’estoit pas , comm’il appert des sergens de Paul et de Saul mesme(1 Rois 19, 20 et suiv).	ce qui n’était pas , comme il appert des sergents de Paul et de Saul même (1 Rois 19, 20 et suiv).
De façon que la vocation des Prohetes ne sert de rien a celle des haeretiques ou schismatiques, car :	De façon que la vocation des Prophètes ne sert de rien à celle des hérétiques ou schismatiques, car:
1.	1.
Ou ell’estoit ordinaire, comme nous avons monstré cy devant, ou approuvëe du reste de la Sinagogue, comm’il est aysé a voir en ce qu’on les reconnoissoit incontinent, et en faysoit on conte en tous lieux parmi les Juifz, les appelans hommes de Dieu (3 Rois 17, 18) :	Ou elle était ordinaire, comme nous avons montré ci-devant, ou approuvée du reste de la Synagogue, comme il est aisé à voir en ce qu’on les reconnaissait incontinent, et en faisait on conte en tous lieux parmi les Juifs, les appelant hommes de Dieu (3 Rois 17, 18):
et a qui regardera de pres l’histoire de cest’ancienne sinagogue, verra que l’office des Prophetes estoit aussy commun entr’eux qu’entre nous des praedicateurs.	et à qui regardera de près l’histoire de cette ancienne synagogue, verra que l’office des Prophètes était aussi commun entr’eux qu’entre nous des prédicateurs.
2.	2.
Jamais on ne monstrera prophete qui voulut renverser la puissance ordinaire, ains l’ont tousjours suyvie, et n’ont rien dict contraire a la doctrine de ceux qui estoyent assis sur la chaire Mosaique et Aaronique ;	Jamais on ne montrera prophète qui voulut renverser la puissance ordinaire, ains l’ont toujours suivie, et n’ont rien dit contraire à la doctrine de ceux qui étaient assis sur la chaire Mosaïque et Aaronique;
ains il s’en est trouvé qui estoyent de la race sacerdotale, comme Jeremie, filz d’helcias, et Ezechiel, filz de Buzi ;	ains il s’en est trouvé qui étaient de la race sacerdotale, comme Jérémie, fils d’helcias, et Ézéchiel, fils de Buzi;
ilz ont tousjours parlé avec honneur des Pontifes et succession sacerdotale, quoy quilz ayent repris leurs vices.	ils ont toujours parlé avec honneur des Pontifes et succession sacerdotale, quoi qu'ils aient repris leurs vices.
Isaïe, voulant escrire dans un grand livre qui luy fut monstré, prit Urie prestre, quoy qu’a venir, et zacharie prophete a tesmoins, comme s’il prenoyt le tesmoignage de tous les prestres et prophetes ;	Isaïe, voulant écrire dans un grand livre qui lui fut montré, prit Urie prêtre, quoi qu’a venir, et zacharie prophète à témoins, comme s’il prenait le témoignage de tous les prêtres et prophètes;
et Malachie atteste il pas que les levres du prestre gardent la science, et demanderont la loy de sa bouche ;	et Malachie atteste il pas que les lèvres du prêtre gardent la science, et demanderont la loi de sa bouche;
car l’ange du seigneur des armëes ?	car l’ange du seigneur des armées?
(Ezech 2, 7) tant s’en faut que jamais ilz ayent retiré les Juifz de la communion de l’ordinaire.	(Ezech 2, 7) tant s’en faut que jamais ils aient retiré les Juifs de la communion de l’ordinaire.
3.	3.
Les Prophetes, combien de miracles ont ilz faictz en confirmation de la vocation prophetique ?	Les Prophètes, combien de miracles ont ils faits en confirmation de la vocation prophétique?
ce ne seroit jamais faict si j’entrois en ce denombrement.	ce ne serait jamais fait si j’entrais en ce dénombrement.
Mays si quelquefois ilz ont faict quelquechose qui eut quelque visage d’extraordinaire pouvoir, incontinent les miracles se sont ensuyvis :	Mais si quelquefois ils ont fait quelque chose qui eut quelque visage d’extraordinaire pouvoir, incontinent les miracles se sont ensuivis:
tesmoin Elie, qui dressant un autel en Carmel selon l’instinct quil avoit eu du saint Esprit, et sacrifiant, monstrant par miracle quil le faisoit a l’honneur de Dieu et de la religion Juifve (3 Rois 18, 32 et 38).	témoin Elie, qui dressant un autel en Carmel selon l’instinct qu'il avait eu du saint Esprit, et sacrifiant, montrant par miracle qu'il le faisait à l’honneur de Dieu et de la religion Juive (3 Rois 18, 32 et 38).
4.	4.
En fin, vos ministres auroyent bonne grace silz vouloient s’usurper le pouvoir de prophetes, eux qui n’en ont jamais eu le don ni la lumiere :	En fin, vos ministres auraient bonne grâce s'ils voulaient s’usurper le pouvoir de prophètes, eux qui n’en ont jamais eu le don ni la lumière:
ce seroit plustost a nous, qui pourrions produire infinité des propheties des nostres ;	ce serait plutôt à nous, qui pourrions produire infinité des prophéties des nôtres;
comme de saint Gregoire Taumaturge, au rapport de saint Basile, de saint Anthoine, tesmoin Athanase, de l’abbé Jan, tesmoin saint Augustin, saint benoist, saint Bernard, saint françois et mill’autres ;	comme de saint Grégoire Thaumaturge, au rapport de saint Basile, de saint Antoine, témoin Athanase, de l’abbé Jan, témoin saint Augustin, saint benoît, saint Bernard, saint françois et mille autres;
Si donques il est question entre nous de l’authorité prophetique, elle nous demeurera, soit elle ordinaire ou extraordinaire, puysque nous en avons l’effect, non pas a vos ministres qui n’en ont jamais faict un brin de preuve :	Si donc il est question entre nous de l’autorité prophétique, elle nous demeurera, soit elle ordinaire ou extraordinaire, puisque nous en avons l’effet, non pas à vos ministres qui n’en ont jamais fait un brin de preuve:
sinon quilz voulussent appeller propheties de la vision de Zuingle, au livre inscrit, Subsidium de eucharistia, et le livre intitulé, Querela Lutheri, ou la praediction quil fit, l’an 25 de ce siecle, que sil praechoit encor deux ans il ne demeureroit ni pape, ni prestres, ni moynes, ni clochers, ni Messe.	sinon qu'ils voulussent appeler prophéties de la vision de Zwingli, au livre inscrit, Subsidium de eucharistia, et le livre intitulé, Querela Lutheri, ou la prédiction qu'il fit, l’an 25 de ce siècle, que s'il prêchait encor deux ans il ne demeurerait ni pape, ni prêtres, ni moines, ni clochers, ni Messe.
Et de vray, il ny a qu’un mal en ceste prophetie, c’est seulement faute de verité ;	Et de vrai, il n’y a qu’un mal en cette prophétie, c’est seulement faute de vérité;
car il praecha encor pres de vingt deux, et neantmoins encor se trouve il des prestres et des clochers, et en la chaire de saint pierre est assis un Pape legitime.	car il prêcha encor près de vingt deux, et néanmoins encor se trouve il des prêtres et des clochers, et en la chaire de saint pierre est assis un Pape légitime.
Vos premiers ministres donques, Messieurs, sont de ces prophetes que Dieu defendooit d’est’ouÿs parler, en Hieremie :	Vos premiers ministres donc, Messieurs, sont de ces prophètes que Dieu défendait d’être ouïs parler, en Jérémie:
ne veuïlles ouyr les paroles des prophetes qui prophetisent et vous deçoivent ;	ne veuilles ouïr les paroles des prophètes qui prophétisent et vous déçoivent;
ilz parlent la vision de leur coeur, et non point par la bouche du seigneur.	ils parlent la vision de leur coeur, et non point par la bouche du seigneur.
Je n’envoÿoys pas les prophetes et ilz couroyent ;	Je n’envoyais pas les prophètes et ils couraient;
je ne parloys pas a eux et ilz prophetisoyent.	je ne parlais pas à eux et ils prophétisaient.
J’ay ouÿ ce que les prophetes ont dict, prophetisans en mon nom le mensonge, et disans, j’ay songé, j’ay songé .	J’ai ouï ce que les prophètes ont dit, prophétisant en mon nom le mensonge, et disant, j’ai songé, j’ai songé.
(hier 22, 16,21 et 25).	(hier 22, 16,21 et 25).
Vous sembl’il pas que ce soyent luther et AZuingle avec leurs propheties et visions ?	Vous semble-t-il pas que ce soient luther et Zwingli avec leurs prophéties et visions?
ou Carolostade avec sa revelation quil disoit avoir eüe pour sa cene, qui donna occasion a Luther d’escrire son livre, Contra coelestes prophetas ?	ou Carolostade avec sa révélation qu'il disait avoir eue pour sa cène, qui donna occasion à Luther d’écrire son livre, Contra coelestes prophetas?
, C’est bien eux, au moins, qui ont ceste proprieté de n’avoir pas esté envoyés ;	, C’est bien eux, au moins, qui ont cette propriété de n’avoir pas été envoyés;
c’est eux qui prennent leurs langues, et disent, le Seigneur a dict (31) :	c’est eux qui prennent leurs langues, et disent, le Seigneur a dit (31):
car ilz ne sçauroyent jamais monstrer aucune preuve de la charge quilz usurpent, ilz ne sçauroyent produyre aucune legitime vocation, et, donques, comme veulent ilz precher ?	car ils ne sauraient jamais montrer aucune preuve de la charge qu'ils usurpent, ils ne sauraient produire aucune légitime vocation, et, donc, comme veulent ils prêcher?
On ne peut s’enrooler sans aucun capitayne sans l’aveû du prince, et comment fustes vous si promtz a vous engager sous la charge de ces premiers ministres, sans le congé de vos pasteurs ordinaires, sortir de l’estat auquel vous esties nay et nourry qui est l’Eglise Catholique ?	On ne peut s’enrôler sans aucun capitaine sans l’aveu du prince, et comment fustes vous si prompts à vous engager sous la charge de ces premiers ministres, sans le congé de vos pasteurs ordinaires, sortir de l’état auquel vous étiez né et nourri qui est l’Église Catholique?
Ilz sont coupables d’avoir faict de leur propr’authorité ceste levëe de bouclier, et vous de les avoir suyvis ;	Ils sont coupables d’avoir fait de leur propre autorité cette levée de bouclier, et vous de les avoir suivis;
dont vous estes inexcusables.	dont vous estes inexcusables.
Le bon enfant Samuel, humble, doux et saint, ayant esté apellé par trois fois de Dieu, pensa tousjours que ce fut Heli qui l’eut appellé :	Le bon enfant Samuel, humble, doux et saint, ayant été appelé par trois fois de Dieu, pensa toujours que ce fut Héli qui l’eut appelé:
1.	1.
par les peuples et magistratz, 2.	par les peuples et magistrats, 2.
par nos Evesques, 3.	par nos Évêques, 3.
par sa voix extraordinaire.	par sa voix extraordinaire.
Non, non, qu’ilz.	Non, non, qu’ils.
.	.
.	.
Samuel fut appellé troys fois de Dieu, et selon son humilité il pensoyt que ce fut une vocation d’homme, jusques a tant qu’enseigné par Heli il conneust que c’estoit la vois divine (1 Rois 3, 4-10) .	Samuel fut appelé trois fois de Dieu, et selon son humilité il pensait que ce fut une vocation d’homme, jusques à tant qu’enseigné par Heli il connût que c’était la voix divine (1 Rois 3, 4-10) .
Vos ministres, Messieurs, produysent trois vocations de Dieu :	Vos ministres, Messieurs, produisent trois vocations de Dieu:
par les magistratz seculiers, par les Evesques, et par la voix extraordinaire ;	par les magistrats séculiers, par les Évêques, et par la voix extraordinaire;
ilz pensent que ce soyt Dieu qui les aÿe appelé en ces troys façons la.	ils pensent que ce soit Dieu qui les aie appelé en ces trois façons la.
Mays non, ilz reconnoyssent que c’est une vocation de l’homme, et que les oreilles ont corné a leur viel Adam, et s’en remettent a celuy qui, comm’Heli, praeside maintenant a l’Eglise.	Mais non, ils reconnaissent que c’est une vocation de l’homme, et que les oreilles ont corné à leur vieil Adam, et s’en remettent à celui qui, comme Heli, préside maintenant à l’Église.
Et voyla la premiere rayson qui rend vos ministres et vous aussy, quoy qu’inegalement, inexcusables devant Dieu et les hommes d’avoir laissé l’Eglise.	Et voilà la première raison qui rend vos ministres et vous aussi, quoi qu’inégalement, inexcusables devant Dieu et les hommes d’avoir laissé l’Église.
	
CHAPITRE II	CHAPITRE II
Erreurs des ministres sur la Nature de l’Eglise	Erreurs des ministres sur la Nature de l’Église
120	120
ARTICLE PREMIER	ARTICLE PREMIER
QUE L’EGLISE CHRETIENNE EST VISIBLE	QUE L’EGLISE CHRETIENNE EST VISIBLE
121	121
Au contraire, Messieurs, l’Eglise, qui contredisoit et s’opposoit a vos premiers ministres, et s’oppose encores a ceux de ce tems, est si bien marquëe de tous costés, que personne, tant aveuglé soit il, ne peut praetendre cause d’ignorance du devoir que tous les bons Chrestiens luy ont, et que ce ne soit la vraÿe, unique, inseparable et tres chere Espouse du Roy celeste ;	Au contraire, Messieurs, l’Église, qui contredisait et s’opposait à vos premiers ministres, et s’oppose encore à ceux de ce temps, est si bien marquée de tous côtés, que personne, tant aveuglé soit il, ne peut prétendre cause d’ignorance du devoir que tous les bons Chrétiens lui ont, et que ce ne soit la vraie, unique, inséparable et très chère Épouse du Roi céleste;
qui rend vostre separation d’autant plus inexcusable.	qui rend votre séparation d’autant plus inexcusable.
Car, sortir de l’Eglise, et contredire a ses decretz, c’est tousjours se rendre ethnique et publicain (mat 18, 17), quand ce seroit a la persuasion d’un ange ou seraphim (Gal 1, 8) ;	Car, sortir de l’Église, et contredire à ses décrets, c’est toujours se rendre ethnique et publicain (mat 18, 17), quand ce serait à la persuasion d’un ange ou séraphin (Gal 1, 8);
mays, a la persuasion d’hommes pecheurs a la grande forme, comme les autres, personnes particulieres, sans authorité, sans adveu, sans aucune qualité requise a des precheurs ou profetes que la simple connoissance de quelques sciences, rompre tous les liens et la plus religieuse obligation d’obeissance qu’on eust en ce monde, qui est celle qu’on doit a l’Eglise comm’Espouse de Nostre Seigneur, c’est une faute qui ne se peut couvrir que d’une grande repentance et poenitence, a laquelle je vous invite de la part du Dieu vivant.	mais, à la persuasion d’hommes pêcheurs à la grande forme, comme les autres, personnes particulières, sans autorité, sans aveu, sans aucune qualité requise à des prêcheurs ou prophètes  que la simple connaissance de quelques sciences, rompre tous les liens et la plus religieuse obligation d’obéissance qu’on eût en ce monde, qui est celle qu’on doit à l’Église comme Épouse de Notre Seigneur, c’est une faute qui ne se peut couvrir que d’une grande repentance et pénitence, à laquelle je vous invite de la part du Dieu vivant.
Les adversaires, voyans bien qu’a ceste touche leur doctrine seroit reconneüe de bas or, ont tasché par tous moyens de nous divertir de ceste preuve invincible que nous prenons es marques de la vraÿe Eglise, et partant ont voulu maintenir que l’Eglise est invisible et imperceptible, et par consequent irremarquable.	Les adversaires, voyant bien qu’à cette touche leur doctrine serait reconnue de bas or, ont tâché par tous moyens de nous divertir de cette preuve invincible que nous prenons ès marques de la vraie Église, et partant ont voulu maintenir que l’Église est invisible et imperceptible, et par conséquent irremarquable.
Je crois que cestecy est l’extrem’absurdité, et qu’au pardela immediatement se loge la frenesie et la rage.	Je crois que cette-ci est l’extrême absurdité, et qu’au par-delà immédiatement se loge la frénésie et la rage.
Mays ilz vont par deux chemins a ceste leur opinion de l’invisibilité de l’eglise ;	Mais ils vont par deux chemins à cette leur opinion de l’invisibilité de l’église;
car les uns disent qu’ell’est invisible par ce qu’elle consiste seulement es personnes esleües et praedestinëes, les autres attribuent cest’invisibilité a la rareté et dissipation des croyans et fidelles :	car les uns disent qu’elle est invisible parce qu’elle consiste seulement ès personnes élues et prédestinées, les autres attribuent cette invisibilité à la rareté et dissipation des croyants et fidèles:
dont les premiers tiennent l’Eglis’estre en tous tems invisible, les autres disent que cest’invisibilité a duré environ mill’ans, ou plus ou moins, c’est a dire, des saint Gregoire jusqu’a Luther, quand la papauté estoit paysible parmi le Christianisme ;	dont les premiers tiennent l’Église être en tous temps invisible, les autres disent que cette invisibilité a duré environ mille ans, ou plus ou moins, c’est-à-dire, des saint Grégoire jusqu’à Luther, quand la papauté était paisible parmi le Christianisme;
car ilz disent que durant ce tems la il y avoit plusieurs vrais Chrestiens secretz, qui ne descouvroyent pas leurs intentions, et se contentoyent de servir ainsy Dieu a couvert.	car ils disent que durant ce temps la il y avait plusieurs vrais Chrétiens secrets, qui ne découvraient pas leurs intentions, et se contentaient de servir ainsi Dieu à couvert.
Ceste theologie est tant imaginaire et damnatoire, que les autres ont mieux aymé dire que durant ces mill’ans l’Eglise n’estoit ni visible ni invisible, mays du tout abolie et estoufëe par l’impieté et l’idolatrie.	Ceste théologie est tant imaginaire et damnatoire, que les autres ont mieux aimé dire que durant ces mille ans l’Église n’était ni visible ni invisible, mais du tout abolie et étouffée par l’impiété et l’idolâtrie.
Permettes moy, je vous prie, que je die librement la verité.	Permettez-moi, je vous prie, que je dis librement la vérité.
Tous ces discours ressentent le mal de chaud ;	Tous ces discours ressentent le mal de chaud;
ce sont des songes qu’on faict en veilllant, qui ne valent pas celuy que Nabuchodonosor fit en dormant ;	ce sont des songes qu’on fait en veillant, qui ne valent pas celui que Nabuchodonosor fit en dormant;
aussy luy sont ilz du tout contraires, si nous croyons a l’interpretation de Daniel (Daniel 2, 34) :	aussi lui sont ils du tout contraires, si nous croyons à l’interprétation de Daniel (Daniel 2, 34):
car Nabuchodonosor vit une pierre taillëe d’un mont sans oeuvre de mains, qui vint roulant et renversa la grande statue, et s’accreut tellement que devenue montagne elle remplit toute la terre ;	car Nabuchodonosor vit une pierre taillée d’un mont sans œuvre de mains, qui vint roulant et renversa la grande statue, et s’accrut tellement que devenue montagne elle remplit toute la terre;
et Daniel l’entendit du royaume de Nostre Seigneur qui demeurera aeternellement (vers 44).	et Daniel l’entendit du royaume de Notre Seigneur qui demeurera éternellement (vers 44).
S’il est comm’une montaigne, et si grande qu’elle remplit la terre, comme sera elle invisible ou secrette ?	S’il est comme une montagne, et si grande qu’elle remplit la terre, comme sera elle invisible ou secrète?
et s’il dure aeternellement, comm’aura il manqué 1000 ans ?	et s’il dure éternellement, comme aura il manqué 1000 ans?
Et c’est bien du royaume de l’Eglise que s’entend ce passage :	Et c’est bien du royaume de l’Église que s’entend ce passage:
car 1.	car 1.
celuy de la triomphante remplira le ciel, non la terre seulement, et ne s’eslevera pas au tems des autres royaumes, comme porte l’interpretation de Daniel, mais apres la consommation du siecle ;	celui de la triomphante remplira le ciel, non la terre seulement, et ne s’élèvera pas au temps des autres royaumes, comme porte l’interprétation de Daniel, mais après la consommation du siècle;
joint que d’estre taillé de la montaigne sans oeuvre manuelle appartient a lgenration temporelle de Nostre Seigneur, selon laquelle il a esté conceu au ventre de la Vierge, engendré de sa propre substance sans oeuvre humayne, par la seule benediction du Saint Esprit.	joint que d’être taillé de la montagne sans œuvre manuelle appartient à la génération temporelle de Notre Seigneur, selon laquelle il a été conçu au ventre de la Vierge, engendré de sa propre substance sans œuvre humaine, par la seule bénédiction du Saint Esprit.
Ou donques Daniel a mal deviné, ou les adversaires de l’Eglise Catholique, quand ilz disoyent l’Eglis’estre invisible, cachêe et abolie.	Ou donc Daniel a mal deviné, ou les adversaires de l’Église Catholique, quand ils disaient l’Église être invisible, cachée et abolie.
Ayes patience, au nom de Dieu ;	Ayez patience, au nom de Dieu;
nous irons par ordre et briefvement, monstrant la vanité de ces opinions.	nous irons par ordre et brièvement, montrant la vanité de ces opinions.
Mays il faut avant tout dire que c’est qu’Eglise.	Mais il faut avant tout dire que c’est qu’Église.
Eglise vient du mot grec qui veut dire, appeler ;	Église vient du mot grec qui veut dire, appeler;
Eglise donques signifie un’assemblëe ou compaignie de gens appellés :	Église donc signifie une assemblée ou compagnie de gens appelés:
Sinagogue veut dire un troupeau, a proprement parler.	Synagogue veut dire un troupeau, à proprement parler.
L’assemblëe des juifz s’appellloyt Sinagogue, celle des Chrestiens s’appelle Eglise :	L’assemblée des juifs s’appelait Synagogue, celle des Chrétiens s’appelle Église:
par ce que les Juifz estoyent comm’un troupeau de bestail, asemblé et entroupelé par crainte, les Chrestiens sont assemblés par la Parole de Dieu, appellés ensembleen union de charité par la praedication des Apostres et leurs successeurs ;	parce que les Juifs étaient comme un troupeau de bétail, assemblé et entroupelé par crainte, les Chrétiens sont assemblés par la Parole de Dieu, appelés ensemble en union de charité par la prédication des Apôtres et leurs successeurs;
dont saint Augustin a dict :	dont saint Augustin a dit:
