MAdemoiselle, C'eſt vne Fille à qui Rome a eſleué des Statuës, qui s'en va dire à VOSTRE ALTESSE que vous meritez d'en auoir:	MAdemoiselle, C’est une Fille à qui Rome a élevé des Statues, qui s’en va dire à VOSTRE ALTESSE que vous méritez d’en avoir:
& que ſi nous eſtions encore en vn temps où la vertu fuſt recompensée, la voſtre vous feroit obtenir des Autels, de la reconnoiſſance Publique.	et que si nous étions encore en un temps où la vertu fût récompensée, la vôtre vous ferait obtenir des Autels, de la reconnaissance Publique.
En effet, comme peu de Princeſſes ont vne Naiſſance auſſi illuſtre que vous l'auez, moins encore ont voſtre vertu:	En effet, comme peu de Princesses ont une Naissance aussi illustre que vous l’avez, moins encore ont votre vertu:
& quoy qu'il y ait eu des Reſtaurateurs de l'Eſtat dans voſtre Maiſon, & qu'il y ait des Heros dans voſtre Alliance;	et quoiqu’il y ait eu des Restaurateurs de l’État dans votre Maison, et qu’il y ait des Héros dans votre Alliance;
voſtre bonté vous rend encore plus conſiderable que voſtre Grandeur.	votre bonté vous rend encore plus considérable que votre Grandeur.
Oſeray-ie vous le dire MADEMOISELLE? la plus part des perſonnes de voſtre condition, manquent d'vne qualité ſi neceſſaire:	Oserai-je vous le dire MADEMOISELLE? la plupart des personnes de votre condition, manquent d’une qualité si nécessaire:
elles naiſſent dans vn ſi grand eſclat, qu'elles s'en eſbloüiſſent elles meſmes:	elles naissent dans un si grand éclat, qu’elles s’en éblouissent elles-mêmes:
& les Flateurs qui les aprochent, corrompant leurs belles inclinations, leur perſuadent qu'elles ne ſont plus ce que nous ſommes;	et les Flatteurs qui les approchent, corrompant leurs belles inclinations, leur persuadent qu’elles ne sont plus ce que nous sommes;
qu'elles doiuent auoir des Regles à part;	qu’elles doivent avoir des Règles à part;
& que la bonté eſt vne vertu populaire, qui ne doit point aprocher des Throſnes ny des Baluſtres.	et que la bonté est une vertu populaire, qui ne doit point approcher des Trônes ni des Balustres.
Mais comme vos ſentimens ſont plus Nobles & plus equitables, vous ſuiuez des Maximes plus humaines:	Mais comme vos sentiments sont plus Nobles et plus équitables, vous suivez des Maximes plus humaines:
ayant peu de choſe à regarder au deſſus de vous, V. A. ne deſdaigne pas d'abaiſſer les yeux au deſſous d'elle:	ayant peu de chose à regarder au-dessus de vous, V. A. ne dédaigne pas d’abaisser les yeux au dessous d’elle:
& ſon obligeante facilité la fait autant aimer de tout le monde, que le Sang des Rois dont elle eſt, l'en fait reſpecter.	et son obligeante facilité la fait autant aimer de tout le monde, que le Sang des Rois dont elle est, l’en fait respecter.
V.A. a de la beaute, V. A. a infiniment de l'eſprit, & meſme du plus eſclairé:	V.A. a de la beauté, V. A. a infiniment de l’esprit, et même du plus éclairé:
mais apres auoir dit toutes ces choſes, ie crois encore dire dauantage, quand ie dis que V. A, a de la bonté.	mais après avoir dit toutes ces choses, je crois encore dire davantage, quand je dis que V. A, a de la bonté.
C'eſt donc à cette bonté, Mademoiselle, que CLELIE va demander protection:	C’est donc à cette bonté, Mademoiselle, que CLÉLIE va demander protection:
& cette illuſtre Romaine, à qui l'orgueil du Tibre ne fit point de peur, quand elle le trauerſa à la nage, trauerſoit l'Océan, pour vous aller rendre vn deuoir ſi legitime.	et cette illustre Romaine, à qui l’orgueil du Tibre ne fit point de peur, quand elle le traversa à la nage, traversait l’Océan, pour vous aller rendre un devoir si légitime.
Il eſt vray que ſi ie confonds mes intereſts auec les ſiens y elle s'y trouue obligée par bien plus d'vne raiſon car i'ay eu la gloire d'eſtre aimé de feuë Madame voſtre mere:	Il est vrai que si je confonds mes intérêts avec les siens y elle s’y trouve obligée par bien plus d’une raison car j’ai eu la gloire d’être aimé de feue Madame votre mère:
d’auoir quelque part en l'eſtime de feu Monſeigneur le Comte de Soiſſons voſtre Oncle:	d’avoir quelque part en l’estime de feu Monseigneur le Comte de Soissons votre Oncle:
& V. A. ſçait quel eſt mon attachement pour Madame de Longueuille, & pour toute ſa Maiſon.	et V. A. sait quel est mon attachement pour Madame de Longueville, et pour toute sa Maison.
Que vous diray-ie encore MADEMOISELLE? pluſieurs Gentils hommes de nos Parens, ont eu l'auantage d'eſtre à Monſeigneur voſtre Pere:	Que vous dirai-je encore MADEMOISELLE? plusieurs Gentilshommes de nos Parents, ont eu l’avantage d’être à Monseigneur votre Père:
de mes Parentes ont eu celuy d'eſtre vos Dames d'honneur:	de mes Parentes ont eu celui d’être vos Dames d’honneur:
& i'ay eu moy meſme la gloire d'eſtre aſſez long-temps attaché à la ſuite du Grand Prince à qui vous deueZ la vie, quoy que ie ne fuſſe pas ſon Domeſtique.	et j’ai eu moi même la gloire d’être assez longtemps attaché à la suite du Grand Prince à qui vous devez la vie, quoi que je ne fusse pas son Domestique.
Enfin i'ay reçeu ſept ans tous  entiers, les commandemens de Monſeigneur le Prince de Carignan voſtre Oncle, dans les Armées du Grand Charles Emanuel ſon Pere, de qui i'auois l’honneur d'eſtre aimé: ainſi,	Enfin j’ai reçu sept ans tous entiers, les commandements de Monseigneur le Prince de Carignan votre Oncle, dans les Armées du Grand Charles Emanuel son Père, de qui j’avais l’honneur d’être aimé: ainsi,
MADEMOISELLE, ſoit que ie vous conſidere, ou ſoit que ie me regarde, ie me trouue touſiours obligé de faire ce que ie fais:	MADEMOISELLE, soit que je vous considère, ou soit que je me regarde, je me trouve toujours obligé de faire ce que je fais:
& de ne chercher point d'autre protection à CLELIE, que celle de V. A.	et de ne chercher point d’autre protection à CLÉLIE, que celle de V. A.
I'eſpere que vous ne la luy refuſereZ pas:	I’espère que vous ne la lui refuserez pas:
& que vous adiouſterez à cette grace, celle d'agréer que ie ſois toute ma vie,	et que vous ajouterez à cette grâce, celle d’agréer que je sois toute ma vie,
MADEMOISELLE, De V. A. Le tres-humble, & tres-obeïſſant Seruiteur, DE SCVDERY.	MADEMOISELLE, De V. A. Le très humble, et très obéissant Serviteur, DE SCUDÉRY.
IL ne fut iamais vn plus beau iour que celuy qui deuoit preceder les Nopces de l’illuſtre Aronce, & de l'admirable Clelie:	IL ne fut jamais un plus beau jour que celui qui devait précéder les Noces de l’illustre Aronce, et de l’admirable Clélie:
& depuis que le Soleil auoit commencé de couronner le Printemps de Roſes & de Lis, il n’auoit iamais eſclairé la fertile Campagne de la delicieuſe Capouë, auec des Rayons plus purs, ny reſpandu plus d’or & de lumiere dans les Ondes du fameux Vulturne, qui arroſe ſi agreablement vn des plus beaux Païs du Monde.	et depuis que le Soleil avait commencé de couronner le Printemps de Roses et de Lis, il n’avait jamais éclairé la fertile Campagne de la délicieuse Capoue, avec des Rayons plus purs, ni répandu plus d’or et de lumière dans les Ondes du fameux Vulturne, qui arrose si agréablement un des plus beaux Pays du Monde.
Le Ciel eſtoit ſerain, le Fleuue eſtoit tranquile, tous les Vents eſtoient renfermez dans ces Demeures ſouſterraines, d'où ils ſçauent ſeuls les routes & les deſtours;	Le Ciel était serein, le Fleuve était tranquille, tous les Vents étaient renfermés dans ces Demeures souterraines, d’où ils savent seuls les routes et les détours;
& les Zephirs meſme n’auoient pas alors plus de force qu’il en falloit pour agiter agreablement les beaux cheueux de la belle Clelie:	et les Zéphirs même n’avaient pas alors plus de force qu’il en fallait pour agiter agréablement les beaux cheveux de la belle Clélie:
qui ſe voyant à la veille de rendre heureux le plus parfait Amant qui fut iamais, auoit dans le cœur, & dans les yeux, la meſme tranquilité qui paroiſſoit eſtre alors en toute la Nature.	qui se voyant à la veille de rendre heureux le plus parfait Amant qui fut jamais, avait dans le cœur, et dans les yeux, la même tranquillité qui paraissait être alors en toute la Nature.
Pour Aronce, quoy qu’il euſt encore plus de ioye que Clelie, parce qu’il auoit encore plus d'amour;	Pour Aronce, quoiqu’il eût encore plus de joie que Clélie, parce qu’il avait encore plus d’amour;
il ne laiſſoit pas d'auoir quelque-fois vne certaine agitation d’eſprit, qui reſſembloit à l’inquietude durant quelques momens. En effet il trouuoit qu’il n’euſt pas teſmoigné aſſez d’ardeur, ſi la ſeule eſperance d’eſtre heureux le lendemain l’euſt entierement ſatisfait:	il ne laissait pas d’avoir quelquefois une certaine agitation d’esprit, qui ressemblait à l’inquiétude durant quelques moments. En effet il trouvait qu’il n’eût pas témoigné assez d’ardeur, si la seule espérance d’être heureux le lendemain l’eût entièrement satisfait:
ainſi il murmuroit contre la longueur des iours, quoy qu’il ne fuſt encore qu’aux premiers iours du Printemps;	ainsi il murmurait contre la longueur des jours, quoiqu’il ne fût encore qu’aux premiers jours du Printemps;
& il regardoit alors les heures comme des Siecles.	et il regardait alors les heures comme des Siècles.
Cette douce inquietude, qui n’eſtoit cauſée que par vne impatience amoureuſe, ne l’empeſchoit pourtant pas d’eſtre de fort agreable humeur:	Cette douce inquiétude, qui n’était causée que par une impatience amoureuse, ne l’empêchait pourtant pas d’être de fort agréable humeur:
quoy qu’il euſt d’ailleurs quelque choſe dans l’eſprit qui luy donnoit de la peine.	quoiqu’il eût d’ailleurs quelque chose dans l’esprit qui lui donnait de la peine.
En effet il s’imaginoit toujours qu’il arriueroit quelque accident qui retarderoit encore ſon bonheur, comme il auoit eſté retardé:	En effet il s’imaginait toujours qu’il arriverait quelque accident qui retarderait encore son bonheur, comme il avait été retardé:
car il euſt deſia eſpouſé ſa Maiſtreſſe, n’euſt eſté que le Fleuue au bord duquel eſtoit vne tres belle Maiſon, où Clelius auoit reſolu de faire les Nopces de ſa Fille, s’eſtoit accru d’vne ſi terrible maniere, qu’il n’y auoit pas eu moyen de ſonger à faire vne Feſte pendant vn rauage ſi extraordinaire.	car il eût déjà épousé sa Maîtresse, n’eût été que le Fleuve au bord duquel était une très belle Maison, où Clélius avait résolu de faire les Noces de sa Fille, s’était accru d’une si terrible manière, qu’il n’y avait pas eu moyen de songer à faire une Fête pendant un ravage si extraordinaire.
Car ce Fleuue s’eſtoit débordé tout d’vn coup, auec vne telle impetuoſité, que durant douze heures ſes eaux auoient augmenté de moment en moment.	Car ce Fleuve s’était débordé tout d’un coup, avec une telle impétuosité, que durant douze heures ses eaux avaient augmenté de moment en moment.
De plus, le Vent, les Eſclairs, le Tonnerre, & vne pluye eſpouuantable, auoient encore adiouſté tant d’horreur à cette innondation, qu’on euſt dit que tout deuoit perir.	De plus, le Vent, les Éclairs, le Tonnerre, et une pluie épouvantable, avaient encore ajouté tant d’horreur à cette inondation, qu’on eût dit que tout devait périr.
L’eau du Fleuue ſembloit ſe vouloir eſleuer iuſques au Ciel;	L’eau du Fleuve semblait se vouloir élever jusqu’au Ciel;
& l’eau qui tomboit du Ciel eſtoit ſi abondante, & ſi agitée, par les diuers tourbillons qui s'entre-choquoient, que le Fleuue faiſoit autant de bruit que la Mer;	et l’eau qui tombait du Ciel était si abondante, et si agitée, par les divers tourbillons qui s’entrechoquaient, que le Fleuve faisait autant de bruit que la Mer;
& la Pluye en faiſoit meſme autant que la chûté des plus fiers Torrens en peut faire.	et la Pluie en faisait même autant que la chute des plus fiers Torrents en peut faire.
Auſſi ce rauage fit-il d’eſtranges deſordres dans cét aimable Païs:	Aussi ce ravage fit-il d’étranges désordres dans cet aimable Pays:
car il démolit pluſieurs Baſtimens, publics & particuliers;	car il démolit plusieurs Bâtiments, publics et particuliers;
il deſracina des Arbres;	il déracina des Arbres;
couurit les Champs de Sable & de Pierres;	couvrit les Champs de Sable et de Pierres;
aplanit des Colines;	aplanit des Collines;
creuſa des Campagnes;	creusa des Campagnes;
& changea preſques toute la face de cette petite Contrée.	et changea presque toute la face de cette petite Contrée.
Mais ce qu’il y eut de remarquable, fut que lors que cét Orage fut paſſé, on vit que le rauage des eaux auoit déterré les ruines de diuers Tombeaux magnifiques, dont les Inscriptions eſtoient à moitié effacées:	Mais ce qu’il y eut de remarquable, fut que lorsque cet Orage fut passé, on vit que le ravage des eaux avait déterré les ruines de divers Tombeaux magnifiques, dont les Inscriptions étaient à moitié effacées:
qu’en quelques autres lieux, il auoit deſcouuert de grandes Colomnes toutes d’vne piece:	qu’en quelques autres lieux, il avait découvert de grandes Colomnes toutes d’une pièce:
pluſieurs ſuperbes Vaſes antiques d’Agathe, de Porphire, de Iaſpe, de Terre Samienne, & de pluſieurs autres matieres precieuſes:	plusieurs superbes Vases antiques d’Agathe, de Porphire, de Jaspe, de Terre Samienne, et de plusieurs autres matières précieuses:
de ſorte que cét endroit au lieu d’auoir perdu quelque choſe de ſa beauté, auoit aquis de nouueaux ornemens.	de sorte que cet endroit au lieu d’avoir perdu quelque chose de sa beauté, avait acquis de nouveaux ornements.
Auſſi eſtoit-ce aupres de ces belles & magnifiques ruines, qu’Aronce & Clelie, conduits par Clelius, & par Sulpicie ſa Femme, & accompagnez d’vne petite Troupe choiſie qui deuoit eſtre aux Nopces de ces illuſtres Amants qui ſe deuoient faire le lendemain, ſe promenoient auec beaucoup de plaiſir:	Aussi était-ce auprès de ces belles et magnifiques ruines, qu’Aronce et Clélie, conduits par Clélius, et par Sulpicie sa Femme, et accompagnés d’une petite Troupe choisie qui devait être aux Noces de ces illustres Amants qui se devaient faire le lendemain, se promenaient avec beaucoup de plaisir:
Aronce ne ſe ſouuenant plus alors de toutes les peines que ſes Riuaux luy auoient données.	Aronce ne se souvenant plus alors de toutes les peines que ses Rivaux lui avaient données.
Car le temps de ſon bonheur ſembloit eſtre ſi proche, le iour eſtoit ſi beau;	Car le temps de son bonheur semblait être si proche, le jour était si beau;
le lieu ſi agreable;	le lieu si agréable;
la Compagnie ſi diuertiſſante & ſi enioüée;	la Compagnie si divertissante et si enjouée;
& Clelie eſtoit ſi belle, & luy eſtoit ſi fauorable;	et Clélie était si belle, et lui était si favorable;
qu’il n’eſtoit pas poſſible que ce qu’il y auoit encore de fâcheux en ſa fortune, le fuſt aſſez, pour l’empeſcher d’auoir vne ioye exceſſiue, bien qu’elle fuſt quelquesfois interrompuë, comme ie l'ay deſia dit, par quelque inquiettude.	qu’il n’était pas possible que ce qu’il y avait encore de fâcheux en sa fortune, le fût assez, pour l’empêcher d’avoir une joie excessive, bien qu’elle fût quelquefois interrompue, comme je l’ai déjà dit, par quelque inquiétude.
C’eſt pourquoy voulant alors teſmoigner à la belle & incomparable Clelie vne partie des ſentimens de ioye qu'il auoit dans l'ame, il la ſepara adroitement de dix ou douze pas de cette agreable Troupe qui les ſuiuoit:	C’est pourquoi voulant alors témoigner à la belle et incomparable Clélie une partie des sentiments de joie qu’il avait dans l’âme, il la sépara adroitement de dix ou douze pas de cette agréable Troupe qui les suivait:
luy ſemblant que ce qu’il diſoit à Clelie lors qu’il n’eſtoit entendu que d’elle, faiſoit beaucoup plus d’impreſſion dans son esprit.	lui semblant que ce qu’il disait à Clélie lorsqu’il n’était entendu que d’elle, faisait beaucoup plus d’impression dans son esprit.
Mais lors qu’il voulut paſſer d’vne converſation generale, à vne conuersation particuliere;	Mais lorsqu’il voulut passer d’une conversation générale, à une conversation particulière;
& qu’il tourna la teſte pour voir s’il eſtoit aſſez loin de ceux qui les ſuiuoient, pour n’eſtre entendu que de Clelie;	et qu’il tourna la tête pour voir s’il était assez loin de ceux qui les suivaient, pour n’être entendu que de Clélie;
il vit paroiſtre à l’entrée d’vn petit Bois, qui n’eſtoit qu'à trente pas d’eux, le plus braue, & le plus honneſte homme de ſes Riuaux, qui s’apelloit Horace:	il vit paraître à l’entrée d’un petit Bois, qui n’était qu’à trente pas d’eux, le plus brave, et le plus honnête homme de ses Rivaux, qui s’appelait Horace:
& il l’y vit paroiſtre accompagné de quelques-vns de ſes Amis.	et il l’y vit paraître accompagné de quelques-uns de ses Amis.
Cette veuë ſurprit ſans doute Aronce: mais elle ſurprit pourtant encore plus Clelie:	Cette vue surprit sans doute Aronce: mais elle surprit pourtant encore plus Clélie:
qui craignant de voir arriuer quelque funeſte accident, quitta Aronce pour aller vers ſon Pere, afin de l’obliger à faire ce qu’il pourroit, pour empeſcher qu’Horace & cét heureux Amant n’en vinſſent aux mains.	qui craignant de voir arriver quelque funeste accident, quitta Aronce pour aller vers son Père, afin de l’obliger à faire ce qu’il pourrait, pour empêcher qu’Horace et cet heureux Amant n’en vinssent aux mains.
Mais à peine eut elle fait cinq ou ſix pas, qu’vn tremblement de Terre effroyable, où ce Païs-là eſt ſi ſuiet, commença tout d’vn coup:	Mais à peine eut elle fait cinq ou six pas, qu’un tremblement de Terre effroyable, où ce Pays-là est si sujet, commença tout d’un coup:
& commença auec vne telle impetuoſité, que la Terre s’entre-ouurant entre Aronce & Clelie, auec des mugiſſemens auſſi effroyables que ceux de la Mer irritée, il en ſortit en vn inſtant vne Flame ſi eſpouuentable, qu’elle les déroba eſgallement à la veuë l’vn de l’autre:	et commença avec une telle impétuosité, que la Terre s’entrouvrant entre Aronce et Clélie, avec des mugissements aussi effroyables que ceux de la Mer irritée, il en sortit en un instant une Flamme si épouvantable, qu’elle les déroba également à la vue l’un de l’autre:
& tout ce que vit alors le malheureux Aronce, fut que la Terre s’entre-ouurant de par tout, il eſtoit enuironné de Flames ondoyantes, qui faiſant autant de Figures differentes qu’on en voit quelquefois aux Nuës, luy firent voir le plus affreux obiet du monde.	et tout ce que vit alors le malheureux Aronce, fut que la Terre s’entrouvrant de partout, il était environné de Flammes ondoyantes, qui faisant autant de Figures différentes qu’on en voit quelquefois aux Nues, lui firent voir le plus affreux objet du monde.
Leur couleur bleüatre, entre-meſlée de rouge, de jaune, & de vert (qui s’entortilloient enſemble de cent bizarres manieres) rendoient la veuë de ces Flames ſi affreuse, que tout autre cœur que celuy d’Aronce auroit ſuccombé en vne pareille rencontre.	Leur couleur bleuâtre, entremêlée de rouge, de jaune, et de vert (qui s’entortillaient ensemble de cent bizarres manières) rendaient la vue de ces Flammes si affreuse, que tout autre cœur que celui d’Aronce aurait succombé en une pareille rencontre.
Car cét Abiſme qui s’eſtoit entre-ouuert entre Clelie & luy, & qui les auoit ſeparez auec tant de violence;	Car cet Abîme qui s’était entrouvert entre Clélie et lui, et qui les avait séparés avec tant de violence;
auoit quelque choſe de ſi terrible à voir, que l'imagination ne ſçauroit ſe le figurer.	avait quelque chose de si terrible à voir, que l’imagination ne saurait se le figurer.
En effet vne fumée eſpaiſſe & noire, ayant preſques en vn moment caché le Soleil, & obſcurci l’air, comme s’il euſt eſté nuit, on voyoit quelquefois ſortir de ce Gouffre vne abondance eſtrange de Flames tumultueuses;	En effet une fumée épaisse et noire, ayant presque en un moment caché le Soleil, et obscurci l’air, comme s’il eût été nuit, on voyait quelquefois sortir de ce Gouffre une abondance étrange de Flammes tumultueuses;
qui ſe dilatant apres dans l’air, eſtoient emportées comme des Tourbillons de feu, par les Vents qui ſe leuerent alors de diuers coſtez.	qui se dilatant après dans l’air, étaient emportées comme des Tourbillons de feu, par les Vents qui se levèrent alors de divers côtés.
Ce qu’il y auoit encore d’eſtonnant, eſtoit que dans le meſme temps que la Foudre faiſoit retentir tous les lieux d’alentour d’vn eſpouuantable bruit;	Ce qu’il y avait encore d’étonnant, était que dans le même temps que la Foudre faisait retentir tous les lieux d’alentour d’un épouvantable bruit;
on entendoit mille Tonnerres ſoûterrains, qui par des ſecouſſes terribles, qui faiſoient encore de nouuelles ouuertures à la Terre;	on entendait mille Tonnerres souterrains, qui par des secousses terribles, qui faisaient encore de nouvelles ouvertures à la Terre;
ſembloient auoir eſbranlé le Centre du Monde;	semblaient avoir ébranlé le Centre du Monde;
& vouloir remettre la Nature en ſa premiere confuſion.	et vouloir remettre la Nature en sa première confusion.
Mille Pierres embraſées, ſortant de ce Gouffre enflamé, eſtoient eſlancées en haut auec des ſifflemens effroyables;	Mille Pierres embrasées, sortant de ce Gouffre enflammé, étaient élancées en haut avec des sifflements effroyables;
& retomboient en ſuitte dans la Campagne, ou prés ou loing, ſelon que l’impetuoſité qui les pouſſoit, ou leur propre poids les faiſoit retomber.	et retombaient ensuite dans la Campagne, ou près ou loin, selon que l’impétuosité qui les poussait, ou leur propre poids les faisait retomber.
En quelques endroits de la Plaine, on voyoit des Flames boüillonner comme des Sources de feu:	En quelques endroits de la Plaine, on voyait des Flames bouillonner comme des Sources de feu:
& il s'exhalloit de ces terribles Feux, vne odeur de Souffre & de Bitume, ſi incommode, qu’on en eſtoit preſque ſuffoqué.	et il s’exhalait de ces terribles Feux, une odeur de Souffre et de Bitume, si incommode, qu’on en était presque suffoqué.
Ce qu’il y auoit encore de ſurprenant, eſtoit qu’au milieu de tant de Feux, il y auoit des endroits d’où il ſortoit des Torrens:	Ce qu’il y avait encore de surprenant, était qu’au milieu de tant de Feux, il y avait des endroits d’où il sortait des Torrents:
qui en quelques lieux eſteignoient la flame, & augmentoient la fumée:	qui en quelques lieux éteignaient la flamme, et augmentaient la fumée:
& qui en quelques autres eſtoient eux meſmes conſumez par les feux qu’ils rencontroient.	et qui en quelques autres étaient eux mêmes consumés par les feux qu’ils rencontraient.
Mais ce qu’il y eut de plus terrible, fut qu’il ſortit tout d’vn coup de cét Abiſme, vne ſi prodigieuſe quantité de Cendres embraſées, que l’Air, la Terre, & le Fleuue, en furent preſques entierement ou remplis, ou couuerts.	Mais ce qu’il y eut de plus terrible, fut qu’il sortit tout d’un coup de cet Abîme, une si prodigieuse quantité de Cendres embrasées, que l’Air, la Terre, et le Fleuve, en furent presque entièrement ou remplis, ou couverts.
Cependant comme de moment en moment la Terre s’eſbranloit touſiours dauantage, la Maiſon où les Nopces d’Aronce & de Clelie ſe deuoient faire fut abatuë;	Cependant comme de moment en moment la Terre s’ébranlait toujours davantage, la Maison où les Noces d’Aronce et de Clélie se devaient faire fut abattue;
le Bourg tout entier où elle eſtoit ſcituée fut enſeueli ſous ſes propres ruines;	le Bourg tout entier où elle était située fut enseveli sous ses propres ruines;
pluſieurs Troupeaux dans la Campagne furent eſtouffez;	plusieurs Troupeaux dans la Campagne furent étouffés;
grand nombre de Gens perirent;	grand nombre de Gens périrent;
& on n’a iamais entendu parler d'vn tel deſordre.	et on n’a jamais entendu parler d’un tel désordre.
Car ceux qui eſtoient ſur la Terre, cherchoient de petits Batteaux pour ſe mettre ſur le Fleuue, penſant y eſtre plus ſeurement:	Car ceux qui étaient sur la Terre, cherchaient de petits Bateaux pour se mettre sur le Fleuve, pensant y être plus sûrement:
& ceux qui eſtoient ſur le Fleuue, abordoient en diligence, s’imaginant qu’ils ſeroient moins en peril ſur la Terre.	et ceux qui étaient sur le Fleuve, abordaient en diligence, s’imaginant qu’ils seraient moins en péril sur la Terre.
Ceux des Plaines, fuyoient aux Montagnes:	Ceux des Plaines, fuyaient aux Montagnes:
& ceux des Montagnes, deſcendoient dans les Plaines.	et ceux des Montagnes, descendaient dans les Plaines.
Ceux qui eſtoient dans les Bois, taſchoient de gagner la Campagne:	Ceux qui étaient dans les Bois, tâchaient de gagner la Campagne:
& ceux de la Campagne, faiſoient ce qu'ils pouuoient pour ſe ſauuer dans les Bois:	et ceux de la Campagne, faisaient ce qu’ils pouvaient pour se sauver dans les Bois:
chacun s’imaginant que la place où il n’eſtoit pas, eſtoit plus ſeure que celle où il eſtoit.	chacun s’imaginant que la place où il n’était pas, était plus sûre que celle où il était.
Cependant au milieu de ce tremblement de Terre ſi eſpouuantable de ces Flames ſi terribles;	Cependant au milieu de ce tremblement de Terre si épouvantable de ces Flammes si terribles;
de ces effroyables Tonnerres, Celeſtes, & Souſterrains;	de ces effroyables Tonnerres, Célestes, et Souterrains;
de ces Torrens impetueux;	de ces Torrents impétueux;
de cette eſpaiſſe fumée;	de cette épaisse fumée;
de cette odeur de Souffre & de Bithume;	de cette odeur de Souffre et de Bitume;
de ces Pierres enflammées;	de ces Pierres enflammées;
& de cette Nuë de Cendres embraſées, qui fit perir tant de Gens & tant de Troupeaux aux lieux meſmes où la Terre ne trembla point.	et de cette Nue de Cendres embrasées, qui fit périr tant de Gens et tant de Troupeaux aux lieux mêmes où la Terre ne trembla point.
Au milieu, dis-ie, d’vn ſi grand, peril, Aronce qui ne voyoit rien, de viuant que luy, ne ſongeoit qu’à ſon aimable Clelie:	Au milieu, dis-je, d’un si grand, péril, Aronce qui ne voyait rien, de vivant que lui, ne songeait qu’à son aimable Clélie:
& aprehendant pour elle, tout ce qu’il n’aprehendoit pas pour luy meſme, il auoit fait tout ce qu’il auoit pu, pour taſcher de la reioindre.	et appréhendant pour elle, tout ce qu’il n’appréhendait pas pour lui-même, il avait fait tout ce qu’il avait pu, pour tâcher de la rejoindre.
Mais il n’auoit pas eſté Maiſtre de ſes actions:	Mais il n’avait pas été Maître de ses actions:
car lors qu’il auoit voulu aller d’vn coſté, l’eſbranlement de la Terre l’auoit ietté de l’autre:	car lorsqu’il avait voulu aller d’un côté, l’ébranlement de la Terre l’avait jeté de l’autre:
de ſorte qu’il auoit eſté contraint de ſe laiſſer conduire à la Fortune, qui le ſauua d’vn ſi grand peril.	de sorte qu’il avait été contraint de se laisser conduire à la Fortune, qui le sauva d’un si grand péril.
Cependant lors que ce grand deſordre fut paſſé;	Cependant lorsque ce grand désordre fut passé;
que ces flames enſouffrées ſe furent eſteintes;	que ces flammes ensouffrées se furent éteintes;
que la Terre ſe fut raffermie en cet endroit;	que la Terre se fut raffermie en cet endroit;
que le bruit fut ceſſé;	que le bruit fut cessé;
que les Tenebres furent diſſipées, apres auoir duré le reſte du iour & toute la nuit;	que les Ténèbres furent dissipées, après avoir duré le reste du jour et toute la nuit;
Aronce ſe trouua au leuer du Soleil, ſur vn grand monceau de Cendres & de Cailloux, d’où il pouuoit deſcouurir ce funeſte Païſage.	Aronce se trouva au lever du Soleil, sur un grand monceau de Cendres et de Cailloux, d’où il pouvait découvrir ce funeste Paysage.
Mais il fut bien eſtonné de ne voir plus ny la Maiſon où il auoit couché, ny le Bourg où elle eſtoit;	Mais il fut bien étonné de ne voir plus ni la Maison où il avait couché, ni le Bourg où elle était;
& de voir vne partie d’vn Bois qui eſtoit proche de là renuerſé:	et de voir une partie d’un Bois qui était proche de là renversé:
& toute la Campagne couuerte de Gens ou de Troupeaux morts.	et toute la Campagne couverte de Gens ou de Troupeaux morts.
De ſorte que la crainte eſtant alors plus forte en ſon eſprit que l’eſperance, il deſcendit de deſſus cette Coline de Cendres;	De sorte que la crainte étant alors plus forte en son esprit que l’espérance, il descendit de dessus cette Coline de Cendres;
mais dés qu’il en fut deſcendu, il vit ſortir d’vn de ces Tombeaux que le Fleuue débordé auoit deſcouuerts, Clelius, & Sulpicie, qui s’y eſtoient retirez:	mais dès qu’il en fut descendu, il vit sortir d’un de ces Tombeaux que le Fleuve débordé avait découverts, Clélius, et Sulpicie, qui s’y étaient retirés:
car par vn cas fortuit eſtrange, le tremblement de Terre n’acheua pas de les deſtruire.	car par un cas fortuit étrange, le tremblement de Terre n’acheva pas de les détruire.
D’abord Aronce eut vne ioye extréme de les voir:	D’abord Aronce eut une joie extrême de les voir:
il eſpera meſme que Clelie les auroit ſuiuis, & ſortiroit auſſi de ce Tombeau:	il espéra même que Clélie les aurait suivis, et sortirait aussi de ce Tombeau:
mais il n'en vit ſortir que deux de leurs Amis, & trois de leurs Amies, ſi bien que s'auançant diligemment vers Sulpicie, de qui il eſtoit le plus proche;	mais il n’en vit sortir que deux de leurs Amis, et trois de leurs Amies, si bien que s’avançant diligemment vers Sulpicie, de qui il était le plus proche;
eh de grace, luy dit-il, dittes moy où eſt l'aimable Clelie?	eh de grâce, lui dit-il, dites-moi où est l’aimable Clélie?
Helas, luy reſpondit cette Mere affligée, ie m’auançois vers vous pour vous demander ſi vous ne ſçauiez point ce qu'elle eſt deuenuë:	Hélas, lui répondit cette Mère affligée, je m’avançais vers vous pour vous demander si vous ne saviez point ce qu’elle est devenue:
car enfin tout ce que i’en ſçay eſt que dans le meſme temps qu’elle vous a eu quitté pour s’auancer vers son Pere, i’ay veû Horace ſuiuy de ceux qui l’accompagnoient qui venoit vers elle:	car enfin tout ce que j’en sais est que dans le même temps qu’elle vous a eu quitté pour s’avancer vers son Père, j’ai vu Horace suivi de ceux qui l’accompagnaient qui venait vers elle:
& ie n’ay plus veû vn moment apres que des Tourbillons de flames, qui nous ont forcez Clelius & moy, de nous ſauuer dans vn de ces Tombeaux, auec ceux qui eſtoient le plus prés de nous.	et je n’ai plus vu un moment après que des Tourbillons de flammes, qui nous ont forcés Clelius et moi, de nous sauver dans un de ces Tombeaux, avec ceux qui étaient le plus près de nous.
A peine Sulpicie eut-elle acheué de prononcer ces paroles, qu'Aronce ſans regarder ny Clelius, ny Sulpicie, ny ceux qui eſtoient auec eux, ſe mit à chercher parmy ces grands monceaux de Cendres, ſans ſçauoir luy meſme bien preciſément ce qu’il cherchoit:	À peine Sulpicie eut-elle achevé de prononcer ces paroles, qu'Aronce sans regarder ni Clélius, ni Sulpicie, ni ceux qui étaient avec eux, se mit à chercher parmi ces grands monceaux de Cendres, sans savoir lui-même bien précisément ce qu’il cherchait:
& Clelius, Sulpicie, & ceux qui les ſuiuoient, le mirent à chercher auſſi bien que luy, s’ils ne trouueroient nulles marques de la vie, ou de la mort de Clelie.	et Clelius, Sulpicie, et ceux qui les suivaient, le mirent à chercher aussi bien que lui, s’ils ne trouveraient nulles marques de la vie, ou de la mort de Clélie.
Mais plus ils chercherent, plus leur douleur augmenta:	Mais plus ils cherchèrent, plus leur douleur augmenta:
car ils trouuerent vne Amie de cette admirable Fille, eſtouffée dans ces Cendres bruſlantes qui eſtoient tombées ſur elle:	car ils trouvèrent une Amie de cette admirable Fille, étouffée dans ces Cendres brûlantes qui étaient tombées sur elle:
& ils virent aupres de ſon corps celuy d’vn Amant qu’elle auoit, qui auoit eu le meſme deſtin.	et ils virent auprès de son corps celui d’un Amant qu’elle avait, qui avait eu le même destin.
Ce lamentable obiet, tout funeſte qu’il eſtoit, obligea pourtant Aronce à porter enuie à ce malheureux Amant;	Ce lamentable objet, tout funeste qu’il était, obligea pourtant Aronce à porter envie à ce malheureux Amant;
puis que du moins il auoit eu l'auantage de mourir aupres de ſa Maiſtreſſe.	puisque du moins il avait eu l’avantage de mourir auprès de sa Maîtresse.
Mais comme ces deux Perſonnes n’eſtoient plus en eſtat d’auoir beſoin d’aucun ſecours, ils ne s’y arreſterent pas:	Mais comme ces deux Personnes n’étaient plus en état d’avoir besoin d’aucun secours, ils ne s’y arrêtèrent pas:
& Clelius ordonna ſeulement à deux de ſes Domeſtique qu’il retrouua, de deſgager ces corps de dedans ces Cendres, & de demeurer aupres, iuſques à ce qu’on pûſt les enuoyer querir:	et Clélius ordonna seulement à deux de ses Domestique qu’il retrouva, de dégager ces corps de dedans ces Cendres, et de demeurer auprès, jusqu’à ce qu’on pût les envoyer quérir:
en ſuite dequoy il continua de chercher comme les autres, mais ils chercherent tous inutilement.	ensuite de quoi il continua de chercher comme les autres, mais ils cherchèrent tous inutilement.
Cependant on voyoit alors de par tout des Gens qui ſortoient ou des Bois qui eſtoient proches;	Cependant on voyait alors de par tout des Gens qui sortaient ou des Bois qui étaient proches;
ou des ruines de ces Maiſons qui eſtoient abatuës;	ou des ruines de ces Maisons qui étaient abattues;
ou qui ſe releuant de Terre, alloient chercher ou leurs Parens, ou leurs Amis:	ou qui se relevant de Terre, allaient chercher ou leurs Parents, ou leurs Amis:
car cét accident auoit diſperſé toutes les Familles.	car cet accident avait dispersé toutes les Familles.
Ainſi on en voyoit qui pleuroient pour leurs Peres;	Ainsi on en voyait qui pleuraient pour leurs Pères;
d’autres pour leurs Enfans;	d’autres pour leurs Enfants;
d'autres pour leurs Maiſons ruinées;	d’autres pour leurs Maisons ruinées;
d’autres pour leurs Troupeaux eſtouffez;	d’autres pour leurs Troupeaux étouffés;
& d’autres pour la ſeule crainte d’auoir perdu ce qu’ils cherchoient:	et d’autres pour la seule crainte d’avoir perdu ce qu’ils cherchaient:
car encore que les tremblemens de Terre ayent touſiours eſté aſſez frequens en cét aimable Païs;	car encore que les tremblements de Terre aient toujours été assez fréquents en cet aimable Pays;
la douleur de ceux qui s’eſtoient trouuez engagez en celuy-cy, n’en eſtoit pas moins grande.	la douleur de ceux qui s’étaient trouvés engagés en celui-ci, n’en était pas moins grande.
Mais entre tant de malheureux, dont ce funeſte Païſage eſtoit tout couuert, Aronce, l’infortuné Aronce, eſtoit le plus deſeſperé:	Mais entre tant de malheureux, dont ce funeste Paysage était tout couvert, Aronce, l’infortuné Aronce, était le plus désespéré:
ſon affliction eſtoit ſi forte, qu'il n’auoit pas la liberté de s’en pleindre:	son affliction était si forte, qu’il n’avait pas la liberté de s’en plaindre:
& ce fut veritablement en cette rencontre qu’il fut aiſé de diſcerner la difference qu’il y a de la douleur d’vn Pere & d’vne Mere à celle d’vn Amant.	et ce fut véritablement en cette rencontre qu’il fut aisé de discerner la différence qu’il y a de la douleur d’un Père et d’une Mère à celle d’un Amant.
Car encore que Clelius & Sulpicie fuſſent en vne peine extréme de leur Fille, il eſtoit aiſé de voir qu’Aronce ſouffroit incomparablement plus qu’eux, quoy qu’ils ſouffriſſent beaucoup.	Car encore que Clélius et Sulpicie fussent en une peine extrême de leur Fille, il était aisé de voir qu’Aronce souffrait incomparablement plus qu’eux, quoi qu’ils souffrissent beaucoup.
Mais à la fin voyant qu’ils n’aprenoient rien de ce qu’ils cherchoient, ils iugerent que comme ils eſtoient eſchapez, Clelie pourroit auſſi eſtre eſchapée:	Mais à la fin voyant qu’ils n’apprenaient rien de ce qu’ils cherchaient, ils jugèrent que comme ils étaient échappés, Clélie pourrait aussi être échappée:
ainſi ils creurent qu’il eſtoit à propos de s’en retourner à Capouë, afin de voir ſi quelqu’vn ne l’y auroit point remenée.	ainsi ils crurent qu’il était à propos de s’en retourner à Capoue, afin de voir si quelqu’un ne l’y aurait point ramenée.
Si bien que cette legere eſperance ayant paſſé du cœur de Clelius dans celuy d’Aronce, le rendit capable de ſonger à chercher les voyes d’y retourner.	Si bien que cette légère espérance ayant passé du cœur de Clélius dans celui d’Aronce, le rendit capable de songer à chercher les voies d’y retourner.
Il eſt vray que le hazard leur en fournit vne:	Il est vrai que le hasard leur en fournit une:
car ils trouuerent vn Chariot vuide, que le tremblement de Terre n’auoit fait que renuerſer, & qu’engager ſous des Cendres comme on le remenoit à Capouë.	car ils trouvèrent un Chariot vide, que le tremblement de Terre n’avait fait que renverser, et qu’engager sous des Cendres comme on le ramenait à Capoue.
De ſorte que l'ayant deſgagé, & s’eſtant trouué vn homme qui le ſçauoit conduire, ils ſe mirent dedans, apres que les moins affligez de cette Troupe, eurent donné ordre pour faire porter à Capouë les corps de ces deux Amans:	De sorte que l’ayant dégagé, et s’étant trouvé un homme qui le savait conduire, ils se mirent dedans, après que les moins affligés de cette Troupe, eurent donné ordre pour faire porter à Capoue les corps de ces deux Amants:
& qu'ils eurent obligé ceux auec qui ils eſtoient, à faire vn leger repas à la premiere Habitation qu’ils trouuerent.	et qu’ils eurent obligé ceux avec qui ils étaient, à faire un léger repas à la première Habitation qu’ils trouvèrent.
Car ce qu’il y eut de remarquable en ce tremblement de Terre, fut qu’il ne s’eſtendit que depuis le Bourg où les Nopces d’Aronce ſe deuoient faire, iuſques à Nole:	Car ce qu’il y eut de remarquable en ce tremblement de Terre, fut qu’il ne s’étendit que depuis le Bourg où les Noces d’Aronce se devaient faire, jusqu’à Nole:
& que depuis là iuſques à Capouë, il n'y eut autre mal que celuy que la chutte de ces Cendres embraſées y fit en quelques endroits.	et que depuis là jusqu’à Capoue, il n’y eut autre mal que celui que la chute de ces Cendres embrasées y fit en quelques endroits.
La douleur d’Aronce redoubla pourtant en y arriuant, lors qu’il vit qu’il n’y aprenoit nulle nouuelle de ſa chere Clelie, ny de ſon Riual.	La douleur d’Aronce redoubla pourtant en y arrivant, lorsqu’il vit qu’il n’y apprenait nulle nouvelle de sa chère Clélie, ni de son Rival.
Il eſt vray qu’il ne fut pas long temps ſans ſçauoir qu’Horace n'eſtoit point mort: parce qu’il fut aduerti par vn homme de ſa connoiſſance, qu'vn Amy particulier d’Horace, qui ſe nommoit Stenius, en auoit reçeu vne Lettre le matin.	Il est vrai qu’il ne fut pas longtemps sans savoir qu’Horace n’était point mort: parce qu’il fut averti par un homme de sa connaissance, qu’un Ami particulier d’Horace, qui se nommait Sténius, en avait reçu une Lettre le matin.
De ſorte que pouſſé par vne curioſité que l'excés de ſa paſſion rendoit infiniment forte, il fut le chercher chez luy, où il ne le trouua pas:	De sorte que poussé par une curiosité que l’excès de sa passion rendait infiniment forte, il fut le chercher chez lui, où il ne le trouva pas:
mais comme on luy eut dit qu’il s’eſtoit allé promener dans vne grande Place qui eſtoit derriere vn Temple de Diane qui eſtoit à Capouë, il fut l'y trouuer.	mais comme on lui eut dit qu’il s’était allé promener dans une grande Place qui était derrière un Temple de Diane qui était à Capoue, il fut l’y trouver.
Comme Stenius connoiſſoit extrémement Aronce, il le reçeut auec ciuilité, quoy qu’il fuſt Riual de ſon Amy:	Comme Sténius connaissait extrêmement Aronce, il le reçut avec civilité, quoi qu’il fût Rival de son Ami:
ſi bien qu’Aronce eſperant qu’il ne luy refuſeroit pas ce qu’il vouloit luy demander, l’aborda auſſi fort ciuilement.	si bien qu’Aronce espérant qu’il ne lui refuserait pas ce qu’il voulait lui demander, l’aborda aussi fort civilement.
Ie n’ignore pas Stenius, luy dit-il, que vous eſtes plus Amy d’Horace que de moy: auſſi ne veux-ie pas vous propoſer de trahir le ſecret qu’il vous a confié:	Je n’ignore pas Sténius, lui dit-il, que vous êtes plus Ami d’Horace que de moi: aussi ne veux-je pas vous proposer de trahir le secret qu’il vous a confié:
mais ſçachant d’vne certitude infaillible, que vous en auez auiourd’huy reçeu vne Lettre, ie viens vous coniurer, & vous coniurer auec ardeur, de me vouloir dire ſeulement s’il ne vous aprend pas que Clelie ſoit viuante.	mais sachant d’une certitude infaillible, que vous en avez aujourd’hui reçu une Lettre, je viens vous conjurer, et vous conjurer avec ardeur, de me vouloir dire seulement s’il ne vous apprend pas que Clélie soit vivante.
Ie ne vous demande pas, adiouſta-t’il, que vous me diſiez ny où il va, ny où il eſt preſentement:	Je ne vous demande pas, ajouta-t-il, que vous me disiez ni où il va, ni où il est présentement:
car comme ie ſçay bien que l’honneur ne vous permet pas de me le dire, ie croy qu’il ne me permet pas auſſi de vous le demander:	car comme je sais bien que l’honneur ne vous permet pas de me le dire, je crois qu’il ne me permet pas aussi de vous le demander:
& i’ay meſme ſi bonne opinion de vous, que ie ſuis perſuadé que ie vous le demanderois inutilement:	et j’ai même si bonne opinion de vous, que je suis persuadé que je vous le demanderais inutilement:
c’eſt pourquoy ie ne veux pas que la force de mon amour, m’oblige à vous faire vne iniuſte proposition.	c’est pourquoi je ne veux pas que la force de mon amour, m’oblige à vous faire une injuste proposition.
Mais Stenius, tout ce que ie veux de vous, eſt qu’en faueur d’vn Amant affligé, vous me diſiez ſeulement, Clelie eſt viuante, ſans me dire en quel lieu de la Terre Aronce la mene:	Mais Sténius, tout ce que je veux de vous, est qu’en faveur d’un Amant affligé, vous me disiez seulement, Clélie est vivante, sans me dire en quel lieu de la Terre Aronce la mène:
& pour vous y obliger, pourſuiuit-il, i'ay à vous dire que quand vous ne me le direz pas, ie ne laiſſeray pas d'agir comme ſi ie ſçauois auec certitude que Clelie n’eſt pas morte, & que mon Riual la tient ſous ſa puiſſance:	et pour vous y obliger, poursuivit-il, j’ai à vous dire que quand vous ne me le direz pas, je ne laisserai pas d’agir comme si je savais avec certitude que Clélie n’est pas morte, et que mon Rival la tient sous sa puissance:
c’eſt pourquoy ie croy que ſans choquer la fidelité que vous deuez à Horace, vous pouuez ne me refuſer pas.	c’est pourquoi je crois que sans choquer la fidélité que vous devez à Horace, vous pouvez ne me refuser pas.
Ie ne vous nieray point, repliqua Stenius, que i’ay reçeu auiourd’huy vne Lettre d’Horace, puis que vous le ſçaueZ:	Je ne vous nierai point, répliqua Sténius, que j’ai reçu aujourd’hui une Lettre d’Horace, puisque vous le savez:
& ie vous aduoüeray meſme que ie l’ay preſentement ſur moy:	et je vous avouerai même que je l’ai présentement sur moi:
mais en meſme temps ie vous diray que ie ſuis eſtrangement ſurpris, que vous me demandiez vne choſe que ie ne dois pas faire:	mais en même temps je vous dirai que je suis étrangement surpris, que vous me demandiez une chose que je ne dois pas faire:
& que ie veux meſme croire que vous ne feriez pas ſi vous eſtiez en ma place.	et que je veux même croire que vous ne feriez pas si vous étiez en ma place.
Si ie vous demandois quelque choſe qui pûſt nuire à voſtre Amy, repliqua Aronce, vous auriez raiſon de parler comme vous faites:	Si je vous demandais quelque chose qui pût nuire à votre Ami, répliqua Aronce, vous auriez raison de parler comme vous faites:
mais ie ne vous demande que ce qui peut conſoler vn malheureux Amant, ſans que cette conſolation puiſſe nuire à ſon Riual:	mais je ne vous demande que ce qui peut consoler un malheureux Amant, sans que cette consolation puisse nuire à son Rival:
& ſi vous auiez aimé, vous ne me refuſeriez ſans doute pas.	et si vous aviez aimé, vous ne me refuseriez sans doute pas.
Ie ne ſçay ce que ie ferois comme Amant, reprit fierement Stenius, mais ie ſçay bien que comme Amy d’Horace, ie ne vous dois rien dire où il ait intereſt:	Je ne sais ce que je ferais comme Amant, reprit fièrement Sténius, mais je sais bien que comme Ami d’Horace, je ne vous dois rien dire où il ait intérêt:
& que ie dois trouuer fort eſtrange que vous m’ayez demandé vne chose que ie ne pourrois faire ſans laſcheté.	et que je dois trouver fort étrange que vous m’ayez demandé une chose que je ne pourrais faire sans lâcheté.
Pour vous la faire faire auec honneur	Pour vous la faire faire avec honneur
(reprit Aronce, en mettant l’Eſpée à la main)	(reprit Aronce, en mettant l’Épée à la main)
il faut que vous ſouſteniez auſſi bien voſtre opinion par voſtre valeur, que par voſtre opiniaſtreté:	il faut que vous souteniez aussi bien votre opinion par votre valeur, que par votre opiniâtreté:
& que vous deſtendiez meſme la Lettre d'Horace, puis que vous ne voulez pas que ie ſçache ſi Clelie eſt viuante ou morte.	et que vous détendiez même la Lettre d’Horace, puisque vous ne voulez pas que je sache si Clélie est vivante ou morte.
A ces mots, Stenius ſe reculant de quelques pas, mit l’Eſpée à la main, auſſi bien qu’Aronce;	À ces mots, Sténius se reculant de quelques pas, mit l’Épée à la main, aussi bien qu’Aronce;
& deuant que des Gens qui les voyoient faire de loing, puſſent eſtre à eux, Aronce eut non ſeulement deſarmé & vaincu Stenius, mais il luy eut meſme arraché la Lettre d’Horace:	et devant que des Gens qui les voyaient faire de loin, pussent être à eux, Aronce eut non seulement désarmé et vaincu Sténius, mais il lui eut même arraché la Lettre d’Horace:
apres quoy il ſe retira diligemment chez Clelius, ou il ouurit cette Lettre de ſon Riual, qui eſtoit telle.	après quoi il se retira diligemment chez Clélius, où il ouvrit cette Lettre de son Rival, qui était telle.
VN tremblement de Terre ayant mis la rigoureuſe Clelie en ma puiſſance, ie m’en vay chercher vn Aſile à Perouſe, où vous m'enuoyerez toutes les choſes que celuy qui vous rend ma Lettre vous dira:	VN tremblement de Terre ayant mis la rigoureuse Clélie en ma puissance, je m’en vais chercher un Asile à Pérouse, où vous m’enverrez toutes les choses que celui qui vous rend ma Lettre vous dira:
& où vous me manderez, pour augmenter ma ſatisfaction, quel aura eſté le deſeſpoir de mon Riual.	et où vous me manderez, pour augmenter ma satisfaction, quel aura été le désespoir de mon Rival.
La lecture de cette Lettre donna vne ſi ſenſible ioye à Aronce, qu’on ne la ſçauroit exprimer:	La lecture de cette Lettre donna une si sensible joie à Aronce, qu’on ne la saurait exprimer:
car non ſeulement il aprenoit que Clelie eſtoit viuante;	car non seulement il apprenait que Clélie était vivante;
mais il ſçauoit en meſme temps que ſon Riual la menoit en vn lieu, où l’honneur & la Nature l’obligeoient d’aller, & où il n’euſt peut-eſtre pas eſté, s’il euſt ſçeu que la Maiſtreſſe euſt eſté ailleurs.	mais il savait en même temps que son Rival la menait en un lieu, où l’honneur et la Nature l’obligeaient d’aller, et où il n’eût peut-être pas été, s’il eût su que la Maîtresse eût été ailleurs.
Si bien que diſant promptement la choſe à Clelius & à Sulpicie, il ſe reſolut de partir dés le lendemain:	Si bien que disant promptement la chose à Clélius et à Sulpicie, il se résolut de partir dès le lendemain:
ce en effet il partit auec vn Eſquipage qui n’auoit rien de plus magnifique qu’vn Gendre de Clelius le deuoit auoir, n’ayant que trois ou quatre Eſclaues aueque luy.	ce en effet il partit avec un Équipage qui n’avait rien de plus magnifique qu’un Gendre de Clélius le devait avoir, n’ayant que trois ou quatre Esclaves avec lui.
Il eſt vray qu’il obligea vn Amy qu’il auoit fait à Capouë, & qui ſçauoit tout le ſecret de ſa fortune, de faire ce voyage:	Il est vrai qu’il obligea un Ami qu’il avait fait à Capoue, et qui savait tout le secret de sa fortune, de faire ce voyage:
afin que s’il luy reüſſiſſoit heureuſement, il pûſt luy faire partager ſon bonheur.	afin que s’il lui réussissait heureusement, il pût lui faire partager son bonheur.
Cét agreable Amy, qui ſe nommoit Celere, eſtant donc toute la conſolation d’Aronce, ils partirent de Capouë:	Cet agréable Ami, qui se nommait Célère, étant donc toute la consolation d’Aronce, ils partirent de Capoue:
laiſſant ordre à Clelius, & à Sulpicie, de leur enuoyer par vne voye ſeure toutes les choſes qu’ils ſçauoient eſtre neceſſaires pour faire que le voyage d’Aronce euſt le ſuccés qu’il ſouhaitoit:	laissant ordre à Clélius, et à Sulpicie, de leur envoyer par une voie sûre toutes les choses qu’ils savaient être nécessaires pour faire que le voyage d’Aronce eût le succès qu’il souhaitait:
apres quoy ces deux Amis le commencerent & le pourſuiuirent ſans aucun obſtacle, quoy que le chemin ſoit aſſez long:	après quoi ces deux Amis le commencèrent et le poursuivirent sans aucun obstacle, quoique le chemin soit assez long:
iuſques à ce qu’eſtant arriuez vn ſoir au bord du Lac de Thraſymene, ils s'arreſterent pour en regarder la beauté.	jusqu’à ce qu’étant arrivés un soir au bord du Lac de Trasimène, ils s’arrêtèrent pour en regarder la beauté.
Et en effet il eſtoit digne de la curioſité de deux hommes auſſi pleins d'eſprit qu’Aronce & Celere:	Et en effet il était digne de la curiosité de deux hommes aussi pleins d’esprit qu’Aronce et Célère:
car comme il a trois belles & agreables Iſles, elles auoient alors chacune vn aſſez beau Chaſteau:	car comme il a trois belles et agréables Îles, elles avaient alors chacune un assez beau Château:
& tout à l'entour du Lac il y auoit pluſieurs Villages, & pluſieur Hameaux, qui rendoient ce Païſage vn des plus beaux du Monde.	et tout à l’entour du Lac il y avait plusieurs Villages, et plusieurs Hameaux, qui rendaient ce Paysage un des plus beaux du Monde.
Mais à peine Aronce & Celere eurent-ils eu le loiſir de conſiderer la grandeur & la beauté de ce Lac;	Mais à peine Aronce et Célère eurent-ils eu le loisir de considérer la grandeur et la beauté de ce Lac;
qu’ils virent ſortir de la Pointe d’vne de ces Iſles deux petites Barques, dans vne deſquelles Aronce vit ſa chere Clelie & Horace, auec ſix hommes l'Eſpée à la main, qui ſe deffendoient contre dix qui eſtoient dans l’autre.	qu’ils virent sortir de la Pointe d’une de ces Îles deux petites Barques, dans une desquelles Aronce vit sa chère Clélie et Horace, avec six hommes l’Épée à la main, qui se défendaient contre dix qui étaient dans l’autre.
Cette veuë le ſurprit d’vne telle ſorte, que d’abord il ne vouloit pas croire ſes yeux;	Cette vue le surprit d’une telle sorte, que d’abord il ne voulait pas croire ses yeux;
mais Celere luy ayant confirmé qu’ils ne le trompoient pas, il creût en effet qu’il voyoit & ſa Maiſtreſſe, & ſon Riual:	mais Célère lui ayant confirmé qu’ils ne le trompaient pas, il crut en effet qu’il voyait et sa Maîtresse, et son Rival:
& il luy ſembla meſme que celuy qui eſtoit à la Prouë de la ſeconde Barque, eſtoit le Prince de Numidie qu’il aimait fort.	et il lui sembla même que celui qui était à la Proue de la seconde Barque, était le Prince de Numidie qu’il aimait fort.
En cet inſtant Aronce ſe trouua bien embarraſſé:	En cet instant Aronce se trouva bien embarrassé:
car il n’y auoit point de Bateau proche du lieu où il eſtoit, & il falloit faire prés de deux Mille pour en trouuer, à ce que luy dit vn Guide du Païs qui le deuoit mener iuſques à Perouſe.	car il n’y avait point de Bateau proche du lieu où il était, et il fallait faire près de deux Milles pour en trouver, à ce que lui dit un Guide du Pays qui le devait mener jusqu’à Pérouse.
Cependant il falut qu’il ſe reſoluſt à aller iuſques là:	Cependant il fallut qu’il se résolût à aller jusque là:
car comme les deux Barques s’eſloignoient touſiours de luy en combarant, comme ſi elles euſſent voulu prendre la route de la ſeconde Iſle du Lac, il iugeoit bien que quand il auroit entrepris de forcer ſon Cheual à nâger, il n’auroit iamais pû les ioindre:	car comme les deux Barques s’éloignaient toujours de lui en combattant, comme si elles eussent voulu prendre la route de la seconde Île du Lac, il jugeait bien que quand il aurait entrepris de forcer son Cheval à nager, il n’aurait jamais pu les joindre:
car Horace faiſoit ramer auec vne diligence eſtrange.	car Horace faisait ramer avec une diligence étrange.
De ſorte que voyant encore plus d’aparence de pouuoir ſecourir ſa Maiſtreſſe en allant au lieu où on luy diſoit qu’il trouueroit des Bateaux, il pouſſa ſon cheual à toute bride vers vn endroit ou le Lac s’enfonçoit dans vn grand Bois, dont il falloit trauerſer vn coin pour aller à vne Habitation où ce Guide d’Aronce aſſuroit qu’il y auoit touſiours des Bateaux.	De sorte que voyant encore plus d’apparence de pouvoir secourir sa Maîtresse en allant au lieu où on lui disait qu’il trouverait des Bateaux, il poussa son cheval à toute bride vers un endroit ou le Lac s’enfonçait dans un grand Bois, dont il fallait traverser un coin pour aller à une Habitation où ce Guide d’Aronce assurait qu’il y avait toujours des Bateaux.
