L’embrazement de la ville de Sinope eſtoit ſi grand, que tout le Ciel;	L’embrasement de la ville de Sinope était si grand, que tout le Ciel;
toute la Mer;	toute la Mer;
toute la Plaine;	toute la Plaine;
& le haut de toutes les Montagnes les plus reculées, en receuoient vne impreſſion de lumiere, qui malgré l’obſcurité de la nuit, permettoit de diſtinguer toutes choſes.	et le haut de toutes les Montagnes les plus reculées, en recevaient une impression de lumière, qui malgré l’obscurité de la nuit, permettait de distinguer toutes choses.
Iamais obiet ne fut ſi terrible que celuy-là:	Jamais objet ne fut si terrible que celui-là:
l’on voyoit tout à la fois vingt Galeres qui bruſloient dans le Port;	l’on voyait tout à la fois vingt Galères qui brûlaient dans le Port;
& qui au milieu de l’eau dont elles eſtoient ſi proches, ne laiſſoient pas de pouſſer des flames ondoyantes iuſques aux nuës.	et qui au milieu de l’eau dont elles étaient si proches, ne laissaient pas de pousser des flammes ondoyantes jusqu’aux nues.
Ces flames eſtant agitées par vn vent aſſez impetueux, ſe courboient quelquefois vers la plus grande partie de la Ville, qu’elles avoient deſja toute embrazée;	Ces flammes étant agitées par un vent assez impétueux, se courbaient quelquefois vers la plus grande partie de la Ville, qu’elles avaient déjà toute embrasée;
& de laquelle elles n’avoient preſque plus fait qu’un grand bûcher.	et de laquelle elles n’avaient presque plus fait qu’un grand bûcher.
L’on les voyoit paſſer d’un lieu à l’autre en un moment;	L’on les voyait passer d’un lieu à l’autre en un moment;
& par une funeſte communication, il n’y avoit quaſi pas un endroit en toute cette déplorable Ville, qui n’eſprouvast leur fureur.	et par une funeste communication, il n’y avait quasi pas un endroit en toute cette déplorable Ville, qui n’éprouvât leur fureur.
Tous les cordages,	Tous les cordages,
& toutes les voilles, des Vaiſſeaux	et toutes les voiles, des Vaisseaux
& des Galeres, ſe deſtachans toutes embrazées, s’eſlevoient affreuſement en l’air,	et des Galères, se détachant toutes embrasées, s’élevaient affreusement en l’air,
& retomboient en eſtincelles, ſur toutes les maiſons voiſines.	et retombaient en étincelles, sur toutes les maisons voisines.
Quelques unes de ces maiſons eſtant deſja conſumées, cedoient à la violence de cét impitoyable vainqueur;	Quelques-unes de ces maisons étant déjà consumées, cédaient à la violence de cet impitoyable vainqueur;
& tomboient en un inſtant, dans les ruës	et tombaient en un instant, dans les rues
& dans les Places, dont elles avoient eſté l’ornement.	et dans les Places, dont elles avaient été l’ornement.
Cette effroyable multitude de flames, qui s’élevoient de tant de divers endroits;	Cette effroyable multitude de flammes, qui s’élevaient de tant de divers endroits;
& qui avoient plus ou moins de force, ſelon la matiere qui les entretenoit, ſembloient faire un combat entr’elles, à cauſe du vent qui les agitoit;	et qui avaient plus ou moins de force, selon la matière qui les entretenait, semblaient faire un combat entre elles, à cause du vent qui les agitait;
& qui quelques-fois les confondant	et qui quelquefois les confondant
& les ſeparant, ſembloit faire voir en effet, qu’elles ſe diſputoient la gloire de deſtruire cette belle Ville.	et les séparant, semblait faire voir en effet, qu’elles se disputaient la gloire de détruire cette belle Ville.
Parmy ces flames eſclattantes, l’on voyoit encore des tourbillons de fumée, qui par leur ſombre couleur adjouſtoient quelque choſe de plus terrible, à un ſi eſpouvantable objet:	Parmi ces flammes éclatantes, l’on voyait encore des tourbillons de fumée, qui par leur sombre couleur ajoutaient quelque chose de plus terrible, à un si épouvantable objet:
& l’abondance des eſtincelles, dont nous avons deſja parlé, retombant à l’entour de cette Ville, comme une greſle enflamée, faiſoit ſans doute que l’abord en eſtoit affreux.	et l’abondance des étincelles, dont nous avons déjà parlé, retombant à l’entour de cette Ville, comme une grêle enflammée, faisait sans doute que l’abord en était affreux.
Au milieu de ce grand deſordre,	Au milieu de ce grand désordre,
& tout au plus bas de la Ville, il y avoit un Chaſteau, baſty ſur la cime d’un grand Rocher qui s’avançoit dans la Mer, que ces flames n’avoient encore pû devorer:	et tout au plus bas de la Ville, il y avait un Château, bâti sur la cime d’un grand Rocher qui s’avançait dans la Mer, que ces flammes n’avaient encore pu dévorer:
& vers lequel toutefois, elles ſembloient s’eſlancer à chaque moment, parce que le vent les y pouſſoit avec violence.	et vers lequel toutefois, elles semblaient s’élancer à chaque moment, parce que le vent les y poussait avec violence.
Il paroiſſoit que l’embrazement devoit avoir commencé par le Port;	Il paraissait que l’embrasement devait avoir commencé par le Port;
puis que toutes les maiſons qui le bordoient, eſtoient les plus allumées,	puisque toutes les maisons qui le bordaient, étaient les plus allumées,
& les plus proches de leur entiere ruine, ſi toutefois il eſtoit permis de mettre quelque difference, en un lieu où l’on voyoit eſclater par tout, le feu	et les plus proches de leur entière ruine, si toutefois il était permis de mettre quelque différence, en un lieu où l’on voyait éclater par tout, le feu
& la flame.	et la flamme.
Parmy ces feux	Parmi ces feux
& parmy ces flames, l’on voyoit pourtant encore quelques Temples	et parmi ces flammes, l’on voyait pourtant encore quelques Temples
& quelques maiſons, qui faiſoient un peu plus de reſistance que les autres;	et quelques maisons, qui faisaient un peu plus de résistance que les autres;
& qui laiſſoient encore aſſez voir de la beauté de leur ſtructure, pour donner de la compaſſion, de leur inevitable ruine.	et qui laissaient encore assez voir de la beauté de leur structure, pour donner de la compassion, de leur inévitable ruine.
Enfin ce terrible Element détruiſoit toutes choſes;	Enfin ce terrible Élément détruisait toutes choses;
ou faiſoit voir ce qu’il n’avoit pas encore détruit, ſi proche de l’eſtre;	ou faisait voir ce qu’il n’avait pas encore détruit, si proche de l’être;
qu’il eſtoit difficile de n’eſtre pas ſaisi d’horreur	qu’il était difficile de n’être pas saisi d’horreur
& de pitié, par une veuë ſi extraordinaire	et de pitié, par une vue si extraordinaire
& ſi funeſte.	et si funeste.
Ce fut par cét eſpouvantable objet, que l’amoureux Artamene (apres eſtre ſorty d’un valon, tournoyant	Ce fut par cet épouvantable objet, que l’amoureux Artamène (après être sorti d’un vallon, tournoyant
& couvert de bois, à la teſte de quatre mille hommes) fut eſtrangement ſurpris.	et couvert de bois, à la tête de quatre mille hommes) fut étrangement surpris.
Auſſi en parut-il ſi eſtonné, qu’il s’arreſta tout d’un coup:	Aussi en parut-il si étonné, qu’il s’arrêta tout d’un coup:
& ſans sçavoir ſi ce qu’il voyoit eſtoit veritable;	et sans savoir si ce qu’il voyait était véritable;
& ſans pouvoir meſme exprimer ſon eſtonnement, par ſes paroles;	et sans pouvoir même exprimer son étonnement, par ses paroles;
il regarda cette Ville;	il regarda cette Ville;
il regarda le Port;	il regarda le Port;
il jetta les yeux ſur cette Mer, qui paroiſſoit toute embrazée, par la reflexion qu’elle recevoit des Nuës, que ce feu avoit toutes illuminées;	il jeta les yeux sur cette Mer, qui paraissait toute embrasée, par la réflexion qu’elle recevait des Nues, que ce feu avait toutes illuminées;
il regarda la Plaine	il regarda la Plaine
& les Montagnes;	et les Montagnes;
il tourna ſes yeux vers le Ciel;	il tourna ses yeux vers le Ciel;
& ſans pouvoir ny parler, ny marcher, il ſembloit demander à toutes ces choſes, ſi ce qu’il voyoit eſtoit effectif, ou ſi ce n’eſtoit point une illuſion.	et sans pouvoir ni parler, ni marcher, il semblait demander à toutes ces choses, si ce qu’il voyait était effectif, ou si ce n’était point une illusion.
Hidaſpe, Chriſante, Aglatidas, Araſpe,	Hidaspe, Chrysante, Aglatidas, Araspe,
& Feraulas, qui eſtoient les plus proches de luy, regardoient cét embrazement,	et Phéraulas, qui étaient les plus proches de lui, regardaient cet embrasement,
& n’oſoient regarder Artamene;	et n’osaient regarder Artamène;
qui pouſſant enfin ſon cheval ſur une petite eminence, où ils le ſuivirent;	qui poussant enfin son cheval sur une petite éminence, où ils le suivirent;
vit	vit
& connut ſi diſtinctement, que cette Ville qui bruſloit, eſtoit celle-là meſme qu’il penſoit venir ſurprendre cette nuit, par une intelligence qu’il y avoit, afin d’en tirer ſa Princeſſe, que le Roy d’Aſſirie y tenoit captive;	et connut si distinctement, que cette Ville qui brûlait, était celle-là même qu’il pensait venir surprendre cette nuit, par une intelligence qu’il y avait, afin d’en tirer sa Princesse, que le Roi d’Assyrie y tenait captive;
que tout d’un coup s’emportant avec une violence extréme;	que tout d’un coup s’emportant avec une violence extrême;
Quoy injuſtes Dieux, s’écria t’il, il eſt donc bien vray que vous avez conſenti à la perte de la plus belle Princeſſe qui fut jamais?	Quoi injustes Dieux, s’écria t-il, il est donc bien vrai que vous avez consenti à la perte de la plus belle Princesse qui fut jamais?
& que dans le meſme temps que je croyois ſa liberté infaillible, vous me faites voir ſa perte indubitable?	et que dans le même temps que je croyais sa liberté infaillible, vous me faites voir sa perte indubitable?
En diſant cela il s’avança encore un peu davantage:	En disant cela il s’avança encore un peu davantage:
& n’eſtant ſuivi que de Chriſante	et n’étant suivi que de Chrysante
& de Feraulas, Helas mes Amis (leur dit il en commençant de galoper,	et de Phéraulas, Hélas mes Amis (leur dit il en commençant de galoper,
& commandant que tout le ſuivist) quel pitoyable deſtin eſt le mien,	et commandant que tout le suivît) quel pitoyable destin est le mien,
& à quel effroyable ſpectacle m’a t’on amené?	et à quel effroyable spectacle m’a-t-on amené?
Allons du moins, allons mourir dans les meſmes flames, qui ont fait perir noſtre illuſtre Princeſſe.	Allons du moins, allons mourir dans les mêmes flammes, qui ont fait périr notre illustre Princesse.
Peut-eſtre (pourſuivoit il en luy meſme) que ces flames que je voy, viennent d’achever de reduire en cendre, mon adorable Mandane.	Peut-être (poursuivait-il en lui même) que ces flammes que je vois, viennent d’achever de réduire en cendre, mon adorable Mandane.
Mais que dis-je, peut-eſtre?	Mais que dis-je, peut-être?
Non, non, ne mettons point noſtre malheur en doute, il eſt deſja arrivé;	Non, non, ne mettons point notre malheur en doute, il est déjà arrivé;
& les Dieux n’ont pas permis un ſi grand embrazement pour la ſauver.	et les Dieux n’ont pas permis un si grand embrasement pour la sauver.
S’ils euſſent voulu ne la perdre pas, ils auroient ſouslevé les vagues de la Mer, pour eſteindre ces cruelles flames,	S’ils eussent voulu ne la perdre pas, ils auraient soulevé les vagues de la Mer, pour éteindre ces cruelles flammes,
& ne l’auroient pas miſe en un ſi grand danger.	et ne l’auraient pas mise en un si grand danger.
Mais helas!	Mais hélas!
s’écrioit il, injuſte Rival, n’as tu point ſongé à ta conſervation pluſtost qu’à la ſienne,	s’écriait-il, injuste Rival, n’as tu point songé à ta conservation plutôt qu’à la sienne,
& n’as tu point cauſé ſa perte par ta laſcheté?	et n’as tu point causé sa perte par ta lâcheté?
Si je voyois ma Princeſſe (adjouſtoit il en ſe tournant vers Chriſante) entre les mains d’un Prince, à la teſte de cent mille hommes,	Si je voyais ma Princesse (ajoutait-il en se tournant vers Chrysante) entre les mains d’un Prince, à la tête de cent mille hommes,
& que ce Prince la vouluſt ſacrifier à mes yeux, je ne ſerois pas ſi deſesperé, j’aurois un ennemy que je pourrois du moins attaquer, ſi je ne le pouvois vaincre:	et que ce Prince la voulût sacrifier à mes yeux, je ne serais pas si désespéré, j’aurais un ennemi que je pourrais du moins attaquer, si je ne le pouvais vaincre:
Mais icy, je n’ay rien à faire, qu’à m’aller jetter dans ces meſmes flames, qui ont deſja conſumé ma Princeſſe.	Mais ici, je n’ai rien à faire, qu’à m’aller jeter dans ces mêmes flammes, qui ont déjà consumé ma Princesse.
En diſant cela, il s’avançoit encore davantage:	En disant cela, il s’avançait encore davantage:
& apres avoir eſté quelque temps ſans parler;	et après avoir été quelque temps sans parler;
Ha Ciel!	Ha Ciel!
(s’ecrioit il tout d’un coup, voyant qu’il n’y avoit que Chriſante qui le peuſt entendre) ne ſeroit-je point la cauſe de la mort de ma Princeſſe?	(s’écriait-il tout d’un coup, voyant qu’il n’y avait que Chrysante qui le pût entendre) ne serait-je point la cause de la mort de ma Princesse?
n’eſt-ce point pour l’amour de moy qu’elle a elle meſme embrazé cette Ville, pluſtost que de manquer de fidelité, au malheureux Artamene?	n’est-ce point pour l’amour de moi qu’elle a elle-même embrasé cette Ville, plutôt que de manquer de fidélité, au malheureux Artamène?
Ha Dieu!	Ha Dieu!
s’il eſt ainſi, je ſuis digne de mon infortune;	s’il est ainsi, je suis digne de mon infortune;
& je merite tous les maux que je reſſens.	et je mérite tous les maux que je ressens.
Chriſante voyant qu’il avoit ceſſé de parler, s’approcha de luy, pour taſcher de luy donner quelque legere conſolation:	Chrysante voyant qu’il avait cessé de parler, s’approcha de lui, pour tâcher de lui donner quelque légère consolation:
mais Artamene marchant touſjours;	mais Artamène marchant toujours;
& le regardant d’une maniere capable de donner de la compaſſion aux perſonnes les plus inſensibles;	et le regardant d’une manière capable de donner de la compassion aux personnes les plus insensibles;
Non, non, luy dit-il, Chriſante, ce malheur n’eſt pas de ceux dont l’on peut eſtre conſolé:	Non, non, lui dit-il, Chrysante, ce malheur n’est pas de ceux dont l’on peut être consolé:
& je n’ay qu’une voye à prendre, que je ſuivray ſans doute bien toſt.	et je n’ai qu’une voye à prendre, que je suivrai sans doute bientôt.
Ouy, Chriſante, j’auray du moins cette funeſte conſolation, que ce meſme feu qui a peut-eſtre bruſlé ma Maiſtresse	Oui, Chrysante, j’aurai du moins cette funeste consolation, que ce même feu qui a peut-être brûlé ma Maîtresse
& mon Rival;	et mon Rival;
qui a confondu l’innocence	qui a confondu l’innocence
& le crime;	et le crime;
& qui m’a privé tout enſemble, de l’objet de ma haine,	et qui m’a privé tout ensemble, de l’objet de ma haine,
& de celuy de mon amour, achevera encore de me détruire;	et de celui de mon amour, achèvera encore de me détruire;
& meſlera du moins mes Cendres, avec celles de mon adorable Princeſſe.	et mêlera du moins mes Cendres, avec celles de mon adorable Princesse.
En diſant cela, il ſembloit avoir toutes les marques d’un prochain deſespoir ſur le viſage:	En disant cela, il semblait avoir toutes les marques d’un prochain désespoir sur le visage:
ſa voix avoit quelque choſe de triſte	sa voix avait quelque chose de triste
& de funeſte:	et de funeste:
& toutes ſes actions teſmoignoient aſſez, qu’il ſe preparoit à mourir.	et toutes ses actions témoignaient assez, qu’il se préparait à mourir.
Cependant la pointe du jour venant à paroiſtre;	Cependant la pointe du jour venant à paraître;
& l’approche du Soleil, diminuant quelque choſe, de l’horreur de cét embrazement;	et l’approche du Soleil, diminuant quelque chose, de l’horreur de cet embrasement;
parce que la Mer, la Plaine,	parce que la Mer, la Plaine,
& les Montagnes, reprenoient une partie de leurs couleurs naturelles;	et les Montagnes, reprenaient une partie de leurs couleurs naturelles;
la face de cette funeſte Scene, changea en quelque façon:	la face de cette funeste Scène, changea en quelque façon:
& Feraulas vit preſque en meſme temps deux choſes, qu’il fit remarquer au meſme inſtant à ſon cher Maiſtre.	et Phéraulas vit presque en même temps deux choses, qu’il fit remarquer au même instant à son cher Maître.
Seigneur, luy dit-il, ne voyez vous pas en Mer, une Galere qui vogue,	Seigneur, lui dit-il, ne voyez vous pas en Mer, une Galère qui vogue,
& qui ſemble faire beaucoup d’effort pour s’eſloigner de cette malheureuſe Ville?	et qui semble faire beaucoup d’effort pour s’éloigner de cette malheureuse Ville?
Et ne voyez vous pas encore, comme quoy il ſemble que l’on ne ſonge qu’à eſteindre le feu qui s’approche de cette groſſe Tour, qui eſt ſur le portail du Chaſteau,	Et ne voyez vous pas encore, comme quoi il semble que l’on ne songe qu’à éteindre le feu qui s’approche de cette grosse Tour, qui est sur le portail du Château,
& que l’on abandonne tout le reſte pour la conſerver!	et que l’on abandonne tout le reste pour la conserver!
Je voy l’un	Je vois l’un
& l’autre, reſpondit Artamene;	et l’autre, répondit Artamène;
Je ne sçay, adjouſta Chriſante, ſi ce n’eſt point une marque aſſeurée, que la Princeſſe n’a pas encore pery:	Je ne sais, ajouta Chrysante, si ce n’est point une marque assurée, que la Princesse n’a pas encore péri:
puis qu’il peut eſtre, qu’elle eſt dans cette Galere, ou dans cette Tour, que les flames n’ont pas encore embrazée.	puisqu’il peut être, qu’elle est dans cette Galère, ou dans cette Tour, que les flammes n’ont pas encore embrasée.
Helas!	Hélas!
(s’eſcria tout d’un coup Artamene) s’il eſtoit ainſi, que je ſerois heureux, de pouvoir conſerver quelque eſpoir!	(s’écria tout d’un coup Artamène) s’il était ainsi, que je serais heureux, de pouvoir conserver quelque espoir!
Il s’approcha alors beaucoup plus prés de la Ville:	Il s’approcha alors beaucoup plus près de la Ville:
& voyant effectivement qu’il y avoit pluſieurs perſonnes qui taſchoient d’empeſcher le feu d’approcher de cette Tour;	et voyant effectivement qu’il y avait plusieurs personnes qui tâchaient d’empêcher le feu d’approcher de cette Tour;
Travaille (s’écria t’il en redoublant ſa courſe) trop heureux Rival;	Travaille (s’écria-t-il en redoublant sa course) trop heureux Rival;
travaille pour le ſalut de noſtre Princeſſe:	travaille pour le salut de notre Princesse:
& ſois aſſeuré ſi tu la peux ſauver de ce peril, que je te pardonne tous les maux que tu m’as faits.	et sois assuré si tu la peux sauver de ce péril, que je te pardonne tous les maux que tu m’as faits.
Ce Prince ne demeuroit pourtant pas long temps dans un meſme ſentiment:	Ce Prince ne demeurait pourtant pas longtemps dans un même sentiment:
tantoſt il faiſoit des vœux pour ſa Maiſtresse:	tantôt il faisait des vœux pour sa Maîtresse:
tantoſt des imprecations contre ſon Rival.	tantôt des imprécations contre son Rival.
Un moment apres, regardant cette Galere,	Un moment après, regardant cette Galère,
& luy ſemblant y remarquer des femmes ſur la poupe, il s’en reſjoüiſſoit beaucoup:	et lui semblant y remarquer des femmes sur la poupe, il s’en réjouissait beaucoup:
puis venant à ſonger que quand ce ſeroit ſa Maiſtresse, elle ſeroit touſjours perduë pour luy;	puis venant à songer que quand ce serait sa Maîtresse, elle serait toujours perdue pour lui;
il rentroit dans ſon deſespoir.	il rentrait dans son désespoir.
Apres venant à conſiderer cette Tour, que la Mer	Après venant à considérer cette Tour, que la Mer
& les flames environnoient de toutes parts;	et les flammes environnaient de toutes parts;
& venant à penſer, que peut-eſtre ſa Princeſſe eſtoit enfermée en ce lieu-là, il changeoit de ſentimens tout d’un coup;	et venant à penser, que peut-être sa Princesse était enfermée en ce lieu-là, il changeait de sentiments tout d’un coup;
& ces meſmes Troupes, qui eſtoient venuës pour détruire cette Ville, eurent commandement d’aider à en eſteindre le feu.	et ces mêmes Troupes, qui étaient venues pour détruire cette Ville, eurent commandement d’aider à en éteindre le feu.
Artamene donc ne pouvant ſe reſoudre de retourner ſur ſes pas, envoya Feraulas commander aux ſiens, de marcher en diligence,	Artamène donc ne pouvant se résoudre de retourner sur ses pas, envoya Phéraulas commander aux siens, de marcher en diligence,
& de le ſuivre.	et de le suivre.
Mais en approchant de Sinope, l’on ſentoit un air ſi chaud	Mais en approchant de Sinope, l’on sentait un air si chaud
& ſi embrazé;	et si embrasé;
& l’on entendoit un bruit ſi eſpouvantable, que tout autre qu’Artamene n’auroit jamais entrepris d’y aller.	et l’on entendait un bruit si épouvantable, que tout autre qu’Artamène n’aurait jamais entrepris d’y aller.
Le mugiſſement de la Mer;	Le mugissement de la Mer;
le murmure du Vent;	le murmure du Vent;
le petillement de la flame, joint au bruit affreux, de la chutte des maiſons entieres qui crouloient de fonds en comble;	le pétillement de la flamme, joint au bruit affreux, de la chute des maisons entières qui croulaient de fond en comble;
& à toutes les plaintes,	et à toutes les plaintes,
& à tous les cris que jettoient les mourants;	et à tous les cris que jetaient les mourants;
ou ceux que la peur d’une mort prochaine faiſoit crier, cauſoient une confuſion eſpouventable.	ou ceux que la peur d’une mort prochaine faisait crier, causaient une confusion épouvantable.
De tous ces mugiſſemens, dis-je;	De tous ces mugissements, dis-je;
de tous ces murmures;	de tous ces murmures;
de tous ces cris;	de tous ces cris;
de toutes ces chuttes de maiſons,	de toutes ces chutes de maisons,
& de toutes ces plaintes, il ſe formoit un bruit ſi lugubre	et de toutes ces plaintes, il se formait un bruit si lugubre
& ſi eſclatant, que tous les Echos des Montagnes y reſpondans encore, en formoient une harmonie tres-funeſte, s’il eſt permis d’appeller harmonie, un retentiſſement ſi rempli de confuſion.	et si éclatant, que tous les Echos des Montagnes y répondant encore, en formaient une harmonie très funeste, s’il est permis d’appeler harmonie, un retentissement si rempli de confusion.
Cela n’empeſcha pourtant pas Artamene de ſe faire entendre:	Cela n’empêcha pourtant pas Artamène de se faire entendre:
car eſtant deſja aſſez proche de la Ville, en un lieu où tous les ſiens l’avoient joint;	car étant déjà assez proche de la Ville, en un lieu où tous les siens l’avaient joint;
il ſe tourna vers eux,	il se tourna vers eux,
& leur dit avec une affection inconcevable;	et leur dit avec une affection inconcevable;
Imaginez vous, mes Compagnons, que c’eſt moy qui ſuis dans cette Tour;	Imaginez-vous, mes Compagnons, que c’est moi qui suis dans cette Tour;
que c’eſt moy qui ſuis dans la neceſſité de perir, parmy les eaux, ou parmy les flames;	que c’est moi qui suis dans la nécessité de périr, parmi les eaux, ou parmi les flammes;
& que c’eſt à moy enfin à qui vous allez ſauver la vie.	et que c’est à moi enfin à qui vous allez sauver la vie.
Ou pour mieux dire encore, imaginez vous que voſtre Roy;	Ou pour mieux dire encore, imaginez vous que votre Roi;
voſtre Princeſſe;	votre Princesse;
vos Femmes;	vos Femmes;
vos Peres;	vos Pères;
& vos Enfans;	et vos Enfants;
ſont enfermez dans cette Tour avec Artamene,	sont enfermés dans cette Tour avec Artamène,
& y vont perir;	et y vont périr;
afin qu’eſtans pouſſez par des ſentimens ſi tendres, vous agiſſiez avec plus de courage,	afin qu’étant poussés par des sentiments si tendres, vous agissiez avec plus de courage,
& avec plus de diligence.	et avec plus de diligence.
Il faut, mes Compagnons, il faut aujourd’huy faire, ce qui n’a peut-eſtre jamais eſté fait:	Il faut, mes Compagnons, il faut aujourd’hui faire, ce qui n’a peut-être jamais été fait:
il faut perdre nos ennemis,	il faut perdre nos ennemis,
& les ſauver;	et les sauver;
il faut les combattre d’une main,	il faut les combattre d’une main,
& les ſecourir de l’autre;	et les secourir de l’autre;
& bref il faut faire toutes choſes pour conſerver une Princeſſe, qui doit eſtre voſtre Reine;	et bref il faut faire toutes choses pour conserver une Princesse, qui doit être votre Reine;
& qui merite de l’eſtre de toute la Terre.	et qui mérite de l’être de toute la Terre.
A ces mots, Chriſante, Araſpe, Aglatidas,	À ces mots, Chrysante, Araspe, Aglatidas,
& Hidaſpe, qui commandoient chacun mille hommes en cette occaſion;	et Hidaspe, qui commandaient chacun mille hommes en cette occasion;
s’approcherent d’Artamene, pour recevoir ſes derniers ordres:	s’approchèrent d’Artamène, pour recevoir ses derniers ordres:
& Feraulas qui eſtoit l’Agent de l’entrepriſe,	et Phéraulas qui était l’Agent de l’entreprise,
& celuy qui avoit intelligence dans Sinope;	et celui qui avait intelligence dans Sinope;
& auquel Artucas avoit promis de livrer une des Portes de la Ville cette meſme nuit;	et auquel Artucas avait promis de livrer une des Portes de la Ville cette même nuit;
fut auſſi de ce conſeil:	fut aussi de ce conseil:
& ce fut luy qui dit qu’il ne faloit pas laiſſer d’agir de la meſme façon, que ſi cette Ville n’eſtoit pas embrazée:	et ce fut lui qui dit qu’il ne fallait pas laisser d’agir de la même façon, que si cette Ville n’était pas embrasée:
& qu’ainſi ſans chercher d’autres expediens, il faloit ſans doute marcher droit à la porte du Temple de Mars.	et qu’ainsi sans chercher d’autres expédients, il fallait sans doute marcher drait à la porte du Temple de Mars.
Parce, dit il, que ſi par hazard cét embrazement n’a pas encore mis toute la Ville en confuſion;	Parce, dit il, que si par hasard cet embrasement n’a pas encore mis toute la Ville en confusion;
par tout autre lieu que par celuy-là, nous pourrions trouver de la reſistance:	par tout autre lieu que par celui-là, nous pourrions trouver de la résistance:
la couſtume eſtant meſme en de ſemblables rencontres, de redoubler la Garde, de peur que l’incendie ne ſoit un artifice des ennemis, où au contraire nous ſommes aſſurez de n’en trouver aucune par cét endroit:	la coutume étant même en de semblables rencontres, de redoubler la Garde, de peur que l’incendie ne soit un artifice des ennemis, où au contraire nous sommes assurés de n’en trouver aucune par cet endroit:
car ſi Artucas	car si Artucas
& les ſiens n’ont pas encore eſté devorez par les flames, nous les trouverons preſts à nous aider:	et les siens n’ont pas encore été dévorés par les flammes, nous les trouverons prêts à nous aider:
& s’ils ont peri, aparemment nous ne trouverons là perſonne qui s’oppoſe à noſtre paſſage.	et s’ils ont peri, apparemment nous ne trouverons là personne qui s’oppose à notre passage.
Cét aduis ayant eſté trouvé raiſonnable, ils reſolurent apres, par quel lieu ils pourroient le plus commodément gagner le pied de la Tour:	Cet avis ayant été trouvé raisonnable, ils résolurent après, par quel lieu ils pourraient le plus commodément gagner le pied de la Tour:
mais Aglatidas leur fit remarquer, que l’embrazement commençoit de diminuer du coſté du Port;	mais Aglatidas leur fit remarquer, que l’embrasement commençait de diminuer du côte du Port;
parce que des Galeres	parce que des Galères
& des Vaiſſeaux eſtans pluſtost conſumez que des maiſons, il faloit ſans doute que le feu s’y eſteignist plus toſt qu’ailleurs;	et des Vaisseaux étant plutôt consumés que des maisons, il fallait sans doute que le feu s’y éteignît plutôt qu’ailleurs;
& qu’ainſi il faloit prendre tout le long du Port;	et qu’ainsi il fallait prendre tout le long du Port;
afin de n’avoir preſque plus à ſe garantir que d’un coſté,	afin de n’avoir presque plus à se garantir que d’un côté,
& que par ce moyen, ils pourroient arriver avec aſſez de facilité au pied de la Tour.	et que par ce moyen, ils pourraient arriver avec assez de facilité au pied de la Tour.
Artamene qui ſouhaittoit impatiemment d’y eſtre, ne voulut contredire à rien, de peur de les arreſter davantage;	Artamène qui souhaitait impatiemment d’y être, ne voulut contredire à rien, de peur de les arrêter davantage;
& ſe mit à marcher le premier;	et se mit à marcher le premier;
commandant ſeulement aux ſiens, de crier par toute la Ville, qu’ils ne venoient que pour ſauver la Princeſſe:	commandant seulement aux siens, de crier par toute la Ville, qu’ils ne venaient que pour sauver la Princesse:
afin que ce peuple entendant un Nom qui luy eſtoit ſi cher	afin que ce peuple entendant un Nom qui lui était si cher
& ſi precieux, peuſt faire moins de reſistance;	et si précieux, pût faire moins de résistance;
& mettre moins d’obſtacle à leur deſſein.	et mettre moins d’obstacle à leur dessein.
Ils marcherent donc;	Ils marchèrent donc;
& Feraulas conduiſant Artamene, (qui avoit mis pied à terre, auſſi bien que tous ſes Capitaines) à la porte du Temple de Mars;	et Phéraulas conduisant Artamène, (qui avait mis pied à terre, aussi bien que tous ses Capitaines) à la porte du Temple de Mars;
ils y trouverent celuy qu’ils cherchoient:	ils y trouvèrent celui qu’ils cherchaient:
qui deſesperé qu’il eſtoit, qu’Artamene devſt arriver;	qui désespéré qu’il était, qu’Artamène dût arriver;
(car la veüe de ce funeſte embrazement, l’avoit beaucoup retardé) commençoit de ne ſonger plus qu’à ſe mettre à couvert de la violence des flames.	(car la vue de ce funeste embrasement, l’avait beaucoup retardé) commençait de ne songer plus qu’à se mettre à couvert de la violence des flammes.
Mais il n’eut pas pluſtost veû ceux qu’il attendoit, qu’il fit ouvrir la porte, où il eſtoit peu accompagné:	Mais il n’eut pas plus tôt vu ceux qu’il attendait, qu’il fit ouvrir la porte, où il était peu accompagné:
parce que malgré luy, une grande partie des ſiens eſtoit allé voir en quel eſtat eſtoient leurs Maiſons;	parce que malgré lui, une grande partie des siens était allé voir en quel état étaient leurs Maisons;
leurs Peres;	leurs Pères;
leurs Enfans;	leurs Enfants;
ou leurs Femmes.	ou leurs Femmes.
Ils n’eurent donc aucune peine à ſe rendre Maiſtres de cette porte:	Ils n’eurent donc aucune peine à se rendre Maîtres de cette porte:
mais ils en eurent bien davantage, à ſe garantir du feu qu’ils trouvoient par tout.	mais ils en eurent bien davantage, à se garantir du feu qu’ils trouvaient partout.
Artamene en marchant dans ces ruës toutes enflamées, fut pluſieurs fois expoſé, à ſe voir accabler par la chutte des maiſons:	Artamène en marchant dans ces rues toutes enflammées, fut plusieurs fois exposé, à se voir accabler par la chute des maisons:
& ſi cét objet luy avoit ſemblé terrible par le dehors de la Ville, il luy ſembla eſpouvantable par le dedans.	et si cet objet lui avait semblé terrible par le dehors de la Ville, il lui sembla épouvantable par le dedans.
Ils marchoient l’eſpée à la main droite,	Ils marchaient l’épée à la main droite,
& le bouclier à la gauche;	et le bouclier à la gauche;
dont ils eurent plus de beſoin de ſe ſervir pour repouſſer les charbons ardants qui tomboient de toutes parts ſur leurs teſtes;	dont ils eurent plus de besoin de se servir pour repousser les charbons ardents qui tombaient de toutes parts sur leurs têtes;
que pour recevoir les traits de leurs Ennemis.	que pour recevoir les traits de leurs Ennemis.
Ce n’eſt pas que d’abord l’arrivée d’Artamene ne redoublaſt les cris	Ce n’est pas que d’abord l’arrivée d’Artamène ne redoublât les cris
& l’eſtonnement, parmy ce qui reſtoit de perſonnes vivantes dans cette Ville:	et l’étonnement, parmi ce qui restait de personnes vivantes dans cette Ville:
& que ce Heros n’en viſt pluſieurs, qui eſtans occupez à eſteindre le feu de leurs propres logemens, ou à ſauver leurs familles;	et que ce Héros n’en vît plusieurs, qui étant occupés à éteindre le feu de leurs propres logements, ou à sauver leurs familles;
quittoient cét office charitable, pour taſcher de ſe raſſembler,	quittaient cet office charitable, pour tâcher de se rassembler,
& de faire quelque reſistance.	et de faire quelque résistance.
Mais ils ne trouvoient dans ce grand deſordre, ny armes, ny Chefs, ny compagnons capables de s’oppoſer à ſon paſſage.	Mais ils ne trouvaient dans ce grand désordre, ni armes, ni Chefs, ni compagnons capables de s’opposer à son passage.
L’on voyoit en un lieu des gens qui abatoient leurs propres maiſons, pour ſauver celles de leurs voiſins:	L’on voyait en un lieu des gens qui abattaient leurs propres maisons, pour sauver celles de leurs voisins:
l’on en voyoit d’autres qui jettoient ce qu’ils avoient de plus precieux par les feneſtres, pour taſcher d’en ſauver au moins quelque choſe:	l’on en voyait d’autres qui jetaient ce qu’ils avaient de plus précieux par les fenêtres, pour tâcher d’en sauver au moins quelque chose:
l’on voyoit des Meres, qui ſans ſe ſoucier ny de meubles, ny de maiſons, s’enfuyoient les cheveux deſja à demy bruſlez, avec leurs enfans ſeulement entre les bras:	l’on voyait des Mères, qui sans se soucier ni de meubles, ni de maisons, s’enfuyaient les cheveux déjà à demi brûlés, avec leurs enfants seulement entre les bras:
Enfin l’on voyoit des choſes ſi pitoyables	Enfin l’on voyait des choses si pitoyables
& ſi terribles tout enſemble;	et si terribles tout ensemble;
que ſi Artamene n’euſt pas eſté emporté comme il l’eſtoit, par une paſſion violente;	que si Artamène n’eût pas été emporté comme il l’était, par une passion violente;
il ſe fuſt arreſté à chaque pas pour les ſecourir, tant ils eſtoient dignes de compaſſion,	il se fût arrêté à chaque pas pour les secourir, tant ils étaient dignes de compassion,
& tant il eſtoit ſensible à leur miſere.	et tant il était sensible à leur misère.
Cependant il avançoit touſjours:	Cependant il avançait toujours:
mais le bruit de ſa venuë l’ayant pourtant devancé;	mais le bruit de sa venue l’ayant pourtant devancé;
Aribée Gouverneur de Sinope, qui faiſoit tous ſes efforts, pour empeſcher que le feu ne gagnaſt la Tour,	Aribée Gouverneur de Sinope, qui faisait tous ses efforts, pour empêcher que le feu ne gagnât la Tour,
& qui occupoit en ce lieu, la meilleure partie de ce qui reſtoit de peuple	et qui occupait en ce lieu, la meilleure partie de ce qui restait de peuple
& de ſoldats dans la Ville;	et de soldats dans la Ville;
ne le sçeut pas pluſtost, qu’il ſe trouva dans une inquietude inconcevable;	ne le sut pas plutôt, qu’il se trouva dans une inquiétude inconcevable;
& dans une incertitude, qu’on ne sçauroit exprimer:	et dans une incertitude, qu’on ne saurait exprimer:
ne sçachant s’il devoit aller combattre, ou s’il devoit continuer de faire eſteindre ce feu.	ne sachant s’il devait aller combattre, ou s’il devait continuer de faire éteindre ce feu.
Car, diſoit il, que ſervira au Roy d’Aſſirie que je vainque, s’il eſt vaincu par les flames?	Car, disait-il, que servira au Roi d’Assyrie que je vainque, s’il est vaincu par les flammes?
Mais que me ſervira t’il auſſi à moy meſme d’eſteindre ce feu, adjouſtoit il, ſi je ſuis pris par Artamene?	Mais que me servira-t-il aussi à moi-même d’éteindre ce feu, ajoutait-il, si je suis pris par Artamène?
moy qui ſuis ſon plus grand ennemy;	moi qui suis son plus grand ennemi;
moy qui ay trahy le Roy mon Maiſtre;	moi qui ai trahi le Roi mon Maître;
moy qui ay ſervi à l’enlevement de la Princeſſe ſa Fille;	moi qui ai servi à l’enlèvement de la Princesse sa Fille;
& qui ay fait revolter ſes Peuples.	et qui ai fait révolter ses Peuples.
Ha!	Ha!
non non, combattons Artamene, qui eſt auſſi redoutable au Roy d’Aſſirie, que le feu	non non, combattons Artamène, qui est aussi redoutable au Roi d’Assyrie, que le feu
& que les flames:	et que les flammes:
& ſongeons à noſtre conſervation, en penſant à celle d’autruy.	et songeons à notre conservation, en pensant à celle d’autrui.
En diſant cela, il commanda à ceux qui eſteignoient le feu,	En disant cela, il commanda à ceux qui éteignaient le feu,
& qui par des machines dont ils ſe ſervoient, taſchoient de luy couper chemin, en abatant les maiſons voiſines, où il s’eſtoit attaché;	et qui par des machines dont ils se servaient, tâchaient de lui couper chemin, en abatant les maisons voisines, où il s’était attaché;
de prendre des armes s’ils en avoient;	de prendre des armes s’ils en avaient;
d’en aller chercher en diligence s’ils n’en avoient point;	d’en aller chercher en diligence s’ils n’en avaient point;
ou de s’en faire de tout ce qu’ils rencontreroient;	ou de s’en faire de tout ce qu’ils rencontreraient;
& meſme du feu	et même du feu
& des flames;	et des flammes;
pluſtost que de ne le ſecourir pas.	plutôt que de ne le secourir pas.
Apres donc qu’Artamene eut traverſé une partie de cette Ville embrazée;	Après donc qu’Artamène eut traversé une partie de cette Ville embrasée;
& qu’ayant marché tout le long du Port, il fut arrivé proche de la Tour;	et qu’ayant marché tout le long du Port, il fut arrivé proche de la Tour;
il fut bien ſurpris de voir que perſonne ne travailloit plus pour eſteindre le feu,	il fut bien surpris de voir que personne ne travaillait plus pour éteindre le feu,
& qu’Aribée s’avançoit pour le combattre.	et qu’Aribée s’avançait pour le combattre.
Quoy, s’écria-t’il, je viens pour eſteindre ces flames,	Quoi, s’écria-t-il, je viens pour éteindre ces flammes,
& ce ſera moy qui empeſcheray qu’on ne les eſtéigne?	et ce sera moi qui empêcherai qu’on ne les éteigne?
Ha!	Ha!
non non, mes Compagnons, il ne le faut pas.	non non, mes Compagnons, il ne le faut pas.
En diſant cela, il commanda à une partie de ſiens, de ſonger à faire ce que les autres ne faiſoient plus;	En disant cela, il commanda à une partie de siens, de songer à faire ce que les autres ne faisaient plus;
pendant qu’il combatroit ceux qui ſembloient en avoir envie.	pendant qu’il combattrait ceux qui semblaient en avoir envie.
Comme il eſtoit en cét eſtat,	Comme il était en cet état,
& qu’il s’avançoit vers le gros, à la teſte duquel eſtoit Aribée;	et qu’il s’avançait vers le gros, à la tête duquel était Aribée;
il leva les yeux vers le haut de la Tour:	il leva les yeux vers le haut de la Tour:
& y reconnut le Roy d’Aſſirie:	et y reconnut le Roi d’Assyrie:
qui par une action toute deſesperée, ſembloit n’avoir autre deſſein, que de choiſir s’il ſe jetteroit dans les flames ou dans la Mer.	qui par une action toute désespérée, semblait n’avoir autre dessein, que de choisir s’il se jetterait dans les flammes ou dans la Mer.
Cette veuë ayant encore confirmé Artamene, dans la croyance que ſa Maiſtresse n’eſtoit pas morte;	Cette vue ayant encore confirmé Artamène, dans la croyance que sa Maîtresse n’était pas morte;
il redoubla les commandemens qu’il avoit deſja faits, d’eſteindre ce feu;	il redoubla les commandements qu’il avait déjà faits, d’éteindre ce feu;
& marcha teſte baiſſée vers ſes Ennemis, qui venoient à luy, avec aſſez de reſolution.	et marcha tête baissée vers ses Ennemis, qui venaient à lui, avec assez de résolution.
Comme il fut proche d’eux,	Comme il fut proche d’eux,
& qu’il reconnut diſtinctement qui eſtoit leur Chef;	et qu’il reconnut distinctement qui était leur Chef;
Aribée, luy cria t’il, je ne viens pas aujourd’huy pour te combatre,	Aribée, lui cria-t-il, je ne viens pas aujourd’hui pour te combattre,
& pour te punir:	et pour te punir:
& il ne tiendra qu’à toy, que je n’obtienne ton pardon du Roy des Medes, ſi tu veux mettre les armes bas;	et il ne tiendra qu’à toi, que je n’obtienne ton pardon du Roi des Mèdes, si tu veux mettre les armes bas;
& m’ayder à, ſauver ta Princeſſe	et m’aider à, sauver ta Princesse
& la mienne.	et la mienne.
Mais Aribée, qui croyoit ſon crime trop grand, pour luy pouvoir eſtre jamais pardonné;	Mais Aribée, qui croyait son crime trop grand, pour lui pouvoir être jamais pardonné;
& qui de plus, avoit appris une choſe, qu’Artamene ignoroit encore;	et qui de plus, avait appris une chose, qu’Artamène ignorait encore;
au lieu de luy reſpondre, s’eſlança vers luy l’eſpée haute,	au lieu de lui répondre, s’élança vers lui l’épée haute,
& commença un combat au milieu des feux	et commença un combat au milieu des feux
& des flames;	et des flammes;
qui n’eſtoit pas moins redoutable, par ce qui tomboit d’enhaut, que pour les coups qui partoient de la main d’un Ennemy invincible;	qui n’était pas moins redoutable, par ce qui tombait d’en haut, que pour les coups qui partaient de la main d’un Ennemi invincible;
que l’Amour, la Haine,	que l’Amour, la Haine,
& la Vangeance, rendoient encore plus vaillant qu’à l’accouſtumée;	et la Vengeance, rendaient encore plus vaillant qu’à l’accoutumée;
quoy qu’il fuſt toujours le plus vaillant homme du monde.	quoiqu’il fût toujours le plus vaillant homme du monde.
Hidaſpe, Artucas, Chriſante, Aglatidas,	Hidaspe, Artucas, Chrysante, Aglatidas,
& Araſpe;	et Araspe;
ſe rangerent aupres d’Artamene:	se rangèrent auprès d’Artamène:
car pour Feraulas, ce fut luy qui eut ordre de faire continuer d’eſteindre le feu.	car pour Phéraulas, ce fut lui qui eut ordre de faire continuer d’éteindre le feu.
Ainſi le Roy d’Aſſirie voyoit tout à la fois, travailler à ſon ſalut	Ainsi le Roi d’Assyrie voyait tout à la fois, travailler à son salut
& à ſa perte;	et à sa perte;
vouloir ſauver ſa vie,	vouloir sauver sa vie,
& vaincre celuy qui l’avoit ſervi.	et vaincre celui qui l’avait servi.
Encore (diſoit Artamene en luy meſme,	Encore (disait Artamène en lui-même,
& en jettant les yeux vers le haut de la Tour, où il voyoit touſjours ſon Rival) ſi ma Princeſſe regardoit ce que je fais pour la ſauver, je ſerois bien moins malheureux:	et en jetant les yeux vers le haut de la Tour, où il voyait toujours son Rival) si ma Princesse regardait ce que je fais pour la sauver, je serais bien moins malheureux:
& ſi j’eſtois aſſeuré qu’elle viſt ma mort, ou ma victoire, je n’aurois preſque rien à deſirer.	et si j’étais assuré qu’elle vît ma mort, ou ma victoire, je n’aurais presque rien à désirer.
Cependant la meſlée ſe commence,	Cependant la mêlée se commence,
& ſe continuë fort chaudement:	et se continue fort chaudement:
& ſans qu’Artamene ceſſe de fraper, il ne laiſſe pas d’avoir ſoin de voir ſi Feraulas fait bien executer ſes ordres.	et sans qu’Artamène cesse de frapper, il ne laisse pas d’avoir soin de voir si Phéraulas fait bien exécuter ses ordres.
Enfin dans cette confuſion, il s’attache en un combat particulier contre Aribée, qui fut dangereux	Enfin dans cette confusion, il s’attache en un combat particulier contre Aribée, qui fut dangereux
& opiniaſtré:	et opiniâtré:
car quoy que ce traiſtre euſt en teſte le plus redoutable des hommes, le deſespoir faiſoit en luy, ce que la valeur n’auroit pû faire en un autre.	car quoique ce traître eût en tête le plus redoutable des hommes, le désespoir faisait en lui, ce que la valeur n’aurait pu faire en un autre.
Neantmoins comme au contraire, Artamene combatoit alors avec eſpoir;	Néanmoins comme au contraire, Artamène combattait alors avec espoir;
& qu’il eſtoit perſuadé, qu’il n’y avoit plus que quelques murailles entre ſa Princeſſe	et qu’il était persuadé, qu’il n’y avait plus que quelques murailles entre sa Princesse
& luy;	et lui;
il fit des choſes prodigieuſes.	il fit des choses prodigieuses.
Il tua tout ce qui s’oppoſa à ſon paſſage;	Il tua tout ce qui s’opposa à son passage;
& bleſſa Aribée en tant de lieux, qu’enfin il ſe ſeroit ſans doute reſolu de ſe rendre;	et blessa Aribée en tant de lieux, qu’enfin il se serait sans doute résolu de se rendre;
ſi tout d’un coup une maiſon enflamée ne fuſt tombée ſi prés du lieu où ils combatoient, qu’Aribée en fut enſeveli ſous ſes ruines:	si tout d’un coup une maison enflammée ne fût tombée si près du lieu où ils combattaient, qu’Aribée en fut enseveli sous ses ruines:
& l’on creut qu’il avoit peri par le fer	et l’on crut qu’il avait péri par le fer
& par le feu, pour expier une rebellion criminelle, qui meritoit tous les deux enſemble.	et par le feu, pour expier une rébellion criminelle, qui méritait tous les deux ensemble.
Artamene qui n’avoit pû eſtre bleſſé par ſon Ennemy, penſa eſtre accablé en cette rencontre,	Artamène qui n’avait pu être blessé par son Ennemi, pensa être accablé en cette rencontre,
& ſe vit tout couvert de flame;	et se vit tout couvert de flamme;
tout environné de charbons	tout environné de charbons
& de fumée:	et de fumée:
& s’il n’euſt mis ſon Bouclier ſur ſa teſte, il eſtoit infailliblement perdu.	et s’il n’eût mis son Bouclier sur sa tête, il était infailliblement perdu.
Toute ſa Cotte d’armes en fut à demy bruſlée:	Toute sa Cotte d’armes en fut à demi brûlée:
& peu s’en falut qu’il ne periſt en cette rencontre.	et peu s’en fallut qu’il ne pérît en cette rencontre.
La chutte de cette maiſon, fit qu’il s’eſleva en l’air une pouſſiere ſi eſpaisse:	La chute de cette maison, fit qu’il s’éleva en l’air une poussière si épaisse:
une fumée ſi noire;	une fumée si noire;
& une nuée d’eſtincelles ſi bruſlantes, que l’on fut quelque temps ſans pouvoir rien voir de tout ce qui ſe paſſoit en ce lieu là.	et une nuée d’étincelles si brûlantes, que l’on fut quelque temps sans pouvoir rien voir de tout ce qui se passait en ce lieu là.
Ce qui ſurprit Artamene en cette occaſion, fut que lors que cette maiſon embrazée tomba, Aribée, qui à ce qu’on pouvoit juger par ſon action, avoit eu deſſein de ſe rendre, s’eſtoit reculé de quatre ou cinq pas:	Ce qui surprit Artamène en cette occasion, fut que lorsque cette maison embrasée tomba, Aribée, qui à ce qu’on pouvait juger par son action, avait eu dessein de se rendre, s’était reculé de quatre ou cinq pas:
ſi bien que par là, il ſembloit eſtre allé au devant de ce qui le devoit accabler:	si bien que par là, il semblait être allé au devant de ce qui le devait accabler:
& par un miracle de la Fortune, Artamene, qui le touchoit de la pointe de ſon eſpée, ne ſe trouva pourtant point engagé ſous ces perilleuſes ruines.	et par un miracle de la Fortune, Artamène, qui le touchait de la pointe de son épée, ne se trouva pourtant point engagé sous ces périlleuses ruines.
Apres cét accident, tout ce qui le ſecondoit s’eſtonna	Après cet accident, tout ce qui le secondait s’étonna
& s’enfuit:	et s’enfuit:
& noſtre Heros faiſant crier;	et notre Héros faisant crier;
& leur criant luy meſme, qu’il venoit pour les ſervir,	et leur criant lui-même, qu’il venait pour les servir,
& qu’il ne vouloit point leur perte;	et qu’il ne voulait point leur perte;
les obligea enfin à jetter leurs armes;	les obligea enfin à jeter leurs armes;
& à ſe fier en la parole d’un Vainqueur, qu’ils avoient autre-fois tant aymé.	et à se fier en la parole d’un Vainqueur, qu’ils avaient autrefois tant aimé.
Ainſi en fort de peu temps, tout le monde ſe trouva d’un meſme Parti:	Ainsi en fort de peu temps, tout le monde se trouva d’un même Parti:
& Artamene encourageant les ſiens,	et Artamène encourageant les siens,
& leur monſtrant par ſon exemple, ce qu’il faloit faire pour eſteindre le feu;	et leur montrant par son exemple, ce qu’il fallait faire pour éteindre le feu;
ce Peuple fut ravi de voir de charitables Ennemis.	ce Peuple fut ravi de voir de charitables Ennemis.
Ils abatirent des maiſons avec des Beliers:	Ils abattirent des maisons avec des Béliers:
ils employerent leurs Boucliers à jetter de l’eau, ſur tout ce qui tomboit d’enflamé, de peur que cela n’embrazaſt ce qui ne l’eſtoit pas encore;	ils employèrent leurs Boucliers à jeter de l’eau, sur tout ce qui tombait d’enflammé, de peur que cela n’embrasât ce qui ne l’était pas encore;
& enfin ils n’oublierent rien, de tout ce qu’ils jugerent qui pouvoit ſervir.	et enfin ils n’oublièrent rien, de tout ce qu’ils jugèrent qui pouvait servir.
Tous les Chefs firent des miracles en cette journée:	Tous les Chefs firent des miracles en cette journée:
mais entre les autres, Aglatidas ſembloit avoir eu deſſein, de chercher pluſtost la mort que la victoire;	mais entre les autres, Aglatidas semblait avoir eu dessein, de chercher plutôt la mort que la victoire;
tant il s’eſtoit courageuſement expoſé à la fureur des flames,	tant il s’était courageusement exposé à la fureur des flammes,
& au deſespoir des Ennnemis.	et au désespoir des Ennnemis.
Cependant Artamene voyant que le feu commençoit de diminuër, ſe reſjoüiſſoit en luy meſme, dans l’eſperance qu’il avoit, de revoir bien toſt ſa chere Princeſſe.	Cependant Artamène voyant que le feu commençait de diminuer, se réjouissait en lui-même, dans l’espérance qu’il avait, de revoir bientôt sa chère Princesse.
Elle eſt, diſoit-il en ſon cœur, dans cette Tour:	Elle est, disait-il en son cœur, dans cette Tour:
& ſi je ne ſuis le plus malheureux des hommes, je verray dans quelques moments, cette adorable perſonne:	et si je ne suis le plus malheureux des hommes, je verrai dans quelques moments, cette adorable personne:
& j’entendray peut-eſtre ſa belle bouche, m’appeller ſon Liberateur.	et j’entendrai peut-être sa belle bouche, m’appeler son Libérateur.
Enfin, diſoit il encore, je verray bien toſt l’objet de ma haine	Enfin, disait-il encore, je verrai bientôt l’objet de ma haine
& de mon amour.	et de mon amour.
En effet, le feu ayant eſté eſteint de ce coſté là;	En effet, le feu ayant été éteint de ce côté-là;
& eſtant arrivé à la porte de la Tour, qui commençoit deſja de s’embrazer, il envoya s’aſſeurer de toutes les portes de la Ville;	et étant arrivé à la porte de la Tour, qui commençait déjà de s’embraser, il envoya s’assurer de toutes les portes de la Ville;
mais comme il voulut faire enfoncer celle de cette Tour, ne sçachant s’il n’y trouveroit point encore quelque reſistance;	mais comme il voulut faire enfoncer celle de cette Tour, ne sachant s’il n’y trouverait point encore quelque résistance;
il vit un homme de fort bonne mine qui la luy ouvrit;	il vit un homme de fort bonne mine qui la lui ouvrit;
& qui au lieu de luy en diſputer l’entrée, comme il euſt fait, s’il ne l’euſt pas reconnu auparavant du haut des creneaux;	et qui au lieu de lui en disputer l’entrée, comme il eût fait, s’il ne l’eût pas reconnu auparavant du haut des créneaux;
luy dit avec beaucoup de reſpect, Seigneur, ſi le Nom de Thraſibule n’eſt pas ſorti de voſtre mémoire, accordez luy la grace d’employer voſtre authorité, pour empeſcher la perte d’une illuſtre Perſonne, que le deſespoir va ſans doute faire perir, ſur le haut de cette Tour, ſi vous ne m’aydez à la ſecourir promptement.	lui dit avec beaucoup de respect, Seigneur, si le Nom de Thrasibule n’est pas sorti de votre mémoire, accordez lui la grâce d’employer votre autorité, pour empêcher la perte d’une illustre Personne, que le désespoir va sans doute faire périr, sur le haut de cette Tour, si vous ne m’aidez à la secourir promptement.
Artamene, qui creut que c’eſtoit ſa Princeſſe, qui eſtoit en cette extremité, ne s’amuſa pas à faire un long compliment, au genereux Thraſibule, qu’il reconnut d’abord à la voix;	Artamène, qui crut que c’était sa Princesse, qui était en cette extrémité, ne s’amusa pas à faire un long compliment, au généreux Thrasibule, qu’il reconnut d’abord à la voix;
Allons mon ancien vainqueur (dit il à ce fameux Pirate qui n’avoit point déguiſé ſon veritable Nom, parce qu’eſtant fort commun parmi les Grecs, il ne pouvoit pas le faire reconnoiſtre) allons ſecourir cette perſonne illuſtre:	Allons mon ancien vainqueur (dit-il à ce fameux Pirate qui n’avait point déguisé son véritable Nom, parce qu’étant fort commun parmi les Grecs, il ne pouvait pas le faire reconnaître) allons secourir cette personne illustre:
& en diſant ces paroles avec aſſez de precipitation;	et en disant ces paroles avec assez de précipitation;
il monta l’eſcalier, ſuivi de grand nombre des ſiens;	il monta l’escalier, suivi de grand nombre des siens;
mais particulierement d’Hidaſpe;	mais particulièrement d’Hidaspe;
de Chriſante;	de Chrysante;
d’Aglatidas;	d’Aglatidas;
de Thraſibule,	de Thrasibule,
& de Feraulas:	et de Phéraulas:
& tous, excepté Thraſibule, eſtoient eſtonnez de ne rencontrer point de Soldats dans cette Tour,	et tous, excepté Thrasibule, étaient étonnés de ne rencontrer point de Soldats dans cette Tour,
& de n’en voir point dans le reſte du Chaſteau.	et de n’en voir point dans le reste du Château.
Araſpe par les ordres d’Artamene, demeura à la porte avec ſes compagnons, afin de ne s’expoſer pas mal à propos à quelque ſurprise.	Araspe par les ordres d’Artamène, demeura à la porte avec ses compagnons, afin de ne s’exposer pas mal à propos à quelque surprise.
Ce Prince donc impatient de revoir ſa Maiſtresse, marche le premier;	Ce Prince donc impatient de revoir sa Maîtresse, marche le premier;
& devançant les autres d’aſſez loing, arrive au haut de cette Tour.	et devançant les autres d’assez loin, arrive au haut de cette Tour.
Mais helas, quel deſplaisir,	Mais hélas, quel déplaisir,
& quel eſtonnement fut le ſien!	et quel étonnement fut le sien!
lors qu’au lieu d’y voir ſa Princeſſe, il n’y vit que le Roy d’Aſſirie;	lors qu’au lieu d’y voir sa Princesse, il n’y vit que le Roi d’Assyrie;
c’eſt à dire le raviſſeur de Mandane, ſon Rival	c’est-à-dire le ravisseur de Mandane, son Rival
& ſon Ennemi:	et son Ennemi:
mais un Ennemi ſans armes,	mais un Ennemi sans armes,
& accablé de douleur.	et accablé de douleur.
Artamene ſe tourna alors vers Thraſibule, comme pour luy demander, ſi c’eſtoit là cette illuſtre perſonne, dont il luy avoit voulu parler;	Artamène se tourna alors vers Thrasibule, comme pour lui demander, si c’était là cette illustre personne, dont il lui avait voulu parler;
& voyant que tous ceux qui l’avoient ſuivi, vouloient auſſi eſtre ſur le haut de cette Tour;	et voyant que tous ceux qui l’avaient suivi, voulaient aussi être sur le haut de cette Tour;
& prevoyant que ſa converſation avec le Roy d’Aſſirie, ne ſeroit pas d’un ſtile à eſtre eſcoutée de tant de monde;	et prévoyant que sa conversation avec le Roi d’Assyrie, ne serait pas d’un style à être écoutée de tant de monde;
il leur fit ſigne qu’ils ſe retiraſſent, ſe preparant à demander où eſtoit ſa Princeſſe;	il leur fit signe qu’ils se retirassent, se préparant à demander où était sa Princesse;
croyant encore qu’elle pouvoit eſtre dans un Apartement plus bas, ou en quelque autre lieu du Chaſteau.	croyant encore qu’elle pouvait être dans un Appartement plus bas, ou en quelque autre lieu du Château.
Mais il fut bien ſurpris d’entendre que le Roy d’Aſſirie luy dit;	Mais il fut bien surpris d’entendre que le Roi d’Assyrie lui dit;
Tu vois, Artamene, tu vois un Prince bien plus malheureux que toy;	Tu vois, Artamène, tu vois un Prince bien plus malheureux que toi;
puis qu’il eſt la cauſe de ſon malheur	puisqu’il est la cause de son malheur
& du tien.	et du tien.
Mais tu peux voir en meſme temps (adjouſta t’il, en luy monſtrant une Galere qui paroiſſoit en Mer,	Mais tu peux voir en même temps (ajouta-t-il, en lui montrant une Galère qui paraissait en Mer,
& qui n’eſtoit pas encore fort eſloignée, parce qu’elle avoit le vent contraire) un autre raviſſeur de noſtre Princeſſe, bien plus criminel que moy;	et qui n’était pas encore fort éloignée, parce qu’elle avait le vent contraire) un autre ravisseur de notre Princesse, bien plus criminel que moi;
puis qu’il m’avoit promis une amitié inviolable;	puisqu’il m’avait promis une amitié inviolable;
& que je ne t’avois jamais fait eſperer nulle part en mon affection.	et que je ne t’avais jamais fait espérer nulle part en mon affection.
Quoy (s’écria alors Artamene, en regardant cette Galere,	Quoi (s’écria alors Artamène, en regardant cette Galère,
& ne regardant plus ſon Ennemi;	et ne regardant plus son Ennemi;
(la Princeſſe n’eſt plus en tes mains?	(la Princesse n’est plus en tes mains?
Non, luy reſpondit le Roy d’Aſſirie en ſoupirant:	Non, lui répondit le Roi d’Assyrie en soupirant:
le Prince Mazare, le plus infidelle de tous les hommes me l’enleve;	le Prince Mazare, le plus infidèle de tous les hommes me l’enlève;
& t’oſte le plus doux fruit de ta victoire.	et t’ôte le plus doux fruit de ta victoire.
Mais puis que tu ne peux ſatisfaire ton amour, par la veuë de ta Princeſſe;	Mais puisque tu ne peux satisfaire ton amour, par la vue de ta Princesse;
ſatisfaits du moins ta haine, par la vangeance que tu peux prendre de ton Rival.	satisfais du moins ta haine, par la vengeance que tu peux prendre de ton Rival.
Tu vois que je ne ſuis pas en eſtat de t’en empeſcher;	Tu vois que je ne suis pas en état de t’en empêcher;
& ſi j’avois pû ne ſuivre pas des yeux cette Galere, tant qu’elle paroiſtra le long de cette côſte;	et si j’avais pu ne suivre pas des yeux cette Galère, tant qu’elle paraîtra le long de cette côte;
il y auroit deſja long temps que je me ſerois jetté dans la Mer ou dans les flames, pour achever mes mal-heurs,	il y aurait déjà longtemps que je me serais jeté dans la Mer ou dans les flammes, pour achever mes malheurs,
& pour ne tomber pas entre les mains de mon Ennemi.	et pour ne tomber pas entre les mains de mon Ennemi.
Les Ennemis d’Artamene (luy reſpondit ce genereux affligé) n’ont rien à craindre de luy, que lors qu’ils ont les armes à la main:	Les Ennemis d’Artamène (lui répondit ce généreux affligé) n’ont rien à craindre de lui, que lorsqu’ils ont les armes à la main:
& l’eſtat où je te voy, te met à couvert de ma haine,	et l’état où je te vois, te met à couvert de ma haine,
& de mon reſſentiment.	et de mon ressentiment.
A ces mots, Artamene ſe ſentit ſi accablé de douleur, que jamais perſonne ne le fut davantage:	À ces mots, Artamène se sentit si accablé de douleur, que jamais personne ne le fut davantage:
il voyoit ſa Maiſtresse une ſeconde fois enlevée,	il voyait sa Maîtresse une seconde fois enlevée,
& ne pouvoit la ſuivre ny la ſecourir:	et ne pouvait la suivre ni la secourir:
puis que tous les vaiſſeaux	puisque tous les vaisseaux
& toutes les Galeres, qui eſtoient dans le Port, ayant peri par les flames, il n’eſtoit pas en ſa puiſſance de ſuivre ce dernier raviſſeur pour le punir.	et toutes les Galères, qui étaient dans le Port, ayant péri par les flammes, il n’était pas en sa puissance de suivre ce dernier ravisseur pour le punir.
Il voyoit d’autre coſté ſon premier Rival en ſon pouvoir:	Il voyait d’autre côté son premier Rival en son pouvoir:
mais il le voyoit ſeul	mais il le voyait seul
& ſans armes;	et sans armes;
& ſans autre deſſein que celuy de ſonger à mourir.	et sans autre dessein que celui de songer à mourir.
En ce pitoyable eſtat, deſesperé qu’il eſtoit, par une affliction ſans égale, comme ſans remede;	En ce pitoyable état, désespéré qu’il était, par une affliction sans égale, comme sans remède;
il y avoit des momens où ſa generoſité n’eſtoit aſſez forte, pour l’empeſcher de penſer à ſatisfaire en quelque façon ſa vangeance, par la perte de ſon Rival:	il y avait des moments où sa générosité n’était assez forte, pour l’empêcher de penser à satisfaire en quelque façon sa vengeance, par la perte de son Rival:
il y en avoit d’autres auſſi, où il n’en vouloit qu’à ſa propre vie:	il y en avait d’autres aussi, où il n’en voulait qu’à sa propre vie:
& dans cette cruelle incertitude de ſentimens, ne sçachant ce qu’il devoit faire, ny meſme ce qu’il vouloit faire;	et dans cette cruelle incertitude de sentiments, ne sachant ce qu’il devait faire, ni même ce qu’il voulait faire;
il entendit le Roy d’Aſſirie qui luy cria, Tu vois, Artamene, tu vois que la Fortune te favoriſe en toutes choſes:	il entendit le Roi d’Assyrie qui lui cria, Tu vois, Artamène, tu vois que la Fortune te favorise en toutes choses:
que le vent s’eſtant renforcé, repouſſe cette Galere vers le rivage:	que le vent s’étant renforcé, repousse cette Galère vers le rivage:
& que peut-eſtre bien toſt, tu reverras ta Princeſſe.	et que peut-être bientôt, tu reverras ta Princesse.
Artamene regardant alors vers la Mer, vit effectivement que par la violence d’un vent contraire, cette Galere c’eſtoit ſi fort raprochée, que l’on pouvoit facilement diſtinguer des Femmes, qui paroiſſoient ſur la Poupe:	Artamène regardant alors vers la Mer, vit effectivement que par la violence d’un vent contraire, cette Galère c’était si fort rapprochée, que l’on pouvait facilement distinguer des Femmes, qui paraissaient sur la Poupe:
& remarquer en meſme temps, qu’avec un prodigieux	et remarquer en même temps, qu’avec un prodigieux
& vain effort, la Chiurme faiſoit ce que les Mariniers appellent Paſſe-vogue, pour reſister aux vagues	et vain effort, la Chiourme faisait ce que les Mariniers appellent Passe-vogue, pour résister aux vagues
& aux vents;	et aux vents;
& pour s’eſloigner de la terre à force de rames.	et pour s’éloigner de la terre à force de rames.
A cét inſtant, l’on vit de la joye dans les yeux d’Artamene:	À cet instant, l’on vit de la joie dans les yeux d’Artamène:
mais pour le Roy d’Aſſirie l’on ne vit que de la douleur,	mais pour le Roi d’Assyrie l’on ne vit que de la douleur,
& du deſespoir dans les ſiens;	et du désespoir dans les siens;
sçachant bien que quand le vent repouſſeroit cette Galere dans le Port, ce ne ſeroit qu’à l’avantage d’Artamene,	sachant bien que quand le vent repousserait cette Galère dans le Port, ce ne serait qu’à l’avantage d’Artamène,
& que ce ne pouvoit eſtre au ſien.	et que ce ne pouvait être au sien.
Il s’imaginoit pourtant quelque eſpece de conſolation, dans l’eſperance qu’il concevoit, de pouvoir punir Mazare.	Il s’imaginait pourtant quelque espèce de consolation, dans l’espérance qu’il concevait, de pouvoir punir Mazare.
Ne me permettras tu pas, dit il à Artamene, ſi les Dieux te redonnent ta Princeſſe, de t’eſpargner la peine de chaſtier ton raviſſeur?	Ne me permettras-tu pas, dit-il à Artamène, si les Dieux te redonnent ta Princesse, de t’épargner la peine de châtier ton ravisseur?
& ne ſouffriras tu pas que pour faire ce combat, l’on me donne une eſpée?	et ne souffriras-tu pas que pour faire ce combat, l’on me donne une épée?
que je te promets de paſſer un moment apres ma victoire au travers de mon cœur, afin de te laiſſer joüir en paix, d’un bon heur que je te diſputerois toujours, tant que je ſerois en vie.	que je te promets de passer un moment après ma victoire au travers de mon cœur, afin de te laisser jouir en paix, d’un bonheur que je te disputerais toujours, tant que je serais en vie.
Cette vangeance me doit eſtre reſervée, reprit Artamene:	Cette vengeance me doit être réservée, reprit Artamène:
& puis que par le reſpect que je porte au Roy d’Aſſirie, deſarmé	et puisque par le respect que je porte au Roi d’Assyrie, désarmé
& malheureux, je me prive du plaiſir de me vanger de luy;	et malheureux, je me prive du plaisir de me venger de lui;
il faut du moins que je me reſerve celuy de punir Mazare,	il faut du moins que je me réserve celui de punir Mazare,
& de ſa perfidie, et de ſa temerité.	et de sa perfidie, et de sa témérité.
Apres cela, ces deux Rivaux ſans ſe ſouvenir preſque plus de leur haine, ſe mirent à regarder l’un	Après cela, ces deux Rivaux sans se souvenir presque plus de leur haine, se mirent à regarder l’un
& l’autre cette Galere:	et l’autre cette Galère:
& faiſant tantoſt des vœux,	et faisant tantôt des vœux,
& tantoſt des imprecations, comme s’ils n’euſſent eu qu’un meſme intereſt;	et tantôt des imprécations, comme s’ils n’eussent eu qu’un même intérêt;
il y avoit des momens, où l’on euſt dit qu’ils eſtoient Amis, tant cét objet dominant attachoit leurs yeux, leurs eſprits,	il y avait des moments, où l’on eût dit qu’ils étaient Amis, tant cet objet dominant attachait leurs yeux, leurs esprits,
& leurs penſées.	et leurs pensées.
Mais enfin ils virent que tout d’un coup, la Mer changea de couleur;	Mais enfin ils virent que tout d’un coup, la Mer changea de couleur;
que ſes vagues s’eſleverent;	que ses vagues s’élevèrent;
& que groſſissant encore en un moment, elles portoient tantoſt la Galere dans les Cieux;	et que grossissant encore en un moment, elles portaient tantôt la Galère dans les Cieux;
& tantoſt elles l’enfonçoient dans les abiſmes, Cette triſte veuë faiſant alors un meſme effet, dans ces cœurs également paſſionnez;	et tantôt elles l’enfonçaient dans les abîmes, Cette triste vue faisant alors un même effet, dans ces cœurs également passionnés;
Artamene regarda le Roy d’Aſſirie, avec une douleur inconcevable:	Artamène regarda le Roi d’Assyrie, avec une douleur inconcevable:
& le Roy d’Aſſirie regarda Artamene, avec un deſespoir que l’on ne sçauroit exprimer.	et le Roi d’Assyrie regarda Artamène, avec un désespoir que l’on ne saurait exprimer.
Ce fut alors que l’égalité de leur malheur, ſuspendit tous leurs autres ſentimens;	Ce fut alors que l’égalité de leur malheur, suspendit tous leurs autres sentiments;
& qu’ils eſprouverent tout ce que l’amour peut faire eſprouver de douloureux	et qu’ils éprouvèrent tout ce que l’amour peut faire éprouver de douloureux
& de ſensible.	et de sensible.
Ils voyoient que ſi le vent continuoit de ſouffler du coſté qu’il eſtoit, cette Galere ſe viendroit infailliblement briſer contre le pied de la Tour où ils eſtoient;	Ils voyaient que si le vent continuait de souffler du côté qu’il était, cette Galère se viendrait infailliblement briser contre le pied de la Tour où ils étaient;
ſi bien que faiſant des vœux tous contraires à ceux qu’ils avoient faits un peu auparavant;	si bien que faisant des vœux tous contraires à ceux qu’ils avaient faits un peu auparavant;
ils deſiroient que le vent ſecondast les vœux du raviſſeur,	ils désiraient que le vent secondât les vœux du ravisseur,
& qu’il l’eſloignast de la terre.	et qu’il l’éloignât de la terre.
Cependant la tempeſte ſe redoubla:	Cependant la tempête se redoubla:
& ſelon le caprice,	et selon le caprice,
& l’inconſtance de la Mer, le vent ayant par des tourbillons qui s’entre-choquoient, eſté quelque temps en balance;	et l’inconstance de la Mer, le vent ayant par des tourbillons qui s’entrechoquaient, été quelque temps en balance;
comme s’il n’euſt pû determiner de quel coſté il devoit ſe ranger;	comme s’il n’eût pû déterminer de quel côté il devait se ranger;
tout d’un coup il eſloigna la Galere de la Ville:	tout d’un coup il éloigna la Galère de la Ville:
& luy fit raſer la Côſte avec tant de viſtesse, que ces deux Rivaux la perdirent de veuë en un inſtant:	et lui fit raser la Côte avec tant de vitesse, que ces deux Rivaux la perdirent de vue en un instant:
& perdirent avec elle, tout ce qui leur reſtoit d’eſperance, voyant touſjours durer l’orage auſſi fort qu’auparavant.	et perdirent avec elle, tout ce qui leur restait d’espérance, voyant toujours durer l’orage aussi fort qu’auparavant.
Que ne dirent point apres cela, ces deux illuſtres malheureux;	Que ne dirent point après cela, ces deux illustres malheureux;
dans la crainte qu’ils avoient, voyant continuer la tempeſte, que leur Princeſſe ne fiſt naufrage?	dans la crainte qu’ils avaient, voyant continuer la tempête, que leur Princesse ne fît naufrage?
Ils euſſent bien voulu pouvoir ſeparer Mazare de Mandane;	Ils eussent bien voulu pouvoir séparer Mazare de Mandane;
& ne luy donner point de part aux vœux qu’ils faiſoient pour elle:	et ne lui donner point de part aux vœux qu’ils faisaient pour elle:
mais apres tout, ils conſentoient au ſalut du Rival, plus toſt que de ſe conſentir à la perte de la Maiſtresse.	mais après tout, ils consentaient au salut du Rival, plutôt que de se consentir à la perte de la Maîtresse.
Ils ſe la ſouhaiterent meſme plus d’une fois l’un a l’autre, pluſtost que de la sçavoir expoſée au danger où elle eſtoit:	Ils se la souhaitèrent même plus d’une fois l’un à l’autre, plutôt que de la savoir exposée au danger où elle était:
& plus d’une fois auſſi, ils ſe repentirent de leurs propres ſouhaits.	et plus d’une fois aussi, ils se repentirent de leurs propres souhaits.
Cependant cét objet qui avoit comme ſuspendu toutes leurs paſſions,	Cependant cet objet qui avait comme suspendu toutes leurs passions,
& toutes leurs penſées, n’eſtant plus devant leurs yeux;	et toutes leurs pensées, n’étant plus devant leurs yeux;
ils recommencerent de ſe regarder comme auparavant:	ils recommencèrent de se regarder comme auparavant:
c’eſt à dire comme deux Rivaux,	c’est à dire comme deux Rivaux,
& comme deux Ennemis.	et comme deux Ennemis.
Artamene eſtoit pres de s’en aller,	Artamène était près de s’en aller,
& de commander que l’on gardaſt le Roy d’Aſſirie;	et de commander que l’on gardât le Roi d’Assyrie;
lors que ce Prince luy dit, je sçay bien que ta naiſſance eſt égale à la mienne:	lors que ce Prince lui dit, je sais bien que ta naissance est égale à la mienne:
& je le sçay par des voyes ſi differentes,	et je le sais par des voies si différentes,
& ſi aſſeurées, que je n’en sçaurois douter:	et si assurées, que je n’en saurais douter:
c’eſt pourquoy me confiant en cette generoſité, de laquelle j’ay eſté ſi ſouvent le ſecret admirateur malgré ma haine;	c’est pourquoi me confiant en cette générosité, de laquelle j’ai été si souvent le secret admirateur malgré ma haine;
& que j’ay ſi ſouvent eſprouvée;	et que j’ai si souvent éprouvée;
je veux croire encore, que tu ne me refuſeras pas une grace que je te veux demander.	je veux croire encore, que tu ne me refuseras pas une grâce que je te veux demander.
Comme à mon Rival, luy reſpondit Artamene, je te dois refuſer toute choſe:	Comme à mon Rival, lui répondit Artamène, je te dois refuser toute chose:
mais comme au Roy d’Aſſirie, je te dois accorder tout ce qui n’offenſera point le Roy que je ſers, ou la Princeſſe ſa fille:	mais comme au Roi d’Assyrie, je te dois accorder tout ce qui n’offensera point le Roi que je sers, ou la Princesse sa fille:
c’eſt pourquoy ſois aſſeuré que je ne te refuſeray rien de tout ce qui ne choquera point ny mon honneur, ny mon amour:	c’est pourquoi sois assuré que je ne te refuserai rien de tout ce qui ne choquera point ni mon honneur, ni mon amour:
& je t’en engage la parole d’un homme, qui comme tu dis, n’eſt pas de naiſſance inégale à la tienne, quoy qu’il ne paſſe pas pour cela, dans l’opinion de toute la Terre.	et je t’en engage la parole d’un homme, qui comme tu dis, n’est pas de naissance inégale à la tienne, quoi qu’il ne passe pas pour cela, dans l’opinion de toute la Terre.
Demande donc ce que tu voudras:	Demande donc ce que tu voudras:
mais conſulte auparavant ta propre vertu, pour ne forcer pas la mienne à te refuſer malgré elle.	mais consulte auparavant ta propre vertu, pour ne forcer pas la mienne à te refuser malgré elle.
Le Roy d’Aſſirie voyant qu’il avoit ceſſé de parler;	Le Roi d’Assyrie voyant qu’il avait cessé de parler;
je sçay bien, luy dit il, que tu peux me remettre entre les mains de Ciaxare:	je sais bien, lui dit-il, que tu peux me remettre entre les mains de Ciaxare:
& qu’apres luy avoir conquis la meilleure partie de mon Royaume, il te ſeroit en quelque façon avantageux, de luy en remettre le Roy dans ſes fers.	et qu’après lui avoir conquis la meilleure partie de mon Royaume, il te serait en quelque façon avantageux, de lui en remettre le Roi dans ses fers.
Mais tu és trop brave, pour vouloir que la Fortune t’ayde à triompher d’un homme fait comme moy;	Mais tu es trop brave, pour vouloir que la Fortune t’aide à triompher d’un homme fait comme moi;
& pour te prevaloir de la captivité d’un Rival, que tu ne sçaurois croire qu’homme de cœur, puis qu’il à deſja meſuré ton eſpée avec la tienne.	et pour te prévaloir de la captivité d’un Rival, que tu ne saurais croire qu’homme de cœur, puisqu’il à déjà mesuré ton épée avec la tienne.
Dans les termes où eſt ma paſſion pour la Princeſſe, je ne te celle pas qu’il faut de neceſſité que je meure avant que tu la poſſedes:	Dans les termes où est ma passion pour la Princesse, je ne te celle pas qu’il faut de nécessité que je meure avant que tu la possèdes:
ne me prive donc pas inutilement de la gloire d’avoir contribué quelque choſe, à la punition de noſtre Ennemy commun,	ne me prive donc pas inutilement de la gloire d’avoir contribué quelque chose, à la punition de notre Ennemi commun,
& à la liberté de la Princeſſe:	et à la liberté de la Princesse:
te promettant apres cela, quand meſme le Deſtin me ſeroit favorable,	te promettant après cela, quand même le Destin me serait favorable,
& me feroit retrouver l’illuſtre Mandane;	et me ferait retrouver l’illustre Mandane;
de ne ſonger jamais à la perſuader à ton prejudice;	de ne songer jamais à la persuader à ton préjudice;
que par un combat particulier, le fort des armes n’ait decidé de noſtre Fortune.	que par un combat particulier, le fort des armes n’ait décidé de notre Fortune.
Je voy bien, Artamene, (adjouſta t’il) que ce que je veux eſt difficile:	Je vois bien, Artamène, (ajouta-t-il) que ce que je veux est difficile:
mais ſi ton ame n’eſtoit capable que des choſes aiſées, tu ſerois indigne d’eſtre mon Rival.	mais si ton âme n’était capable que des choses aisées, tu serais indigne d’être mon Rival.
Il eſt vray, reprit Artamene, qu’il ne m’eſt pas aiſé de faire ce que tu deſires:	Il est vrai, reprit Artamène, qu’il ne m’est pas aisé de faire ce que tu désires:
& qu’il me ſera bien plus facile, de terminer nos differens, te faiſant redonner une eſpée;	et qu’il me sera bien plus facile, de terminer nos différends, te faisant redonner une épée;
que de t’accorder cette liberté que tu me demandes;	que de t’accorder cette liberté que tu me demandes;
& qui n’eſt pas peut-eſtre tant en mon pouvoir que tu le crois.	et qui n’est pas peut-être tant en mon pouvoir que tu le crois.
Comme mon amour n’eſt pas moins forte que la tienne, reprit le Roy d’Aſſirie, peut-eſtre que le deſir de combattre n’eſt pas moins violent dans mon cœur, que dans celuy d’Artamene:	Comme mon amour n’est pas moins forte que la tienne, reprit le Roi d’Assyrie, peut-être que le désir de combattre n’est pas moins violent dans mon cœur, que dans celui d’Artamène:
Mais comme je ne veux combattre Artamene que pour la poſſession de la Princeſſe;	Mais comme je ne veux combattre Artamène que pour la possession de la Princesse;
& qu’elle n’eſt pas en eſtat de pouvoir eſtre le prix du Vainqueur;	et qu’elle n’est pas en état de pouvoir être le prix du Vainqueur;
il faut Artamene, il faut aller apres le Raviſſeur de Mandane,	il faut Artamène, il faut aller après le Ravisseur de Mandane,
& travailler conjointement à ſa liberté, y ayant égal intereſt.	et travailler conjointement à sa liberté, y ayant égal intérêt.
Ne conſideres tu point que ſi nous periſſions tous deux dans ce combat, Mandane, l’illuſtre Mandane, demeureroit ſans protection	Ne considères-tu point que si nous périssions tous deux dans ce combat, Mandane, l’illustre Mandane, demeurerait sans protection
& ſans deffence, entre les mains de noſtre Rival?	et sans défense, entre les mains de notre Rival?
A ces mots, Artamene s’arreſta un moment:	À ces mots, Artamène s’arrêta un moment:
puis reprenant la parole;	puis reprenant la parole;
il ne ſeroit ſans doute pas juſte, dit il, d’expoſer noſtre Princeſſe, à un ſemblable malheur:	il ne serait sans doute pas juste, dit-il, d’exposer notre Princesse, à un semblable malheur:
mais il n’eſt pas équitable non plus, que commandant les armes du Roy des Medes, je diſpose ſouverainement de la liberté d’un priſonnier, comme eſt le Roy d’Aſſirie.	mais il n’est pas équitable non plus, que commandant les armes du Roi des Mèdes, je dispose souverainement de la liberté d’un prisonnier, comme est le Roi d’Assyrie.
Tout ce que je puis avec honneur;	Tout ce que je puis avec honneur;
c’eſt de luy promettre, d’employer tous mes ſoins,	c’est de lui promettre, d’employer tous mes soins,
& tout mon credit, pour la luy faire rendre, s’il m’eſt poſſible,	et tout mon crédit, pour la lui faire rendre, s’il m’est possible,
& de n’oublier rien pour cela.	et de n’oublier rien pour cela.
Mais pour luy teſmoigner, adjouſta t’il, que je ne veux pas m’eſpargner la peine qui ſe rencontre à combattre un ſi redoutable Ennemy;	Mais pour lui témoigner, ajouta-t-il, que je ne veux pas m’épargner la peine qui se rencontre à combattre un si redoutable Ennemi;
ny m’en exempter laſchement, en le retenant priſonnier;	ni m’en exempter lâchement, en le retenant prisonnier;
je veux bien luy engager ma parole, de ne pretendre jamais rien à la poſſession de la Princeſſe, quand meſme elle ſeroit en ma puiſſance;	je veux bien lui engager ma parole, de ne prétendre jamais rien à la possession de la Princesse, quand même elle serait en ma puissance;
quand meſme le Roy des Medes y conſentiroit;	quand même le Roi des Mèdes y consentirait;
& quand meſme elle le voudroit, qu’auparavant par un combat particulier;	et quand même elle le voudrait, qu’auparavant par un combat particulier;
le ſort des armes ne m’ait rendu ſon Vainqueur.	le sort des armes ne m’ait rendu son Vainqueur.
Je ne sçaurois nier, luy dit le Roy d’Aſſirie, que vous n’ayez raiſon d’en uſer comme vous faites;	Je ne saurais nier, lui dit le Roi d’Assyrie, que vous n’ayez raison d’en user comme vous faites;
& que je n’aye eu tort de vous faire cette demande:	et que je n’aie eu tort de vous faire cette demande:
mais advoüant que vous eſtes plus ſage que moy, confeſſez auſſi que je ſuis plus amoureux que vous, puis que je le ſuis juſques à perdre la raiſon, que vous conſervez toute entiere.	mais avouant que vous êtes plus sage que moi, confessez aussi que je suis plus amoureux que vous, puisque je le suis jusqu’à perdre la raison, que vous conservez toute entière.
Je vous diſputeray, luy repliqua Artamene, cette derniere qualité, bien plus opiniaſtrément que l’autre:	Je vous disputerai, lui répliqua Artamène, cette dernière qualité, bien plus opiniâtrement que l’autre:
Le Roy d’Aſſirie le ſupplia alors ſans luy repliquer, de ſe ſouvenir, que peut-eſtre ne ſeroit il pas inutile pour la liberté de la Princeſſe:	Le Roi d’Assyrie le supplia alors sans lui répliquer, de se souvenir, que peut-être ne serait-il pas inutile pour la liberté de la Princesse:
& qu’ainſi par cette ſeule raiſon, il le conjuroit de travailler pour la ſienne.	et qu’ainsi par cette seule raison, il le conjurait de travailler pour la sienne.
A ces mots Artamene ſe retira, apres avoir mis le Roy d’Aſſirie ſous la garde d’Araſpe:	À ces mots Artamène se retira, après avoir mis le Roi d’Assyrie sous la garde d’Araspe:
luy ordonnant de le traiter avec tout le reſpect,	lui ordonnant de le traiter avec tout le respect,
& toute la civilité poſſible:	et toute la civilité possible:
& de le mener à ſon Apartement accouſtumé.	et de le mener à son Appartement accoutumé.
Le Roy d’Aſſirie l’entendant, reſpondit que ce devoit eſtre le ſien:	Le Roi d’Assyrie l’entendant, répondit que ce devait être le sien:
mais Artamene ne le voulut pas:	mais Artamène ne le voulut pas:
& s’en ſeparant à l’inſtant meſme, il s’en alla dans toutes les ruës, pour tenir le Peuple en ſon devoir;	et s’en séparant à l’instant même, il s’en alla dans toutes les rues, pour tenir le Peuple en son devoir;
& pour faire achever d’eſteindre le feu.	et pour faire achever d’éteindre le feu.
Il envoya tout le long des Coſtes, pour voir ſi l’on n’apprendroit rien de la Galere, qui avoit enlevé ſa Princeſſe:	Il envoya tout le long des Côtes, pour voir si l’on n’apprendrait rien de la Galère, qui avait enlevé sa Princesse:
& il depeſcha un des ſiens vers Ciaxare, pour l’advertir de ce qui s’eſtoit paſſé.	et il dépêcha un des siens vers Ciaxare, pour l’avertir de ce qui s’était passé.
Enfin il employa tout le reſte du jour à donner ſes ordres:	Enfin il employa tout le reste du jour à donner ses ordres:
& le ſoir eſtant venu, il ſe retira dans le meſme Apartement que ſa Princeſſe avoit occupé, à ce qu’il sçeut par Thraſibule;	et le soir étant venu, il se retira dans le même Appartement que sa Princesse avait occupé, à ce qu’il sut par Thrasibule;
auquel Artamene fit toute la civilité, que l’extréme inquietude où il eſtoit, luy pût permettre de luy faire.	auquel Artamène fit toute la civilité, que l’extrême inquiétude où il était, lui put permettre de lui faire.
Il sçeut qu’eſtant arrivé ſeulement depuis un jour dans ce Port, pour y faire radouber ſes Vaiſſeaux, qui avoient eſté battus de la tempeſte;	Il sut qu’étant arrivé seulement depuis un jour dans ce Port, pour y faire radouber ses Vaisseaux, qui avaient été battus de la tempête;
le Roy d’Aſſirie l’y avoit fort bien reçeu:	le Roi d’Assyrie l’y avait fort bien reçu:
& l’avoit obligé de loger dans le Chaſteau, où il avoit veû la Princeſſe de Medie:	et l’avait obligé de loger dans le Château, où il avait vu la Princesse de Médie:
mais que la nuit derniere, l’on avoit entendu tout d’un coup, le bruit que faiſoient les Vaiſſeaux embrazez, qui en ſuite avoient mis le feu aux maiſons voiſines.	mais que la nuit dernière, l’on avait entendu tout d’un coup, le bruit que faisaient les Vaisseaux embrasés, qui ensuite avaient mis le feu aux maisons voisines.
Qu’à ce bruit, le Roy d’Aſſirie ayant voulu prendre ſon eſpée, ne l’avoit plus trouvée à ſa place,	Qu’à ce bruit, le Roi d’Assyrie ayant voulu prendre son épée, ne l’avait plus trouvée à sa place,
& qu’ayant voulu aller à l’Apartement de la Princeſſe, il l’avoit trouvé fermé:	et qu’ayant voulu aller à l’Appartement de la Princesse, il l’avait trouvé fermé:
& n’avoit trouvé aucun des Soldats qui avoient accouſtumé de garder le Chaſteau.	et n’avait trouvé aucun des Soldats qui avaient accoutumé de garder le Château.
Qu’auſſi toſt il avoit appellé quelques uns des ſiens, qui avoient ouvert par force cét Apartement,	Qu’aussitôt il avait appelé quelques-uns des siens, qui avaient ouvert par force cet Appartement,
& qui n’y avoient trouvé perſonne.	et qui n’y avaient trouvé personne.
Que cependant ayant voulu faire ſortir tous les domeſtiques,	Que cependant ayant voulu faire sortir tous les domestiques,
& voulu ſortir luy meſme, il luy avoit eſté impoſſible;	et voulu sortir lui même, il lui avait été impossible;
à cauſe de l’embrazement.	à cause de l’embrasement.
Et que depuis cela, il avoit toujours eſté ſur le haut de cette Tour, à conſiderer ſon infortune:	Et que depuis cela, il avait toujours été sur le haut de cette Tour, à considérer son infortune:
reſolu à tous les momens, de ſe jetter dans la Mer ou dans les flames.	résolu à tous les moments, de se jeter dans la Mer ou dans les flammes.
Thraſibule n’en pouvoit pas dire d’avantage:	Thrasibule n’en pouvait pas dire davantage:
car il n’y avoit encore qu’un jour qu’il eſtoit arrivé à Sinope:	car il n’y avait encore qu’un jour qu’il était arrivé à Sinope:
il laiſſa donc Artamene dans cét Apartement;	il laissa donc Artamène dans cet Appartement;
apres que ce Prince l’eut aſſeuré en s’en ſeparant, qu’il auroit ſoing de le faire recompenſer par le Roy, de la perte de ſes Vaiſſeaux, que le feu avoit devorez:	après que ce Prince l’eut assuré en s’en séparant, qu’il aurait soin de le faire récompenser par le Roi, de la perte de ses Vaisseaux, que le feu avait dévorés:
le loüant infiniment de ſa moderation;	le louant infiniment de sa modération;
luy qui dans un accident tant inopiné, ne s’amuſoit point à des regrets inutiles;	lui qui dans un accident tant inopiné, ne s’amusait point à des regrets inutiles;
& ſouffroit en homme de cœur, une perte ſi conſiderable.	et souffrait en homme de cœur, une perte si considérable.
Artamene paſſa la nuit avec des inquietudes que l’on ne sçauroit concevoir:	Artamène passa la nuit avec des inquiétudes que l’on ne saurait concevoir:
voicy, diſoit il en luy meſme, le lieu de la perſecution de ma Princeſſe;	voici, disait-il en lui-même, le lieu de la persécution de ma Princesse;
& voicy peut-eſtre l’endroit où elle s’eſt ſouvenuë de moy avec douleur;	et voici peut-être l’endroit où elle s’est souvenue de moi avec douleur;
& où peut-eſtre elle a regretté le malheureux Artamene.	et où peut-être elle a regretté le malheureux Artamène.
Du moins sçay-je bien qu’elle en a parlé:	Du moins sais-je bien qu’elle en a parlé:
Car, par quelle autre voye le Roy d’Aſſirie auroit il pû sçavoir, qu’Artamene n’eſt pas veritablement Artamene?	Car, par quelle autre voie le Roi d’Assyrie aurait il pu savoir, qu’Artamène n’est pas véritablement Artamène?
moy qui dans le temps que je l’ay veû à la Cour de Capadoce, ne le croyois eſtre que Philidaſpe;	moi qui dans le temps que je l’ai vu à la Cour de Cappadoce, ne le croyais être que Philidaspe;
c’eſt à dire un ſimple Chevalier, tel qu’il ſe diſoit;	c’est à dire un simple Chevalier, tel qu’il se disait;
quoy que je fuſſe pour le moins auſſi amoureux que luy;	quoique je fusse pour le moins aussi amoureux que lui;
& par conſequent auſſi difficile à tromper?	et par conséquent aussi difficile à tromper?
Mais helas!	Mais hélas!
adorable Princeſſe, pourquoy faut il que je ſois dans voſtre priſon;	adorable Princesse, pourquoi faut-il que je sois dans votre prison;
que voſtre perſecuteur ſoit icy,	que votre persécuteur soit ici,
& que vous n’y ſoyez pas?	et que vous n’y soyez pas?
Je tiens un Rival que je ne puis punir;	Je tiens un Rival que je ne puis punir;
je pers une Maiſtresse que je ne puis ſauver,	je perds une Maîtresse que je ne puis sauver,
& ſa beauté qui fait tout mon bon-heur	et sa beauté qui fait tout mon bonheur
& toute ſa gloire, fait auſſi toute mon infortune	et toute sa gloire, fait aussi toute mon infortune
& tout ſon mal-heur.	et tout son malheur.
Elle luy donne des Adorateurs;	Elle lui donne des Adorateurs;
mais des Adorateurs ſans reſpect:	mais des Adorateurs sans respect:
& en quelque lieu qu’elle aille, elle me donne des Rivaux	et en quelque lieu qu’elle aille, elle me donne des Rivaux
& des Ennemis.	et des Ennemis.
Ha!	Ha!
beaux yeux, s’ecrioit il, comme eſt-il poſſible que vous inſpiriez des ſentimens ſi injuſtes;	beaux yeux, s’écriait-il, comme est-il possible que vous inspiriez des sentiments si injustes;
& ſi déreglez;	et si déréglés;
Vous, dis-je, qui n’avez jamais porté dans mon cœur, que de la crainte,	Vous, dis-je, qui n’avez jamais porté dans mon cœur, que de la crainte,
& de la veneration?	et de la vénération?
Moy qui n’ay preſque jamais oſé vous dire que je vous aymois:	Moi qui n’ai presque jamais osé vous dire que je vous aimais:
moy qui ne vous ay regardez qu’en tremblant;	moi qui ne vous ai regardés qu’en tremblant;
moy qui vous ay ſi long temps adorez en ſecret;	moi qui vous ai si longtemps adorés en secret;
& moy, dis-je enfin, qui ſerois pluſtost mort mille fois, que de vous faire voir dans mes actions, la moindre choſe qui vous peuſt deſplaire.	et moi, dis-je enfin, qui serais plutôt mort mille fois, que de vous faire voir dans mes actions, la moindre chose qui vous pût déplaire.
Cependant vous avez embrazé des cœurs indignes de vous:	Cependant vous avez embrasé des cœurs indignes de vous:
& des cœurs qui ſans conſiderer ce qu’ils vous doivent, n’ont conſideré que ce qui leur plaiſt.	et des cœurs qui sans considérer ce qu’ils vous doivent, n’ont considéré que ce qui leur plaît.
Cependant je ne sçaurois me repentir de ma reſpectueuse paſſion:	Cependant je ne saurais me repentir de ma respectueuse passion:
& je ne sçay ſi tout malheureux que je ſuis;	et je ne sais si tout malheureux que je suis;
ſi tout eſloigné que je me trouve de ma Princeſſe, je n’aime pas encore mieux eſtre Artamene, que d’eſtre Mazare.	si tout éloigné que je me trouve de ma Princesse, je n’aime pas encore mieux être Artamène, que d’être Mazare.
Ce n’eſt pas pourſuivit il, qu’il ne ſoit heureux dans ſon crime:	Ce n’est pas poursuivit-il, qu’il ne soit heureux dans son crime:
car enfin il la voit;	car enfin il la voit;
il luy parle;	il lui parle;
& il luy parle de ſa paſſion.	et il lui parle de sa passion.
Mais ſans doute auſſi qu’elle luy reſpond avec mépris;	Mais sans doute aussi qu’elle lui répond avec mépris;
& que les meſmes yeux qui ſont ſon plaiſir	et que les mêmes yeux qui sont son plaisir
& ſa gloire, ſont auſſi ſa peine	et sa gloire, sont aussi sa peine
& ſon chaſtiment, par les marques de leur colere.	et son châtiment, par les marques de leur colère.
En un mot, je penſe que j’ayme mieux eſtre innocent dans le cœur de ma Princeſſe, qu’eſtre ſeulement à ſes pieds comme un Criminel.	En un mot, je pense que j’aime mieux être innocent dans le cœur de ma Princesse, qu’être seulement à ses pieds comme un Criminel.
Mais Ciel!	Mais Ciel!
adjouſtoit il tout d’un coup;	ajoutait-il tout d’un coup;
qui m’a dit que cette tempeſte qui s’eſt eſlevée,	qui m’a dit que cette tempête qui s’est élevée,
& qui dure encore, ne l’aura pas fait perir;	et qui dure encore, ne l’aura pas fait périr;
& de quelles flateuſes penſées laiſſay-je entretenir mon eſpoir, dans l’incertitude où j’en ſuis ?	et de quelles flatteuses pensées laissai-je entretenir mon espoir, dans l’incertitude où j’en suis?
Comme il en eſtoit là, il entendit un bruit aſſez grand:	Comme il en était là, il entendit un bruit assez grand:
& Chriſante eſtant entré dans ſa chambre, Seigneur, luy dit-il, l’on delivre le Roy d’Aſſirie;	et Chrysante étant entré dans sa chambre, Seigneur, lui dit-il, l’on délivre le Roi d’Assyrie;
ou pour mieux dire, on l’a deſja delivré.	ou pour mieux dire, on l’a déjà délivré.
Araſpe ayant entendu quelque bruit dans la chambre du Roy priſonnier, où par reſpect il n’avoit pas voulu coucher;	Araspe ayant entendu quelque bruit dans la chambre du Roi prisonnier, où par respect il n’avait pas voulu coucher;
l’a ouverte,	l’a ouverte,
& ne l’y a plus trouvé.	et ne l’y a plus trouvé.
A l’inſtant meſme nous ſommes ſortis;	À l’instant même nous sommes sortis;
nous avons cherché;	nous avons cherché;
& nous avons veû que ſous une feneſtre qui reſpond vers une maiſon bruſlée;	et nous avons vu que sous une fenêtre qui répond vers une maison brûlée;
un amas de ruines	un amas de ruines
& de cendres, a comblé le foſſé du Chateau en cét endroit,	et de cendres, a comblé le fossé du Château en cet endroit,
& a eſlevé un grand monceau de ces matieres fumantes, à la faveur duquel nous jugeons que ce Prince s’eſt ſauvé.	et a élevé un grand monceau de ces matières fumantes, à la faveur duquel nous jugeons que ce Prince s’est sauvé.
Artamene ſurpris d’une nouvelle ſi faſcheuse, envoya promptement ſes ordres à toutes les Portes de Sinope;	Artamène surpris d’une nouvelle si fâcheuse, envoya promptement ses ordres à toutes les Portes de Sinope;
& fut luy meſme en perſonne, pour taſcher de retrouver ſon priſonnier.	et fut lui-même en personne, pour tâcher de retrouver son prisonnier.
Mais durant qu’il eſtoit à un des bouts de la Ville, il sçeut qu’une troupe de gens armez paroiſſoit à l’autre;	Mais durant qu’il était à un des bouts de la Ville, il sut qu’une troupe de gens armés paraissait à l’autre;
& qu’ils taſchoient de ſe rendre Maiſtres de la Porte.	et qu’ils tâchaient de se rendre Maîtres de la Porte.
Il y courut auſſi toſt;	Il y courut aussitôt;
mais il y arriva trop tard:	mais il y arriva trop tard:
car le Roy d’Aſſirie eſtoit deſja ſorti,	car le Roi d’Assyrie était déjà sorti,
& avoit forcé le Corps de Garde.	et avait forcé le Corps de Garde.
Il y avoit pourtant encore quelques uns des ſiens, commandez par Aribée, que l’on avoit creû mort,	Il y avait pourtant encore quelques-uns des siens, commandés par Aribée, que l’on avait cru mort,
& qui s’eſtoit retiré de deſſous ces ruines qui l’avoient enſeveli;	et qui s’était retiré de dessous ces ruines qui l’avaient enseveli;
qui pour donner temps au Roy d’Aſſirie de ſe ſauver, rendoient encore avec luy quelque combat, malgré les bleſſures que ce perfide avoit deſja reçeuës.	qui pour donner temps au Roi d’Assyrie de se sauver, rendaient encore avec lui quelque combat, malgré les blessures que ce perfide avait déjà reçues.
Mais Artamene ne l’eut pas pluſtost reconnu, qu’il luy dit;	Mais Artamène ne l’eut pas plutôt reconnu, qu’il lui dit;
Traiſtre, tu és donc reſſuscité, pour trahir encore une fois ton Maiſtre!	Traître, tu es donc ressuscité, pour trahir encore une fois ton Maître!
Mais ſi tu veux échaper de mes mains, il faut que les tiennes m’oſtent la vie.	Mais si tu veux échapper de mes mains, il faut que les tiennes m’ôtent la vie.
En diſant cela, il fut à luy, avec une impetuoſité ſi grande;	En disant cela, il fut à lui, avec une impétuosité si grande;
qu’Aribée, quoy que courageux, fut contraint de laſcher le pied.	qu’Aribée, quoique courageux, fut contraint de lâcher le pied.
Ce ne fut neantmoins reculer ſa perte que d’un moment:	Ce ne fut néanmoins reculer sa perte que d’un moment:
car Artamene le preſſa de telle ſorte;	car Artamène le pressa de telle sorte;
qu’il ne ſongea plus qu’à parer les coups qu’il luy portoit:	qu’il ne songea plus qu’à parer les coups qu’il lui portait:
cedant viſiblement à la valeur d’un homme, qui ne combatoit gueres ſans vaincre.	cédant visiblement à la valeur d’un homme, qui ne combattait guère sans vaincre.
Il luy donna donc enfin un ſi grand coup d’eſpée à travers le corps, au deffaut de ſa cuiraſſe, qu’il l’abatit à ſes pieds.	Il lui donna donc enfin un si grand coup d’épée à travers le corps, au défaut de sa cuirasse, qu’il l’abattit à ses pieds.
Là, il advoüa avant qu’expirer, que s’eſtant retiré de deſſous ces ruines, il avoit raſſemblé tout ce qu’il avoit pû des ſiens, qu’il avoit fait cacher parmi ces maiſons bruſlées:	Là, il avoua avant qu’expirer, que s’étant retiré de dessous ces ruines, il avait rassemblé tout ce qu’il avait pu des siens, qu’il avait fait cacher parmi ces maisons brûlées:
& qu’ayant sçeu en quel Apartement eſtoit le Roy d’Aſſirie, il avoit eſté au commencement de la nuit, monter ſur cét amas de cendres	et qu’ayant su en quel Appartement était le Roi d’Assyrie, il avait été au commencement de la nuit, monter sur cet amas de cendres
& de bois à demi conſumé;	et de bois à demi-consumé;
faire quelque bruit à la feneſtre de ce Prince, pour l’obliger à y regarder;	faire quelque bruit à la fenêtre de ce Prince, pour l’obliger à y regarder;
& que la choſe luy ayant ſuccedé, il l’avoit fait ſauver par cette feneſtre.	et que la chose lui ayant succédé, il l’avait fait sauver par cette fenêtre.
A ces mots, cét infidelle perdit la parole	À ces mots, cet infidèle perdit la parole
& la vie:	et la vie:
& tous ſes compagnons le voyant en cét eſtat, prirent auſſi toſt la ſuite.	et tous ses compagnons le voyant en cet état, prirent aussitôt la suite.
Mais Artamene fut contraint de ne pourſuivre pas davantage un Prince, que l’obſcurité de la nuit, déroboit facilement à ſes ſoins.	Mais Artamène fut contraint de ne poursuivre pas davantage un Prince, que l’obscurité de la nuit, dérobait facilement à ses soins.
Comme il s’en fut retourné au Chaſteau, il dépeſcha vers Ciaxare, pour l’advertir de cét accident:	Comme il s’en fut retourné au Château, il dépêcha vers Cyaxare, pour l’avertir de cet accident:
& s’occupa tout le reſte de la nuit, à conſiderer le caprice de ſa fortune	et s’occupa tout le reste de la nuit, à considérer le caprice de sa fortune
& de ſon malheur.	et de son malheur.
Repaſſant donc tout ce qui luy eſtoit arrivé, il s’eſtonnoit quelqueſfois, qu’une vie auſſi peu avancée que la ſienne, euſt deſja eſté ſubjette à tant d’evenemens extraordinaires:	Repassant donc tout ce qui lui était arrivé, il s’étonnait quelquefois, qu’une vie aussi peu avancée que la sienne, eût déjà été sujette à tant d’évènements extraordinaires:
& ſe promenant ſeul dans ſa chambre (car il n’avoit pû ſe reſoudre de ſe remettre au lit) il apperçeut ſur la table des Tablettes de feüilles de Palmier, aſſez magnifiques:	et se promenant seul dans sa chambre (car il n’avait pu se résoudre de se remettre au lit) il aperçut sur la table des Tablettes de feuilles de Palmier, assez magnifiques:
Mais helas!	Mais hélas!
quelle ſurprise fut la ſienne, lors qu’en les ouvrant, il vit qu’il y avoit quelque choſe qui eſtoit eſcrit de la main de ſa Princeſſe.	quelle surprise fut la sienne, lorsqu’en les ouvrant, il vit qu’il y avait quelque chose qui était écrit de la main de sa Princesse.
Il les regarde de plus prés;	Il les regarde de plus près;
il parcourt en un moment toutes ces precieuſes lignes;	il parcourt en un moment toutes ces précieuses lignes;
& apres s’eſtre fortement confirmé en l’opinion que c’eſtoit elle qui les avoit tracées:	et après s’être fortement confirmé en l’opinion que c’était elle qui les avait tracées:
il lût diſtinctement ces paroles.	il lut distinctement ces paroles.
