MEMOIRES DE LA VIE DE HENRIETTE-SYLVIE DE MOLIERE.	MÉMOIRES DE LA VIE DE HENRIETTE-SYLVIE DE MOLIÈRE.
Premiere Partie.	Première Partie.
A PARIS	À PARIS
Chez Claude Barbin, au Palais sur le second Perron de la Sainte Chappelle.	Chez Claude Barbin, au Palais sur le second Perron de la Sainte Chapelle.
M. DC. LXXII.	MDCLXXII.
Avec Privilege du Roy.	Avec Privilège du Roi.
FRAGMENT d’une Lettre.	FRAGMENT d’une Lettre.
I’amene avec moy une belle Dame que vous connoiſſez, & qui me menace de me faire aller bien loin :	J’amène avec moi une belle Dame que vous connaissez, et qui me menace de me faire aller bien loin :
elle a une eſtrange demangeaiſon de ſe revoir à Paris ;	elle a une étrange démangeaison de se revoir à Paris ;
mais je doute qu’elle puiſſe, obtenir ſur moy de me faire faire ces pas-là, outre que mes affaires me r’appelleront bien-toſt à Thoulouze.	mais je doute qu’elle puisse obtenir sur moi de me faire faire ces pas-là, outre que mes affaires me rappelleront bientôt à Toulouse.
Ie ne vais pas ainſi dans une Ville où j’ay eu la folie de conſentir qu’on me fit imprimer.	Je ne vais pas ainsi dans une Ville où j’ai eu la folie de consentir qu’on me fit imprimer.
Comme vous avez plus de prudence que moy, je vous laiſſe l’arbitre de tout ce qu’il faudra encore retrancher.	Comme vous avez plus de prudence que moi, je vous laisse l’arbitre de tout ce qu’il faudra encore retrancher.
Mais parlons d’autre choſe :	Mais parlons d’autre chose :
Que voſtre Libraire m’embaraſſe avec ce qu’il me demande ;	Que votre Libraire m’embarrasse avec ce qu’il me demande ;
eſt ce qu’il ne peut rien faire ſans celà ?	est ce qu’il ne peut rien faire sans cela ?
& puis dequoy veut-il que je luy compoſe une Preface, je n’ay plus rien à dire aux Lecteurs, & j’ay tout dit en leur abandonnant la belle Hiſtoire que vous faites imprimer :	et puis de quoi veut-il que je lui compose une Préface, je n’ai plus rien à dire aux Lecteurs, et j’ai tout dit en leur abandonnant la belle Histoire que vous faites imprimer :
D’ailleurs je ne vois pas que ſon Livre exige une grande juſtification ;	D’ailleurs je ne vois pas que son Livre exige une grande justification ;
& ſi je n’ay pû me diſpenſer d’y parler de quelques perſonnes vivantes, je croy qu’il n’y en a pas une, qui en un beſoin, ne me pardonnât volontiers la liberté que j’ay priſe, & à tout évenement je ſeray le garant de l’Ouvrage de ce coſté-là.	et si je n’ai pu me dispenser d’y parler de quelques personnes vivantes, je crois qu’il n’y en a pas une, qui en un besoin, ne me pardonnât volontiers la liberté que j’ai prise, et à tout événement je serai le garant de l’Ouvrage de ce côté-là.
Ie ſuis bien aiſe de ce que vous me mandez qu’on le doit faire corriger par d’habiles gens, prenez garde ſeulement que ces habiles gens-là ne ſoient pas trop ſerieux, car cela leur aideroit à y trouver beaucoup plus de fautes ;	Je suis bien aise de ce que vous me mandez qu’on le doit faire corriger par d’habiles gens, prenez garde seulement que ces habiles gens-là ne soient pas trop sérieux, car cela leur aiderait à y trouver beaucoup plus de fautes ;
& on dit qu’il faut eſtre un peu badin pour lire des badineries, ou du moins, qu’il les faut lire en badinant pour y avoir plus de plaiſir.	et on dit qu’il faut être un peu badin pour lire des badineries, ou du moins, qu’il les faut lire en badinant pour y avoir plus de plaisir.
Ie finis, car on m’attend pour achever de déjeuſner :	Je finis, car on m’attend pour achever de déjeuner :
Adieu Monſieur, vous eſtes le plus obligeant du monde, & ſi j’avois du loiſir, je ne finirois cette Lettre que par de grands complimens que je vous ferois ſur toutes les bontez que vous avez pour moy.	Adieu Monsieur, vous êtes le plus obligeant du monde, et si j’avais du loisir, je ne finirais cette Lettre que par de grands compliments que je vous ferais sur toutes les bontés que vous avez pour moi.
MEMOIRES DE LA VIE DE HENRIETTE-SYLVIE DE MOLIERE.	MÉMOIRES DE LA VIE DE HENRIETTE-SYLVIE DE MOLIÈRE.
CE ne m’eſt pas une legere conſolation, Madame, au milieu de tant de médiſances qui déchirent ma reputation par tout, que voſtre Alteſſe deſire que je me juſtifie.	CE ne m’est pas une légère consolation, Madame, au milieu de tant de médisances qui déchirent ma réputation partout, que votre Altesse désire que je me justifie.
J’en ay les ſentimens que je doy, & pour n’en eſtre pas ingrate, j’obeïray volontiers au commandement qu’elle me fait de la divertir, par un recit fidelle de mes erreurs innocentes.	J’en ai les sentiments que je dois, et pour n’en être pas ingrate, j’obéirai volontiers au commandement qu’elle me fait de la divertir, par un récit fidèle de mes erreurs innocentes.
Non que j’eſpere jamais pouvoir arracher des eſprits les crüelles impreſſions que la calomnie a données de ma conduitte :	Non que j’espère jamais pouvoir arracher des esprits les cruelles impressions que la calomnie a données de ma conduite :
Le Siecle ne permet pas que je me flatte de cette penſée.	Le Siècle ne permet pas que je me flatte de cette pensée.
Mais pour me ſervir des termes de V. A. ;	Mais pour me servir des termes de V. A. ;
il viendra un temps, où les hommes ne pourront plus juger ſi criminellement par eux-meſmes de leurs ſemblables ;	il viendra un temps, où les hommes ne pourront plus juger si criminellement par eux-mêmes de leurs semblables ;
parce qu’ils n’auront plus les mœurs ſi corrompuës ny ſi criminelles ;	parce qu’ils n’auront plus les mœurs si corrompues ni si criminelles ;
& alors on ajoûtera, peut-eſtre, plus de foy à ce que j’auray écrit de l’innocence de mes actions, qu’à ce qu’en auront pû dire mes ennemis.	et alors on ajoutera, peut-être, plus de foi à ce que j’aurai écrit de l’innocence de mes actions, qu’à ce qu’en auront pu dire mes ennemis.
Je ne cacheray rien ;	Je ne cacherai rien ;
non pas même des plus folles aventures où j’auray eu quelque part ;	non pas même des plus folles aventures où j’aurai eu quelque part ;
afin que Vôtre Alteſſe en puiſſe rire, dans le même temps qu’elle me plaindra d’autre choſe ;	afin que Votre Altesse en puisse rire, dans le même temps qu’elle me plaindra d’autre chose ;
Et il me ſemble que quand elle ne m’en auroit pas donné la permiſſion, je ne devrois pas laiſſer de le faire ;	Et il me semble que quand elle ne m’en aurait pas donné la permission, je ne devrais pas laisser de le faire ;
car ſans celà, Madame, voudrois-je les momens que vous emploiriez à la lecture d’une ſi ennuyeuſe hiſtoire, que celle de ma vie ?	car sans cela, Madame, voudrais-je les moments que vous emploieriez à la lecture d’une si ennuyeuse histoire, que celle de ma vie ?
Je m’y crois encore d’autant plus engagée, qu’aſſûrément on n’a incité Vôtre Alteſſe à m’honorer de ſes Lettres, que dans l’eſperance d’une réponſe qui ſeroit de ce caractere ;	Je m’y crois encore d’autant plus engagée, qu’assurément on n’a incité Votre Altesse à m’honorer de ses Lettres que dans l’espérance d’une réponse qui serait de ce caractère ;
& c’eſt pourquoy je la ſupplie de prendre tout en bonne part.	et c’est pourquoi je la supplie de prendre tout en bonne part.
Pour commencer :	Pour commencer :
Je n’ay jamais bien ſçeu qui j’eſtois ?	Je n’ai jamais bien su qui j’étais ?
Je ſçay ſeulement que je ne ſuis pas une perſonne qui ait de communes deſtinées ;	Je sais seulement que je ne suis pas une personne qui ait de communes destinées ;
que ma naïſſance, mon education & mes mariages, ont eſté l’effet d’autant d’aventures extraordinaires ;	que ma naïssance, mon éducation et mes mariages, ont été l’effet d’autant d’aventures extraordinaires ;
& que ſi je voulois emprunter l’éclat de quelque Heroïne fabuleuſe, il ſe trouveroit des gens au monde (comme peut-eſtre il s’en eſt déjà trouvé) qui travailleroient à appuyer la fable de ma genealogie, pour en rendre l’hiſtoire plus obſcure.	et que si je voulais emprunter l’éclat de quelque Héroïne fabuleuse, il se trouverait des gens au monde (comme peut-être il s’en est déjà trouvé) qui travailleraient à appuyer la fable de ma généalogie, pour en rendre l’histoire plus obscure.
Je fus nommée Henriette-Sylvie, par l’ordre de ma mere méme, à ce que l’on m’a dit.	Je fus nommée Henriette-Sylvie, par l’ordre de ma mère même, à ce que l’on m’a dit.
Henriette, ſans doute, pour quelque raiſon qui n’eſtoit connuë que d’elle ſeule, & Sylvie, apparamment, parce que j’eſtois venuë au monde à l’entrée d’un bois appellé le bois de Sylves ;	Henriette, sans doute, pour quelque raison qui n’était connue que d’elle seule, et Sylvie, apparemment, parce que j’étais venue au monde à l’entrée d’un bois appelé le bois de Sylves ;
j’ay receu le nom de Moliere, qui m’eſt demeuré par habitude de ceux qui ſe donerent le ſoin de m’élever, & qui le portoient eux-mémes.	j’ai reçu le nom de Molière, qui m’est demeuré par habitude de ceux qui se donnèrent le soin de m’élever, et qui le portaient eux-mémes.
Au reſte je ſuis grande & de bonne mine ;	Au reste je suis grande et de bonne mine ;
j’ay les yeux noirs & brillants, bien ouverts, bien coupez, & qui marquent aſſez d’eſprit, on jugera ſi j’en ay.	j’ai les yeux noirs et brillants, bien ouverts, bien coupés, et qui marquent assez d’esprit, on jugera si j’en ai.
Ma bouche eſt grande quand je ris, fort petite quand je ne ris point ;	Ma bouche est grande quand je ris, fort petite quand je ne ris point ;
mais par malheur pour elle, je ris touſjours.	mais par malheur pour elle, je ris toujours.
J’ay les dents belles, le nez bien fait, la gorge comme le teint, c’eſt à dire admirable, & quand on devroit m’accuſer de preſomption, j’ajouteray, Madame qu’on en voit bien peu de pareilles.	J’ai les dents belles, le nez bien fait, la gorge comme le teint, c’est-à-dire admirable, et quand on devrait m’accuser de présomption, j’ajouterai, Madame qu’on en voit bien peu de pareilles.
Mais je ſerois trop longtemps à faire mon Portrait en détail ;	Mais je serais trop longtemps à faire mon Portrait en détail ;
On peut s’imaginer que je ſuis quaſi une beauté achevée, depuis la teſte juſqu’aux pieds.	On peut s’imaginer que je suis quasi une beauté achevée, depuis la tête jusqu’aux pieds.
Ceux qui ont veu ce que j’en laiſſe voir, témoigneront que je ne me farde pas.	Ceux qui ont vu ce que j’en laisse voir, témoigneront que je ne me farde pas.
Ceux qui ne m’ont pas veuë croiront, s’ils le veulent, que je me peins ainſi à plaiſir, ils aimeront toûjours mieux l’idée d’une belle perſonne, que celle d’une laide, ou ils ſeront gens de mauvais gouſt ;	Ceux qui ne m’ont pas vue croiront, s’ils le veulent, que je me peins ainsi à plaisir, ils aimeront toujours mieux l’idée d’une belle personne, que celle d’une laide, ou ils seront gens de mauvais goût ;
je dis toutefois la verité à Voſtre Alteſſe.	je dis toutefois la vérité à Votre Altesse.
Je me croy diſpenſée de nommer la famille dont je ſuis deſcenduë, apres ce que j’ay dit.	Je me crois dispensée de nommer la famille dont je suis descendue, après ce que j’ai dit.
Peut eſtre que mes parens m’ayant trouvée digne d’eux, apres avoir leu l’hiſtoire de ma vie, encheriront ſur le bien que de charitables perſonnes m’ont déjà fait, & déveloperont un jour le ſecret entier de ma naiſſance, pour l’ajoûter à mes autres fortunes ;	Peut être que mes parents m’ayant trouvée digne d’eux, après avoir lu l’histoire de ma vie, enchériront sur le bien que de charitables personnes m’ont déjà fait, et déveloperont un jour le secret entier de ma naissance, pour l’ajouter à mes autres fortunes ;
Et ſi cela arrive, je promets quelque choſe d’illuſtre ;	Et si cela arrive, je promets quelque chose d’illustre ;
car je me ſens bien, & je ne puis croire qu’un mal-honeſte homme ſoit le pere d’une fille de ma ſorte.	car je me sens bien, et je ne puis croire qu’un malhonnête homme soit le père d’une fille de ma sorte.
Quoy qu’il en ſoit, on m’a aſſûré que je vis le jour dans un hameau ſitué à l’entrée d’un bois à deux ou trois lieuës de Montpelier, ſur le bord de la mer.	Quoi qu’il en soit, on m’a assuré que je vis le jour dans un hameau situé à l’entrée d’un bois à deux ou trois lieues de Montpelier, sur le bord de la mer.
Quatre hommes & deux femmes y amenerent Celle, qui m’a miſe au monde, au Mois de Juillet de l’année mil ſix cens quarante-ſept.	Quatre hommes et deux femmes y amenèrent Celle qui m’a mise au monde, au Mois de Juillet de l’année mille six cent quarante-sept.
Ils aborderent dans une chaloupe qu’on brûla ſur le rivage apres avoir pris terre :	Ils abordèrent dans une chaloupe qu’on brûla sur le rivage après avoir pris terre :
La raiſon ?	La raison ?
Je ne la ſçay pas.	Je ne la sais pas.
On choiſit la premiere maiſon qui ſe trouva ;	On choisit la première maison qui se trouva ;
c’eſtoit celle d’une pauvre femme qui nouriſſoit ſon enfant.	c’était celle d’une pauvre femme qui nourrissait son enfant.
Ma mere, qui qu’elle ſoit, n’y fut pas une heure, qu’elle accoucha.	Ma mère, qui qu’elle soit, n’y fut pas une heure, qu’elle accoucha.
On fit nourrir l’enfant de la païſanne par une autre, & on me mit entre ſes mains avec une ſomme d’argent, puis la nuit venuë, on diſparut ;	On fit nourrir l’enfant de la paysanne par une autre, et on me mit entre ses mains avec une somme d’argent, puis la nuit venue, on disparut ;
la Païſanne qu’on avoit logée ailleurs pour cette nuit, trouva le lendemain qu’on avoit emporté ma mere à la faveur des tenebres ;	la Paysanne qu’on avait logée ailleurs pour cette nuit, trouva le lendemain qu’on avait emporté ma mère à la faveur des ténèbres ;
ſi on me demande où ?	si on me demande où ?
je le ſçay encore moins que le reſte, je voudrois le ſçavoir, plus pour ma ſatisfaction que pour celle des autres ;	je le sais encore moins que le reste, je voudrais le savoir, plus pour ma satisfaction que pour celle des autres ;
je devois pourtant nommer celle de Voſtre Alteſſe toute la premiere.	je devais pourtant nommer celle de Votre Altesse toute la première.
Je fus eſlevée juſques à cinq ans dans ce hameau, ſans eſtre reclamée de perſonne, & environ ce temps-là Monſieur le Duc de Candale s’aviſa de venir chaſſer ſur cette coſte :	Je fus élevée jusqu’à cinq ans dans ce hameau, sans être réclamée de personne, et environ ce temps-là Monsieur le Duc de Candale s’avisa de venir chasser sur cette côte :
il entra dans la cabane de ma Nourrice pour s’y mettre à couvert d’un orage.	il entra dans la cabane de ma Nourrice pour s’y mettre à couvert d’un orage.
Mes petites façons luy plûrent ;	Mes petites façons lui plurent ;
il crût voir en moy quelque choſe qui n’eſtoit pas de Païſanne, il s’informa qui j’eſtois, apprit mon Avanture, puis ſe tournant avec un ſoûris, vers un Gentil-homme qui l’accompagnoit ;	il crut voir en moi quelque chose qui n’était pas de Paysanne, il s’informa qui j’étais, apprit mon Aventure, puis se tournant avec un souris, vers un Gentilhomme qui l’accompagnait ;
Voilà, luy dit-il, une grande cruauté d’abandonner ainſi un enfant ;	Voilà, lui dit-il, une grande cruauté d’abandonner ainsi un enfant ;
cependant cette petite fille ſeroit un jour parfaitement belle ;	cependant cette petite fille serait un jour parfaitement belle ;
je veux prendre ſoin de la faire élever, pour voir ſi je ne ſeray trompé.	je veux prendre soin de la faire élever, pour voir si je ne serai trompé.
Et en effet dépuis ce moment-là, juſques à ſa mort, il ne me laiſſa mancquer d’aucune choſe neceſſaire à mon education ;	Et en effet depuis ce moment-là, jusqu’à sa mort, il ne me laissa manquer d’aucune chose nécessaire à mon éducation ;
méme il en fit tant, que quand on le ſçeut, cela fit dire à pluſieurs que je luy devois la vie, & quelques-uns l’entendoient malicieuſement.	même il en fit tant, que quand on le sut, cela fit dire à plusieurs que je lui devais la vie, et quelques uns l’entendaient malicieusement.
Toutesfois on m’a bien aſſûré qu’il n’eſtoit pas mon pere, & que ſa chaſſe l’avoit amené par hazard dans ce petit hameau ou l’orage luy avoit fait choiſir la maiſon de ma Nourrice entre toutes les autres, quoy qu’elle ne fût point la plus proche du coſté par où il arrivoit :	Toutefois on m’a bien assuré qu’il n’était pas mon père, et que sa chasse l’avait amené par hasard dans ce petit hameau où l’orage lui avait fait choisir la maison de ma Nourrice entre toutes les autres, quoi qu’elle ne fût point la plus proche du côté par où il arrivait :
Je m’en rapporte à ce qu’il en eſt, & ne ſeray point parente à Meſſieurs ſes heritiers s’ils ne le veulent :	Je m’en rapporte à ce qu’il en est, et ne serai point parente à Messieurs ses héritiers s’ils ne le veulent :
C’eſt aſſez parler de celà.	C’est assez parler de cela.
Le premier ſoin de ce genereux Duc fut de m’oſter à la Païſanne, pour me donner à quelqu’un qui pût m’élever avec plus de ſoin.	Le premier soin de ce généreux Duc fut de m’ôter à la Paysanne, pour me donner à quelqu’un qui pût m’élever avec plus de soin.
Il y avoit à Pezenas un Financier dont la femme eſtoit de ſes amies, & cét homme luy avoit obligation de toute ſa fortune :	Il y avait à Pézenas un Financier dont la femme était de ses amies, et cet homme lui avait obligation de toute sa fortune :
On nourriſſoit à ces gens-là, en une de leurs métairies, une petite fille de mon âge, qui eſtoit abandonnée des Medecins, & on attendoit tous les jours l’heure qu’elle mouruſt :	On nourrissait à ces gens-là, en une de leurs métairies, une petite fille de mon âge, qui était abandonnée des Médecins, et on attendait tous les jours l’heure qu’elle mourût :
Il n’eſtoit pas mal-aiſé de me mettre en ſa place dés qu’elle ſeroit morte, & de faire accroire, en la changeant de main auparavant, qu’on l’auroit depuis guerie à force de bons remedes	Il n’était pas malaisé de me mettre en sa place dès qu’elle serait morte, et de faire accroire, en la changeant de main auparavant, qu’on l’aurait depuis guérie à force de bons remèdes
(Voyez un peu, Madame, par quel chemin la fortune me guidoit aux aventures ?)	(Voyez un peu, Madame, par quel chemin la fortune me guidait aux aventures ?)
Cét échange ſe fit aſſez adroitement :	Cet échange se fit assez adroitement :
Le Financier en uſa le mieux du monde :	Le Financier en usa le mieux du monde :
Je devins par ce moyen la cadette d’un fils qu’il avoit, & le denier conſiderable que le Duc luy donna en méme temps luy inſpira toute la tendreſſe qu’il faloit pour bien contrefaire une amitié paternelle.	Je devins par ce moyen la cadette d’un fils qu’il avait, et le denier considérable que le Duc lui donna en même temps lui inspira toute la tendresse qu’il fallait pour bien contrefaire une amitié paternelle.
Je ne fatiguerois peut-eſtre point Vôtre Altreſſe, en commençant mon hiſtoire par ce qui à pû rendre mon enfance auſſi ſurprenante que le reſte de ma vie.	Je ne fatiguerais peut-être point Votre Altresse, en commençant mon histoire par ce qui a pu rendre mon enfance aussi surprenante que le reste de ma vie.
J’avois un petit air galant qui accuſoit quaſi ce Seigneur d’eſtre mon pere ;	J’avais un petit air galant qui accusait quasi ce Seigneur d’être mon père ;
de l’eſprit, de la vanité, du courage, & une telle diſpoſition à bien prendre l’accent de toutes les langues, que comme le fils de mon Financier avoit des gens auprés de luy, pour les luy montrer ;	de l’esprit, de la vanité, du courage, et une telle disposition à bien prendre l’accent de toutes les langues, que comme le fils de mon Financier avait des gens auprès de lui, pour les lui montrer ;
j’en appris en peu de temps juſques à l’Alemand meſme, avec une merveilleuſe facilité.	j’en appris en peu de temps jusqu’à l’Allemand même, avec une merveilleuse facilité.
J’avois auſſi une grande paſſion pour la chaſſe, & enfin juſques-là on n’avoit guére veu de fille mépriſer, comme moy, dés l’âge de diz ans, tous les divertiſſemens du ſexe, pour monter à cheval, tirer un piſtolet, ou faire quelqu’autre ſemblable exercice.	J’avais aussi une grande passion pour la chasse, et enfin jusque là on n’avait guère vu de fille mépriser, comme moi, dés l’âge de dix ans, tous les divertissements du sexe, pour monter à cheval, tirer un pistolet, ou faire quelque autre semblable exercice.
Et il ne ſeroit pas impoſſible que des inclinations ſi extraordinaires euſſent fait naiſtre quelques petites Aventures aſſez jolies ſi je voulois m’en reſſouvenir :	Et il ne serait pas impossible que des inclinations si extraordinaires eussent fait naître quelques petites Aventures assez jolies si je voulais m’en ressouvenir :
mais mon deſſein eſt de ne parler icy que de ce qu’a veu le grand monde, & je n’avois alors que des témoins de peu d’importance.	mais mon dessein est de ne parler ici que de ce qu’a vu le grand monde, et je n’avais alors que des témoins de peu d’importance.
Je diray ſeulement que je ne connoiſſois point d’autre pere & mere que les gens à qui l’on m’avoit donnée ;	Je dirai seulement que je ne connaissais point d’autre père et mère que les gens à qui l’on m’avait donnée ;
& que je n’en fut détrompée que bien tard, par une Aventure aſſez nouvelle.	et que je n’en fus détrompée que bien tard, par une Aventure assez nouvelle.
La femme de mon Financier eſtoit bien faite, & avoit beaucoup d’eſprit.	La femme de mon Financier était bien faite, et avait beaucoup d’esprit.
Un Marquis de Birague, homme de naiſſance, & tout plein de belles qualitez, tel enfin que (ſi je n’ay pas eu en ce temps-là aſſez de conſideration pour luy, parce qu’il eſtoit marié) je ſerois fort aiſe d’eſtre ſervie par un ſemblable Cavalier, maintenant qu’il eſt veuf.	Un Marquis de Birague, homme de naissance, et tout plein de belles qualités, tel enfin que (si je n’ai pas eu en ce temps-là assez de considération pour lui, parce qu’il était marié) je serais fort aise d’être servie par un semblable Cavalier, maintenant qu’il est veuf.
Ce galant homme, dis-je, voyoit ſouvent la belle Dame de Moliere, c’eſt ainſi que s’appelloit cette femme.	Ce galant homme, dis-je, voyait souvent la belle Dame de Molière, c’est ainsi que s’appelait cette femme.
Le mary les trouva tous deux endormis l’un prés de l’autre, dans un petit bois de l’une de ſes maiſons, à l’heure qu’ils le croyoient loin de là fort occupé à ſon employ.	Le mari les trouva tous deux endormis l’un près de l’autre, dans un petit bois de l’une de ses maisons, à l’heure qu’ils le croyaient loin de là fort occupé à son emploi.
Je ne ſçay pas bien comment la Dame ſe démeſla de cette ſurpriſe ;	Je ne sais pas bien comment la Dame se démêla de cette surprise ;
mais enfin quelques jours apres, je reconnus que ce mary avoit deſſein de s’en venger, & que dans ſon ame, il avoit medité de me faire partager le ſoin de cette vengeance.	mais enfin quelques jours après, je reconnus que ce mari avait dessein de s’en venger, et que dans son âme, il avait médité de me faire partager le soin de cette vengeance.
Le détail de la maniere dont il ſe prit à me le faire connoiſtre, ſeroit ennuyeux.	Le détail de la manière dont il se prit à me le faire connaître, serait ennuyeux.
J’eſtois folaſtre & careſſante pour les gens à qui je croyois appartenir, quoy que je fuſſe la plus fiere des petites filles pour tout le reſte ;	J’étais folâtre et caressante pour les gens à qui je croyais appartenir, quoique je fusse la plus fière des petites filles pour tout le reste ;
Et ainſi lors qu’il me témoigna de l’attachement, j’y répondis par cent careſſes.	Et ainsi lorsqu’il me témoigna de l’attachement, j’y répondis par cent caresses.
Mais apres que cela eut duré quelque temps, je luy plûs ſi fort par ces petites badineries auſquelles je m’abandonnois avec innocence ;	Mais après que cela eut duré quelque temps, je lui plus si fort par ces petites badineries auxquelles je m’abandonnais avec innocence ;
que je le rendis ſans y penſer le plus amoureux de tous les hommes, & il ſe reſolut de pouſſer les affaires plus loin.	que je le rendis sans y penser le plus amoureux de tous les hommes, et il se résolut de pousser les affaires plus loin.
Il me mena à la chaſſe :	Il me mena à la chasse :
c’eſtoit mon foible ;	c’était mon faible ;
Et m’ayant écartée adroitement de ſa femme & du Marquis de Birague, qui peut-eſtre de leur coſté cherchoient auſſi une occaſion de s’écarter :	Et m’ayant écartée adroitement de sa femme et du Marquis de Birague, qui peut-être de leur côté cherchaient aussi une occasion de s’écarter :
Il fit tant que nous nous trouvâmes tous deux ſeuls aſſez loin dans la foreſt.	Il fit tant que nous nous trouvâmes tous deux seuls assez loin dans la forêt.
Le lieu invitoit à mettre pied à terre, & eſtoit tout propre à favoriſer deux perſonnes qui euſſent eſté d’accord.	Le lieu invitait à mettre pied à terre, et était tout propre à favoriser deux personnes qui eussent été d’accord.
Les arbres y formoient une eſpece de berceau, une ſource faiſoit entendre ſon murmure à deux pas de-là ;	Les arbres y formaient une espèce de berceau, une source faisait entendre son murmure à deux pas de là ;
enfin, Madame, Monſieur de Moliere eſtoit un habile homme, & pour le deſſein qu’il avoit, le lieu n’eſtoit pas mal choiſi.	enfin, Madame, Monsieur de Molière était un habile homme, et pour le dessein qu’il avait, le lieu n’était pas mal choisi.
J’y deſcendis de cheval à ſa priere, & le voyant s’y coucher de ſon long pour ſe repoſer, je m’allay mettre auprés de luy en la meſme poſture, ſans aucun ſoupçon de ce qui m’y devoit arriver.	J’y descendis de cheval à sa prière, et le voyant s’y coucher de son long pour se reposer, je m’allai mettre auprès de lui en la même posture, sans aucun soupçon de ce qui m’y devait arriver.
Alors mon prétendu pere s’approchant un peu & m’embraſſant tendrement commença à me découvrir un ſecret, auquel je n’euſſe jamais penſé, & me raconta l’hiſtoire de ma naiſſance.	Alors mon prétendu père s’approchant un peu et m’embrassant tendrement commença à me découvrir un secret, auquel je n’eusse jamais pensé, et me raconta l’histoire de ma naissance.
Il m’étala enſuite les obligations que je luy avois, de ce qu’en voulant bien paſſer toûjours pour mon pere, il m’aſſeuroit tous ſes biens, que la mort de ſon fils tué depuis peu, m’abandonnoit.	Il m’étala ensuite les obligations que je lui avais, de ce qu’en voulant bien passer toujours pour mon père, il m’assurait tous ses biens, que la mort de son fils tué depuis peu, m’abandonnait.
Il ajoûta beaucoup d’autres choſes pour me faire valoir ſon amour ;	Il ajouta beaucoup d’autres choses pour me faire valoir son amour ;
Et le refrein de tout cela fut que je devois répondre à ſa paſſion pour éviter le vice d’ingratitude :	Et le refrain de tout cela fut que je devais répondre à sa passion pour éviter le vice d’ingratitude :
qu’il m’aimeroit toûjours avec la plus grande diſcretion du monde, & que ce commerce n’empeſcheroit pas qu’il ne me trouvaſt bien-toſt un party conſiderable.	qu’il m’aimerait toujours avec la plus grande discrétion du monde, et que ce commerce n’empêcherait pas qu’il ne me trouvât bientôt un parti considérable.
Si je dûs eſtre confuſe & bien eſtonnée en apprenant ces nouvelles, Voſtre Alteſſe en ſera le juge.	Si je dus être confuse et bien étonnée en apprenant ces nouvelles, Votre Altesse en sera le juge.
Je me trouvay d’autant plus embaraſſée, que cét homme, apres avoir finy ſon diſcours, ſe mit en devoir d’encherir par deſſus ſes careſſes ordinaires, & que ma reſiſtance l’embraza d’avantage par la difficulté.	Je me trouvai d’autant plus embarrassée, que cet homme, après avoir fini son discours, se mit en devoir d’enchérir par-dessus ses caresses ordinaires, et que ma résistance l’embrasa d’avantage par la difficulté.
Il ſe jetta à mes genoux :	Il se jeta à mes genoux :
fit mille extravagances, & quoy que je luy euſſe répondu qu’un reſte de tendreſſe & de reſpect, que l’habitude retenoit dans mon cœur, eſtoit la ſeule choſe qui m’empeſchoit de me venger de ſes inſolences, il ne laiſſa point de les continüer, juſques à vouloir en venir à la force ;	fit mille extravagances, et quoique je lui eusse répondu qu’un reste de tendresse et de respect, que l’habitude retenait dans mon cœur, était la seule chose qui m’empêchait de me venger de ses insolences, il ne laissa point de les continuer, jusqu’à vouloir en venir à la force ;
Ce fut alors que j’entray en furie, je me démeſlay de ſes bras, je courus à mon cheval, je pris un piſtolet à larçon de la Selle & le menaçay de le tuër, s’il ne me laiſſoit :	Ce fut alors que j’entrai en furie, je me démêlai de ses bras, je courus à mon cheval, je pris un pistolet à l’arçon de la Selle et le menaçai de le tuer, s’il ne me laissait :
Il n’en fit rien, & au contraire ſa brutalité ſe changeant en fureur, je le vis venir à moy comme un ſatyre, en jurant qu’il ſe ſatisferoit ;	Il n’en fit rien, et au contraire sa brutalité se changeant en fureur, je le vis venir à moi comme un satyre, en jurant qu’il se satisferait ;
Je laſchay le piſtolet qui le bleſſa de deux bales dans le corps :	Je lâchai le pistolet qui le blessa de deux balles dans le corps :
Voilà, Madame, qu’elles furent mes premieres cruautez.	Voilà, Madame, quelles furent mes premières cruautés.
Cependant, l’embarras eſtoit conſiderable pour une fille de mon âge, de ſe voir ſeule dans un bois, d’y avoir étendu un homme ſur la place, d’avoir à ſe ſauver & ne ſe ſouvenir point de la route qui nous avoit conduits en cét endroit.	Cependant, l’embarras était considérable pour une fille de mon âge, de se voir seule dans un bois, d’y avoir étendu un homme sur la place, d’avoir à se sauver et ne se souvenir point de la route qui nous avait conduits en cet endroit.
Auſſi en fus-je tellement épouventée, que je penſay me laiſſer tomber à la renverſe en meſme temps que ce malheureux.	Aussi en fus-je tellement épouvantée, que je pensai me laisser tomber à la renverse en même temps que ce malheureux.
Toutefois ce deſordre ne dura pas.	Toutefois ce désordre ne dura pas.
La neceſſité rappella mon jugement.	La nécessité rappela mon jugement.
Je remontay à cheval.	Je remontai à cheval.
Le bleſſé qui eut plus de pitié de mon embarras, que je n’en avois eu du ſien, me cria de tourner à gauche, & j’abandonnay mon cheval à la courſe par cette route, par où en effet je me fuſſe bien-tôt éloignée ;	Le blessé qui eut plus de pitié de mon embarras, que je n’en avais eu du sien, me cria de tourner à gauche, et j’abandonnai mon cheval à la course par cette route, par où en effet je me fusse bientôt éloignée ;
mais j’allay rencontrer Monſieur de Birague, & la Dame de Moliere, qui s’eſtant entretenus là où il leur avoit plû ſans s’entretüer comme nous, venoient apparamment pour nous rejoindre, guidez par le buit du piſtolet.	mais j’allai rencontrer Monsieur de Birague, et la Dame de Molière, qui s’étant entretenus là où il leur avait plu sans s’entretuer comme nous, venaient apparemment pour nous rejoindre, guidés par le buit du pistolet.
O Dieu !	Ô Dieu !
quelle fut alors mon affliction ?	quelle fut alors mon affliction ?
& quand, à cette diſgrace, il ſe méla encore la peur d’un ſanglier qui eſtoit chaſſé, & qui traverſa en meſme temps cette route preſque ſur les pieds de mon cheval !	et quand, à cette disgrâce, il se mêla encore la peur d’un sanglier qui était chassé, et qui traversa en même temps cette route presque sur les pieds de mon cheval !
Il me ſouvient que malgré toute ma ſurpriſe, je ne laiſſay pas de mettre la main au piſtolet qui me reſtoit, comme pour arreſter cet animal :	Il me souvient que malgré toute ma surprise, je ne laissai pas de mettre la main au pistolet qui me restait, comme pour arrêter cet animal :
Et je diray en paſſant que c’eſt à quoy je veux reconnoiſtre quelquefois le ſang genereux dont je pourrois bien eſtre née.	Et je dirai en passant que c’est à quoi je veux reconnaître quelquefois le sang généreux dont je pourrais bien être née.
Monſieur de Birague qui vit de loin mon action, & qui crût que je n’eſtois là venuë à toute bride, qu’à deſſein d’y rencontrer la beſte au paſſage ;	Monsieur de Birague qui vit de loin mon action, et qui crut que je n’étais là venue à toute bride, qu’à dessein d’y rencontrer la bête au passage ;
fit un grand cry pour me reprocher ma temerité, & s’avançant vers moy au grand galop, me demanda ſi Monſieur de Moliere ſe mocquoit de m’expoſer de la ſorte.	fit un grand cri pour me reprocher ma témérité, et s’avançant vers moi au grand galop, me demanda si Monsieur de Molière se moquait de m’exposer de la sorte.
Mais comme il ne s’imaginoit rien moins que la verité, & que je n’avois pas de temps à perdre ;	Mais comme il ne s’imaginait rien moins que la vérité, et que je n’avais pas de temps à perdre ;
je luy dis, ſans m’amuſer à l’éclaircir d’aucunes choſes, que je le connoiſſois pour un grave Gentil-homme, que j’avois des ſecrets d’importance à luy dire, & que tandis que je luy parlerois il donnât ſeulement avis à Madame de Moliere d’aller trouver ſon mary un peu plus loin où il eſtoit bien bleſſé.	je lui dis, sans m’amuser à l’éclaircir d’aucunes choses, que je le connaissais pour un grave Gentilhomme, que j’avais des secrets d’importance à lui dire, et que tandis que je lui parlerais il donnât seulement avis à Madame de Molière d’aller trouver son mari un peu plus loin où il était bien blessé.
À peine avois-je finy ces paroles qu’elle-meſme nous joignit.	À peine avais-je fini ces paroles qu’elle-même nous joignit.
Sur cette nouvelle elle ſe fit mener ſans retardement vers l’endroit par deux gardes de chaſſe, dont ils eſtoient ſuivis ;	Sur cette nouvelle elle se fit mener sans retardement vers l’endroit par deux gardes de chasse, dont ils étaient suivis ;
Et moy prenant ce temps-là pour dire à ce Gentil-homme que c’eſtoit moy qui avoit fait le coup, je le ſuppliay de me conduire en quelque lieu de ſeureté.	Et moi prenant ce temps-là pour dire à ce Gentilhomme que c’était moi qui avait fait le coup, je le suppliai de me conduire en quelque lieu de sûreté.
Sa ſurpriſe & la penſée que le bleſſé fut mon veritable pere, luy arracherent d’abord quelques reproches qui marquerent l’excés de ſon eſtonnement ;	Sa surprise et la pensée que le blessé fut mon véritable père, lui arrachèrent d’abord quelques reproches qui marquèrent l’excès de son étonnement ;
mais eſtant ennemie de tout ce qui pouvoit alors eſtre inutile :	mais étant ennemie de tout ce qui pouvait alors être inutile :
Il n’eſt pas mon pere, luy repliquay-je avec chagrin, & ce n’eſt pas icy le lieu de vous expliquer ce myſtere.	Il n’est pas mon père, lui répliquai-je avec chagrin, et ce n’est pas ici le lieu de vous expliquer ce mystère.
Si vous avez deſſein de me ſervir ;	Si vous avez dessein de me servir ;
mettez-moy, luy dis-je, encore une fois, en quelque lieu où je ſois en ſeureté, & je vous contenteray aprés ſur toutes les queſtions que vous voudrez me faire.	mettez-moi, lui dis-je, encore une fois, en quelque lieu où je sois en sûreté, et je vous contenterai après sur toutes les questions que vous voudrez me faire.
À ces mots il vit ſon Gentil-homme qui venoit encore au galop derriere luy, & il luy commanda de retourner pour me conduire dans ſon Château de Serſac auprés de la Marquiſe ſa femme, puis il pourſuivit ſon chemin pour rejoindre ſa Maîtreſſe.	À ces mots il vit son Gentilhomme qui venait encore au galop derrière lui, et il lui commanda de retourner pour me conduire dans son Château de Sersac auprès de la Marquise sa femme, puis il poursuivit son chemin pour rejoindre sa Maîtresse.
Elle eſtoit arrivée au lieu fatal, & je ne ſçay pas ſi la maxime du temps eſt veritable, qu’on puiſſe avoir un galant & n’en aimer pas moins ſon mary ;	Elle était arrivée au lieu fatal, et je ne sais pas si la maxime du temps est véritable, qu’on puisse avoir un galant et n’en aimer pas moins son mari ;
mais on me dit qu’il n’y avoit jamais eu de deſolation pareille à celle de la Dame, lors qu’elle vit le ſien couché en terre ſur ſon ſang, & que s’eſtant penchée ſur luy pour le baiſer, il fut preſque impoſſible de l’en ſeparer.	mais on me dit qu’il n’y avait jamais eu de désolation pareille à celle de la Dame, lorsqu’elle vit le sien couché en terre sur son sang, et que s’étant penchée sur lui pour le baiser, il fut presque impossible de l’en séparer.
La médiſance qui n’épargne pas les plus ſaintes actions, ne put à la verité concevoir cét excés d’amour, & publia que c’eſtoit afin qu’on n’euſt pas ſi toſt le moyen d’étancher ſon ſang, & qu’en ayant perdu beaucoup, il en puſt moins réchaper ;	La médisance qui n’épargne pas les plus saintes actions, ne put à la vérité concevoir cet excès d’amour, et publia que c’était afin qu’on n’eût pas sitôt le moyen d’étancher son sang, et qu’en ayant perdu beaucoup, il en pût moins réchapper ;
mais quelque perſecution que cette Dame m’ait fait ſouffrir, & quoy que celà ait pû cauſer effectivement la mort à ſon mary je veux luy faire la juſtice de croire qu’elle fit tout de bonne foy.	mais quelque persécution que cette Dame m’ait fait souffrir, et quoique cela ait pu causer effectivement la mort à son mari je veux lui faire la justice de croire qu’elle fit tout de bonne foi.
On enleva ce pauvre bleſſé avec bien de la peine, & on l’emporta dans le plus prochain Village, pour luy mettre le premier appareil :	On enleva ce pauvre blessé avec bien de la peine, et on l’emporta dans le plus prochain Village, pour lui mettre le premier appareil :
puis on taſcha de luy faire nommer l’autheur de ſa bleſſure.	puis on tâcha de lui faire nommer l’auteur de sa blessure.
Mais en vain on le luy demanda pluſieurs fois, il répondit que c’étoient trois hommes maſquez qui m’avoient voulu enlever ;	Mais en vain on le lui demanda plusieurs fois, il répondit que c’étaient trois hommes masqués qui m’avaient voulu enlever ;
Monſieur de Birague luy meſme, qui eſtant déja inſtruit par moy du principal, & le luy faiſant entendre, en eſperoit ſçavoir tout le ſecret, n’en put jamais tirer autre choſe.	Monsieur de Birague lui-même, qui étant déjà instruit par moi du principal, et le lui faisant entendre, en espérait savoir tout le secret, n’en put jamais tirer autre chose.
Cela fit que l’on ne s’obſtina point d’avantage à le faire parler, & que l’on ſongea ſeulement à le tranſporter dans la Ville.	Cela fit que l’on ne s’obstina point davantage à le faire parler, et que l’on songea seulement à le transporter dans la Ville.
Cependant, Madame, la diſcretion de ce malheureux, ſoit qu’elle fut un effet de honte ou de quelque reſte d’amour, me ſauvoit dans l’opinion de tous ceux à qui je n’avois rien confeſſé, ſi j’avois eu aſſez de force pour oſer paroiſtre aprés le coups ;	Cependant, Madame, la discrétion de ce malheureux, soit qu’elle fut un effet de honte ou de quelque reste d’amour, me sauvait dans l’opinion de tous ceux à qui je n’avais rien confessé, si j’avais eu assez de force pour oser paraître après le coup ;
car le Marquis de Birague me vint dire que tout le monde avoit pris ma fuitte pour un effet de la peur que ces raviſſeurs ſuppoſez m’avoient cauſée & luy-meſme qui appuyoit cette imagination, ne pouvoit penſer autre choſe de l’accident, ſi ce n’eſt que je pouvois avoir bleſſé le Financier en voulant tirer ſur eux ;	car le Marquis de Birague me vint dire que tout le monde avait pris ma fuite pour un effet de la peur que ces ravisseurs supposés m’avaient causée et lui-même qui appuyait cette imagination, ne pouvait penser autre chose de l’accident, si ce n’est que je pouvais avoir blessé le Financier en voulant tirer sur eux ;
mais il arriva un autre malheur qui découvrit bien-toſt le myſtere ;	mais il arriva un autre malheur qui découvrit bientôt le mystère ;
je le diray par ordre à Voſtre Alteſſe.	je le dirai par ordre à Votre Altesse.
J’avois eſté miſe entre les mains de la Marquiſe de Birague, dans le Chaſteau de Serſac, le Marquis vint m’y retrouver, aprés avoir pris le ſoin de mettre auſſi ſa Dame de Moliere en quelque repos.	J’avais été mise entre les mains de la Marquise de Birague, dans le Château de Sersac, le Marquis vint m’y retrouver, après avoir pris le soin de mettre aussi sa Dame de Molière en quelque repos.
Je vous avoüe que je fus touchée quand il m’apprit la conſideration que le bleſſé avoit eu pour moy, & qu’encore que je ne me repentiſſe aucunement d’avoir ſauvé mon honneur au prix de ſa vie, je ne pûs empeſcher quelques larmes de couler d’avoir eſté forcée d’en venir là :	Je vous avoue que je fus touchée quand il m’apprit la considération que le blessé avait eu pour moi, et qu’encore que je ne me repentisse aucunement d’avoir sauvé mon honneur au prix de sa vie, je ne pus empêcher quelques larmes de couler d’avoir été forcée d’en venir là :
Je m’etendis ſur quelques plaintes que je donnay ſur l’heure à l’embaras où j’eſtois, & aprés je racontay bien au long à ce Marquis tout ce qui s’eſtoit paſſé avec l’hiſtoire que le Financier m’avoit faite ce qui le rendit bien eſtonné.	Je m’étendis sur quelques plaintes que je donnai sur l’heure à l’embarras où j’étais, et après je racontai bien au long à ce Marquis tout ce qui s’était passé avec l’histoire que le Financier m’avait faite ce qui le rendit bien étonné.
Il avoit toûjours crû, comme moy & comme tout le monde, que j’eſtois la fille de cét homme ;	Il avait toujours cru, comme moi et comme tout le monde, que j’étais la fille de cet homme ;
& que Madame de Moliere ne luy avoit jamais confié ce ſecret, quoy qu’elle luy confiaſt ſouvent ſa perſonne meſme.	et que Madame de Molière ne lui avait jamais confié ce secret, quoi qu’elle lui confiât souvent sa personne même.
Au reſte la nouveauté de l’aventure m’acquit entierement le Cavalier, & il donna mille loüanges à mon action, au lieu de la blâmer, me fit cent proteſtations de ſervice, & enfin, Madame, il me parla comme un homme qui me trouvoit belle, & qui commençoit à ſçavoir que je n’eſtois plus la fille de ſa Maitreſſe ;	Au reste la nouveauté de l’aventure m’acquit entièrement le Cavalier, et il donna mille louanges à mon action, au lieu de la blâmer, me fit cent protestations de service, et enfin, Madame, il me parla comme un homme qui me trouvait belle, et qui commençait à savoir que je n’étais plus la fille de sa Maîtresse ;
je diray cela ſans luy faire tort.	je dirai cela sans lui faire tort.
Je m’en apperceus bien dés le moment ;	Je m’en aperçus bien dès le moment ;
mais la neceſſité de mettre quelqu’un dans mes intereſts, fit que je ne voulus pas faire un ſecond meurtre pour me venger des eſperances qu’il conceut peut-eſtre alors à mon deſavantage.	mais la nécessité de mettre quelqu’un dans mes intérêts, fit que je ne voulus pas faire un second meurtre pour me venger des espérances qu’il conçut peut-être alors à mon désavantage.
Bien loin de celà, je le remerciay de ſa generoſité ;	Bien loin de cela, je le remerciai de sa générosité ;
j’eus pour luy honeſtement toutes les complaiſances que je pûs ;	j’eus pour lui honnêtement toutes les complaisances que je pus ;
& j’oſeray dire qu’une ſemblable rencontre eſtoit la ſeule qui pouvoit jamais m’accoûtumer à ſouffrir une declaration d’amour ſans colere, tant j’en eſtois ennemie mortelle auparavant.	et j’oserai dire qu’une semblable rencontre était la seule qui pouvait jamais m’accoutumer à souffrir une déclaration d’amour sans colère, tant j’en étais ennemie mortelle auparavant.
Je demeuray deux jours dans ſon château, n’apprenant aucunes nouvelles de la Ville, que ce qu’il m’en envoyoit dire par ſon Gentil-homme ;	Je demeurai deux jours dans son château, n’apprenant aucunes nouvelles de la Ville, que ce qu’il m’en envoyait dire par son Gentilhomme ;
& juſques à ce moment, il n’y avoit eu encore aucun danger pour moy :	et jusqu’à ce moment, il n’y avait eu encore aucun danger pour moi :
au contraire l’opinion que je fuſſe retombée entre les mains des gens maſquez redoubloit le deüil de la maiſon ;	au contraire l’opinion que je fusse retombée entre les mains des gens masqués redoublait le deuil de la maison ;
mais il n’en fut pas de meſme le lendemain que la fiévre avoit fait parler le malade dans ſes réveries, avant qu’il mourut.	mais il n’en fut pas de même le lendemain que la fièvre avait fait parler le malade dans ses rêveries, avant qu’il mourut.
Il avoit preſque tout découvert, & prenant ſa femme pour moy, qu’il demandoit à toute heure, il luy avoit reproché le coup de piſtolet :	Il avait presque tout découvert, et prenant sa femme pour moi, qu’il demandait à toute heure, il lui avait reproché le coup de pistolet :
On avoit compris à quelques autres diſcours interrompus, que c’eſtoit de moy qu’il parloit.	On avait compris à quelques autres discours interrompus, que c’était de moi qu’il parlait.
L’allarme ſe mit auſſi-toſt dans la famille, on ceſſa de me plaindre pour m’accuſer, & avec d’autant plus de violence, que le fils de la maiſon, dont on me croyoit la cadette, eſtoit mort, comme j’ay déjà-dit, & que j’eſtois le ſeul obſtacle qui pouvoit empeſcher les parens du mary d’heriter d’un bien conſiderable.	L’alarme se mit aussitôt dans la famille, on cessa de me plaindre pour m’accuser, et avec d’autant plus de violence, que le fils de la maison, dont on me croyait la cadette, était mort, comme j’ai déjà dit, et que j’étais le seul obstacle qui pouvait empêcher les parents du mari d’hériter d’un bien considérable.
Madame de Moliere elle-meſme, quelque attachement qu’elle eut pour moy, en memoire du Duc qu’elle n’avoit point haï, & par la raiſon de quelques autres engagemens, crut que la bien-ſeance ne luy permettoit plus de me laiſſer paſſer pour ſa fille.	Madame de Molière elle-même, quelque attachement qu’elle eut pour moi, en mémoire du Duc qu’elle n’avait point haï, et par la raison de quelques autres engagements, crut que la bienséance ne lui permettait plus de me laisser passer pour sa fille.
Et peut-eſtre une autre politique luy fit conſiderer qu’elle ſeroit une veufve bien plus propre à remarier, quand on ſçauroit qu’elle n’auroit plus d’enfans ;	Et peut-être une autre politique lui fit considérer qu’elle serait une veuve bien plus propre à remarier, quand on saurait qu’elle n’aurait plus d’enfants ;
Enfin elle s’eſtoit déja reſoluë à me laiſſer perdre.	Enfin elle s’était déjà résolue à me laisser perdre.
Et il n’y avoit rien plus aiſé que de me ruïner.	Et il n’y avait rien plus aisé que de me ruiner.
Monſieur de Candale eſtoit mort dés l’année mil ſix cens cinquanteſept, & ce galant Duc, dont la generoſité ſans doute, n’aimoit pas toûjours l’éclat, ne m’avoit pas fait connoiſtre à beaucoup d’autres gens, que le Financier & ſa femme, de peur, comme je croy, qu’on ne ſceut la charité qu’il avoit euë, en me traitant comme s’il eût eſté mon Pere.	Monsieur de Candale était mort dès l’année mille six cent cinquante-sept, et ce galant Duc, dont la générosité sans doute, n’aimait pas toujours l’éclat, ne m’avait pas fait connaître à beaucoup d’autres gens, que le Financier et sa femme, de peur, comme je crois, qu’on ne sut la charité qu’il avait eue, en me traitant comme s’il eût été mon Père.
Toutefois ma bonne fortune ne m’abandonna pas encore, & Monſieur de Birague qui avoit envie que je luy euſſe beaucoup d’obligation, me rendit de ſi bons ſervices pendant quelques mois, dans cette affaire, & dans une autre qui m’arriva depuis, qu’il donna le temps au meſme hazard qui avoit conduit autrefois le Duc de Candale à la cabanne de ma Nourrice, d’amener encore une puiſſante Dame du fonds de la Flandre, pour prendre ſoin de moy en France, comme ſi elle eut eſté ma mere.	Toutefois ma bonne fortune ne m’abandonna pas encore, et Monsieur de Birague qui avait envie que je lui eusse beaucoup d’obligation, me rendit de si bons services pendant quelques mois, dans cette affaire, et dans une autre qui m’arriva depuis, qu’il donna le temps au même hasard qui avait conduit autrefois le Duc de Candale à la cabane de ma Nourrice, d’amener encore une puissante Dame du fond de la Flandre, pour prendre soin de moi en France, comme si elle eût été ma mère.
Au commencement donc que le ſoupçon fut tombé ſur moy, tout alloit eſtre en feu ;	Au commencement donc que le soupçon fut tombé sur moi, tout allait être en feu ;
mais ce Marquis empeſcha l’orage de ſe former, & il repreſenta à ſa Dame qu’il luy ſeroit plus avantageux par mille raiſons d’intereſts & d’honneur, de me proteger que de me perdre ;	mais ce Marquis empêcha l’orage de se former, et il représenta à sa Dame qu’il lui serait plus avantageux par mille raisons d’intérêts et d’honneur, de me protéger que de me perdre ;
raiſons que les charmes ſenſibles de la perſonne du Cavalier firent trouver ſolides à la belle veufve, ſi elles ne l’eſtoient point en effet.	raisons que les charmes sensibles de la personne du Cavalier firent trouver solides à la belle veuve, si elles ne l’étaient point en effet.
Ainſi aprés quelques jours & quelques aventures forgées, pour excuſer mon abſence & pour pretexter mon retour, Monſieur de Birague me vint annoncer que je pouvois ſortir du Chaſteau de Serſac, ce que je fis, & je m’allay jetter dans une Abbaye de filles à une lieuë de-là.	Ainsi après quelques jours et quelques aventures forgées, pour excuser mon absence et pour prétexter mon retour, Monsieur de Birague me vint annoncer que je pouvais sortir du Château de Sersac, ce que je fis, et je m’allai jeter dans une Abbaye de filles à une lieue de là.
Il ſe ſervit de mille artifices pour m’y venir voir ſouvent ſans en donner de ſoupçon à ſa veufve ;	Il se servit de mille artifices pour m’y venir voir souvent sans en donner de soupçon à sa veuve ;
Et l’hiſtoire meſme n’en ſeroit pas deſagreable, ſi je la racontois ;	Et l’histoire même n’en serait pas désagréable, si je la racontais ;
car comme j’ay déja dit, qu’il avoit un grand fonds ſur les obligations que je pourrois luy avoir avec le temps, il ne perdit aucune occaſion de me faire connoiſtre qu’il n’aimoit plus la Dame de Moliere, que pour meriter d’eſtre aimé de moy, en ménageant auprés d’elle, par ce moyen que toutes les choſes que j’avois à craindre, demeuraſſent étouffées à jamais ;	car comme j’ai déjà dit, qu’il avait un grand fonds sur les obligations que je pourrais lui avoir avec le temps, il ne perdit aucune occasion de me faire connaître qu’il n’aimait plus la Dame de Molière, que pour mériter d’être aimé de moi, en ménageant auprès d’elle, par ce moyen que toutes les choses que j’avais à craindre, demeurassent étouffées à jamais ;
il m’écrivit meſme quelquesfois des Lettres ſi plaiſantes là-deſſus, quand il n’avoit point de pretexte pour me viſiter ;	il m’écrivit même quelquefois des Lettres si plaisantes là-dessus, quand il n’avait point de prétexte pour me visiter ;
que Madame l’Abbeſſe, avec qui j’avois contracté une étroite amitié, en partageoit avec moy le plus agreable divertiſſement du monde ;	que Madame l’Abbesse, avec qui j’avais contracté une étroite amitié, en partageait avec moi le plus agréable divertissement du monde ;
ſur tout lors qu’il nous mandoit que le chagrin que luy cauſoit mon indifference, luy attiroit des tendreſſes incroyables de ſa veufve, qui en faiſoit l’application à un redoublement d’amour qu’il avoit pour elle ;	surtout lorsqu’il nous mandait que le chagrin que lui causait mon indifférence, lui attirait des tendresses incroyables de sa veuve, qui en faisait l’application à un redoublement d’amour qu’il avait pour elle ;
mais il faut paſſer outre, & dire ſeulement que je me perdis moy-meſme, par la folie que j’eus de complaire à cette Abbeſſe badine, qui avoit voulu que je luy fiſſe une réponſe.	mais il faut passer outre, et dire seulement que je me perdis moi-même, par la folie que j’eus de complaire à cette Abbesse badine, qui avait voulu que je lui fisse une réponse.
Ma lettre tomba je ne ſçay comment entre les mains de cette veufve.	Ma lettre tomba je ne sais comment entre les mains de cette veuve.
Elle reconnut en la liſant qu’elle avoit eu pitié d’une langueur dont elle n’eſtoit point coupable :	Elle reconnut en la lisant qu’elle avait eu pitié d’une langueur dont elle n’était point coupable :
Cette connoiſſance la mit en fureur, ſa jalouſie jura ma perte, & enfin elle ſe reſolut à punir ſon infidelle, en réveillant mon affaire qu’elle avoit aſſoupie.	Cette connaissance la mit en fureur, sa jalousie jura ma perte, et enfin elle se résolut à punir son infidèle, en réveillant mon affaire qu’elle avait assoupie.
Il eut beau luy apporter des raiſons pour l’appaiſer, & pour luy oſter de l’eſprit qu’il m’aimaſt ſi fort ;	Il eut beau lui apporter des raisons pour l’apaiser, et pour lui ôter de l’esprit qu’il m’aimât si fort ;
Elle avoit eu la force de diſſimuler ſon déplaiſir juſques à ce qu’elle eut ſurpris la réponſe qu’il me feroit, & elle eſtoit bien pire que ma lettre :	Elle avait eu la force de dissimuler son déplaisir jusqu’à ce qu’elle eut surpris la réponse qu’il me ferait, et elle était bien pire que ma lettre :
Il y avoit des railleries ſanglantes contre elle, qu’il y traittoit de plaiſante dupe, toute ſon amour fut convertie en une impatience extréme de ſe venger ;	Il y avait des railleries sanglantes contre elle, qu’il y traitait de plaisante dupe, toute son amour fut convertie en une impatience extrême de se venger ;
& pour y parvenir elle commença à publier le ſecret de ma naiſſance, & à donner des preuves que je n’eſtois point ſa fille ny celle de ſon mary.	et pour y parvenir elle commença à publier le secret de ma naissance, et à donner des preuves que je n’étais point sa fille ni celle de son mari.
La nouveauté de l’hiſtoire fit auſſi-toſt un grand bruit dans la Ville, les parents du mort ſe raſſemblerent pour deliberer des moyens de me détruire, & tout ce que Monſieur de Birague pût faire pour moy en cet allarme, fut de monter promptement à cheval, & avant qu’on eut pû ſonger à s’aſſurer de ma perſonne, de s’en aſſurer luy-meſme ;	La nouveauté de l’histoire fit aussitôt un grand bruit dans la Ville, les parents du mort se rassemblèrent pour délibérer des moyens de me détruire, et tout ce que Monsieur de Birague pût faire pour moi en cet alarme, fut de monter promptement à cheval, et avant qu’on eût pu songer à s’assurer de ma personne, de s’en assurer lui-même ;
il m’alla cacher dans une maiſon forte de Madame la Comteſſe d’Engleſac, ſœur de mon Abbeſſe, qui n’eſtoit éloignée du Convent que d’une petite demy lieuë.	il m’alla cacher dans une maison forte de Madame la Comtesse d’Englesac, sœur de mon Abbesse, qui n’était éloignée du Couvent que d’une petite demi-lieue.
Madame d’Engleſac eſt une veufve d’une haute vertu, & méme dans la devotion, quoy qu’elle ait l’humeur magnifique, & qu’elle aime à vivre avec ſes amis dans toutes ſortes d’honeſtes plaiſirs.	Madame d’Englesac est une veuve d’une haute vertu, et même dans la dévotion, quoi qu’elle ait l’humeur magnifique, et qu’elle aime à vivre avec ses amis dans toutes sortes d’honnêtes plaisirs.
Elle avoit alors deux de ſes filles auprés d’elle, & un fils le Chevalier le plus accomply du Royaume, les yeux beaux, la bouche plus belle ;	Elle avait alors deux de ses filles auprès d’elle, et un fils le Chevalier le plus accompli du Royaume, les yeux beaux, la bouche plus belle ;
un air de grandeur, la taille libre, haute & majeſtueuſe, une adreſſe incomparable à toutes choſes, un eſprit galant, une ame de Prince, & une valeur de Heros, ſont les moindres loüanges que je puis donner à ce Gentil-homme :	un air de grandeur, la taille libre, haute et majestueuse, une adresse incomparable à toutes choses, un esprit galant, une âme de Prince, et une valeur de Héros, sont les moindres louanges que je puis donner à ce Gentilhomme :
Que Vôtre Alteſſe me le pardonne il me fut aſſez cher pour meriter bien d’autres emportemens, & c’eſt celuy qui doit avoir la meilleur part à toutes les choſes dont j’ay à parler dans la ſuite de ce recit.	Que Votre Altesse me le pardonne il me fut assez cher pour mériter bien d’autres emportements, et c’est celui qui doit avoir la meilleur part à toutes les choses dont j’ai à parler dans la suite de ce récit.
Je receus dans cette maiſon toutes ſortes de ſecours & de bons traitemens, durant la plus chaude perſecution de mes ennemis ;	Je reçus dans cette maison toutes sortes de secours et de bons traitements, durant la plus chaude persécution de mes ennemis ;
Et tous ceux de cette famille ſe firent un honneur de me proteger dans une diſgrace ſi peu ordinaire, qu’ils nommoient l’effet d’une action heroïque, plûtoſt que d’un laſche aſſaſſinat, comme la Dame de Moliere le diſoit par tout ;	Et tous ceux de cette famille se firent un honneur de me protéger dans une disgrâce si peu ordinaire, qu’ils nommaient l’effet d’une action héroïque, plutôt que d’un lâche assassinat, comme la Dame de Molière le disait partout ;
Et enfin la Cour eſtant pour lors en Provence, ils m’obtinrent ma grace du Roy, avec toute ſorte d’avantages contre mes parties.	Et enfin la Cour étant pour lors en Provence, ils m’obtinrent ma grâce du Roi, avec toute sorte d’avantages contre mes parties.
Mais la fortune qui n’avoit pas deſſein que je fuſſe long-temps ſans traverſes, afin d’avoir ſouvent le plaiſir de m’en relever, ne laiſſa point durer cette faveur.	Mais la fortune qui n’avait pas dessein que je fusse longtemps sans traverses, afin d’avoir souvent le plaisir de m’en relever, ne laissa point durer cette faveur.
Birague qui m’en vouloit tout de bon, & qui eſtoit amy particulier du fils de Madame d’Engleſac, luy parla ſi ſouvent de moy, & du plaiſir qu’il y auroit à en eſtre aimé, que ce jeune Cavalier le crut, & me regarda pour luy-meſme.	Birague qui m’en voulait tout de bon, et qui était ami particulier du fils de Madame d’Englesac, lui parla si souvent de moi, et du plaisir qu’il y aurait à en être aimé, que ce jeune Cavalier le crut, et me regarda pour lui-même.
Ses yeux m’en parlerent, je n’y fus pas inſenſible ;	Ses yeux m’en parlèrent, je n’y fus pas insensible ;
& je puis l’avoüer ſans rougir, puiſque j’en ſeray juſtifiée par la ſuitte.	et je puis l’avouer sans rougir, puisque j’en serai justifiée par la suite.
Birague s’en apperceut, & en devint jaloux ;	Birague s’en aperçut, et en devint jaloux ;
mais je dis jaloux à ne vouloir rien ménager pour me punir de luy avoir preferé ce Gentil-homme.	mais je dis jaloux à ne vouloir rien ménager pour me punir de lui avoir préferé ce Gentilhomme.
Et je l’en excuſe bien ;	Et je l’en excuse bien ;
un Amant qui perd n’eſt pas obligé d’en uſer plus civilement.	un Amant qui perd n’est pas obligé d’en user plus civilement.
Il fit connoiſtre ſous main à la Comteſſe les amours de ſon fils, & quelles dangereuſes ſuites elles pourroient avoir.	Il fit connaître sous main à la Comtesse les amours de son fils, et quelles dangereuses suites elles pourraient avoir.
La Dame qui avoit de l’ambition, & avec juſtice (leur famille eſt une des plus nobleſ & des plus riches du Royaume,) ne s’endormit point y donner ordre ;	La Dame qui avait de l’ambition, et avec justice (leur famille est une des plus nobles et des plus riches du Royaume,) ne s’endormit point y donner ordre ;
Elle me tira un jour dans ſon Cabinet pour m’en parler, & aprés m’avoir remontré avec beaucoup de douceur, qu’elle me croyoit trop ſage pour conſentir jamais à la moindre faute, & trop reconnoiſſante auſſi, pour vouloir profiter du fol amour de ſon fils ;	Elle me tira un jour dans son Cabinet pour m’en parler, et après m’avoir remontré avec beaucoup de douceur, qu’elle me croyait trop sage pour consentir jamais à la moindre faute, et trop reconnaissante aussi, pour vouloir profiter du fol amour de son fils ;
elle me pria de luy oſter ſi bien toute eſperance, qu’il quittaſt le deſſein où elle ſçavoit qu’il s’eſtoit embarqué.	elle me pria de lui ôter si bien toute espérance, qu’il quittât le dessein où elle savait qu’il s’était embarqué.
Et ne ſoyez point faſchée, me dit-elle voyant que ſon diſcours m’avoit fait rougir ;	Et ne soyez point fâchée, me dit-elle voyant que son discours m’avait fait rougir ;
de ce que je vous parle avec cette franchiſe :	de ce que je vous parle avec cette franchise :
c’eſt que je vous aime infiniment, & que je ſerois inconſolable, ſi par faute de vous en avoir avertie, vous vous eſtiez engagée dans une choſe qui me donnât lieu de vous éloigner de moy, & de me plaindre de vous.	c’est que je vous aime infiniment, et que je serais inconsolable, si par faute de vous en avoir avertie, vous vous étiez engagée dans une chose qui me donnât lieu de vous éloigner de moi, et de me plaindre de vous.
Une douleur ſecrete, qui avoit ſuccedé à ma rougeur, m’avoit fait tenir les yeux toûjours beſſez juſques à ce qu’elle eut finy ſon diſcours.	Une douleur secrète, qui avait succédé à ma rougeur, m’avait fait tenir les yeux toujours baissés jusqu’à ce qu’elle eut fini son discours.
Et quoy que je previſſe que j’aurois bien de la peine à obſerver ce que je luy promettrois :	Et quoique je prévisse que j’aurais bien de la peine à observer ce que je lui promettrais :
je luy promis neanmoins de faire tout ce qu’elle me commandoit, afin qu’elle ne prit pas le party de m’éloigner.	je lui promis néanmoins de faire tout ce qu’elle me commandait, afin qu’elle ne prit pas le parti de m’éloigner.
Ce ne fut pas ſans cauſer de grands chagrins au jeune Comte qui ne pouvoit deviner la cauſe de mon changement.	Ce ne fut pas sans causer de grands chagrins au jeune Comte qui ne pouvait deviner la cause de mon changement.
Il voulut cent fois m’en demander le ſujet ;	Il voulut cent fois m’en demander le sujet ;
mais j’eſtois toûjours ſi bien obſervée, tantoſt par Birague, & tantoſt par la mere, que je n’oſay jamais luy en parler, quelque envie que j’en euſſe ;	mais j’étais toujours si bien observée, tantôt par Birague, et tantôt par la mère, que je n’osai jamais lui en parler, quelque envie que j’en eusse ;
Et luy qui prenoit celà pour un mépris, en paſſa juſques à un tel deſeſpoir, qu’il en fut dangereuſement malade.	Et lui qui prenait cela pour un mépris, en passa jusqu’à un tel désespoir, qu’il en fut dangereusement malade.
C’eſt icy ;	C’est ici ;
Madame, que je me diſpenſerois volontiers de la loy que je me ſuis faite, de dire beaucoup de choſe en peu de mots ;	Madame, que je me dispenserais volontiers de la loi que je me suis faite, de dire beaucoup de choses en peu de mots ;
pour étendre le recit de cét amour qui eſt encore cher à mon ſouvenir.	pour étendre le récit de cet amour qui est encore cher à mon souvenir.
Mais je crains que je ne m’imagine de donner à Voſtre Alteſſe comme une choſe agreable, qui peut-eſtre ne le ſera que pour moy, qui y ſuis encore intéreſſée.	Mais je crains que je ne m’imagine de donner à Votre Altesse comme une chose agréable, qui peut-être ne le sera que pour moi, qui y suis encore intéressée.
Qu’une femme eſt folle quand elle aime !	Qu’une femme est folle quand elle aime !
ou qu’elle eſt malheureuſe quand elle a de la vertu & de l’amour !	ou qu’elle est malheureuse quand elle a de la vertu et de l’amour !
que j’eus à ſouffrir, pendant ce peu de jours que cét Amant fut dans ſon lit, & qu’on ne me permit pas de luy faire viſite !	que j’eus à souffrir, pendant ce peu de jours que cet Amant fut dans son lit, et qu’on ne me permit pas de lui faire visite !
qu’il ſouffrit luy-meſme de ne me voir pas !	qu’il souffrit lui-même de ne me voir pas !
Je croy que le ſeul dépit qu’il en eut, le guerit par l’envie qu’il luy donna de venir au plûtoſt me reprocher cette dureté :	Je crois que le seul dépit qu’il en eut, le guérit par l’envie qu’il lui donna de venir au plutôt me reprocher cette dureté :
il me ſouvient des meſmes paroles qu’il me dit un jour dans ce dépit, qui luy ſembloit le plus juſte du monde.	il me souvient des mêmes paroles qu’il me dit un jour dans ce dépit, qui lui semblait le plus juste du monde.
Madame d’Engleſac eſtoit occupée à recevoir le Duc de Villars, & l’Eveſque d’Agde, qui l’eſtoient venu viſiter l’un & l’autre en meſme temps.	Madame d’Englesac était occupée à recevoir le Duc de Villars, et l’Évêque d’Agde, qui l’étaient venu visiter l’un et l’autre en même temps.
Le Chevalier des Eſſars, Gentilhomme de merite, & le mieux fait de ſon Païs, les avoit accompagnez ;	Le Chevalier des Essars, Gentilhomme de mérite, et le mieux fait de son Pays, les avait accompagnés ;
& comme j’ay déja dit, que le Comte d’Engleſac avoit deux ſœurs ;	et comme j’ai déjà dit, que le Comte d’Englesac avait deux sœurs ;
ce Chevalier eſtoit amoureux de l’aiſnée.	ce Chevalier était amoureux de l’aînée.
Je penſe méme que le Duc de Villars n’eſtoit là venu que pour trouver un moyen d’en faire le mariage, & je ne ſçay ce qui empeſcha qu’il ne ſe concluſt :	Je pense même que le Duc de Villars n’était là venu que pour trouver un moyen d’en faire le mariage, et je ne sais ce qui empêcha qu’il ne se conclût :
mais quoy qu’il en ſoit ;	mais quoi qu’il en soit ;
tandis que la Mere s’entretenoit avec luy dans un Salon, l’Eveſque avoit donné envie aux autres d’entrer dans la gallerie, & toute la compagnie s’alla mettre au bout ſur des bancs.	tandis que la Mère s’entretenait avec lui dans un Salon, l’Évêque avait donné envie aux autres d’entrer dans la galerie, et toute la compagnie s’alla mettre au bout sur des bancs.
Mon jeune Comte s’y vint aſſeoir auprés de moy, & aprés avoir jetté un grand ſoûpir de ce que je ne le regardois point ;	Mon jeune Comte s’y vint asseoir auprès de moi, et après avoir jeté un grand soupir de ce que je ne le regardais point ;
(je ne l’oſois à cauſe que la plus jeune de ſes ſœurs me tenoit de l’autre coſté, & s’appuyoit en badinant ſur mon épaule)	(je ne l’osais à cause que la plus jeune de ses sœurs me tenait de l’autre côté, et s’appuyait en badinant sur mon épaule)
il me dit aſſez bas d’un ton de dépit ;	il me dit assez bas d’un ton de dépit ;
Vous voulez que je meure crüelle, je le voy bien, ouy vous le voulez, & il eſt aiſé à connoiſtre que je vous euſſe fait plaiſir s’il eut dépendu de moy de mourir de ma maladie ces jours paſſez ;	Vous voulez que je meure cruelle, je le vois bien, oui vous le voulez, et il est aisé à connaître que je vous eusse fait plaisir s’il eût dépendu de moi de mourir de ma maladie ces jours passés ;
mais je vivray peut-eſtre encore aſſez pour vous reprocher voſtre inconſtance plus que vous ne le voudrez.	mais je vivrai peut-être encore assez pour vous reprocher votre inconstance plus que vous ne le voudrez.